,start_coord,end_coord,translation_status,count,length
0,1003,2471,False,1,1468
1,1616,6367,True,1,4751
2,8042,13308,True,1,5266
3,12178,17214,True,1,5036
4,15568,23088,False,1,7520
5,15857,16533,True,1,676
6,15989,17978,True,2,1989
7,16838,21814,False,1,4976
8,21991,24737,False,1,2746
9,24100,24466,True,1,366
10,24100,24484,False,1,384
11,24100,24517,False,1,417
12,24326,24710,False,1,384
13,27123,28332,True,1,1209
14,29190,29329,False,7,139
15,29190,30155,False,1,965
16,29450,29589,True,1,139
17,30229,30987,False,1,758
18,31171,31262,False,2,91
19,31549,32207,False,1,658
20,31742,32400,False,1,658
21,32073,35422,True,2,3349
22,32608,32903,False,1,295
23,33371,33458,False,1,87
24,33371,33462,False,1,91
25,33912,34088,False,4,176
26,34134,34310,True,1,176
27,34974,35145,False,1,171
28,35347,35518,False,1,171
29,35573,35744,False,1,171
30,36900,37741,False,1,841
31,40913,43162,False,1,2249
32,43883,44790,True,2,907
33,45546,49940,False,1,4394
34,48211,71797,False,1,23586
35,59495,60424,True,1,929
36,60373,60689,True,2,316
37,61545,62955,False,1,1410
38,69350,69451,False,1,101
39,69784,69885,False,1,101
40,73821,77676,False,3,3855
41,73821,77953,False,1,4132
42,74054,77676,False,1,3622
43,76992,77744,True,1,752
44,76992,95965,True,1,18973
45,76992,109618,True,1,32626
46,77804,78657,True,1,853
47,78813,79425,True,1,612
48,80183,80315,False,2,132
49,80440,84251,True,1,3811
50,87860,91890,True,1,4030
51,90958,99562,False,1,8604
52,91904,100008,True,4,8104
53,91948,93632,True,1,1684
54,93200,95352,False,1,2152
55,93376,103702,True,2,10326
56,97315,104218,False,1,6903
57,98780,99722,False,1,942
58,106611,112547,False,1,5936
59,106611,112547,True,4,5936
60,106611,138846,True,1,32235
61,107480,108264,False,1,784
62,107480,108264,True,1,784
63,108101,132648,True,1,24547
64,109264,166378,True,1,57114
65,114346,114544,True,6,198
66,115337,135188,False,1,19851
67,119400,126281,False,1,6881
68,122844,127294,False,1,4450
69,123462,123846,False,1,384
70,124608,174449,False,1,49841
71,125418,126233,True,1,815
72,125782,126223,False,1,441
73,125893,127622,True,4,1729
74,125893,131591,True,1,5698
75,133278,133454,True,1,176
76,135577,135819,False,1,242
77,136316,179978,False,1,43662
78,136758,144994,True,1,8236
79,138166,140830,False,1,2664
80,140237,141235,True,2,998
81,140237,143788,True,1,3551
82,140237,169750,True,1,29513
83,140237,186204,True,1,45967
84,145513,147577,False,1,2064
85,146009,147168,False,1,1159
86,147823,148454,False,1,631
87,148031,152663,True,1,4632
88,148636,153055,False,1,4419
89,148636,153055,True,2,4419
90,149199,151845,False,1,2646
91,149199,152093,False,1,2894
92,153002,153103,False,1,101
93,155071,156566,False,1,1495
94,157724,158988,False,1,1264
95,157724,166039,False,1,8315
96,165452,168687,False,1,3235
97,167416,167514,False,1,98
98,173469,174201,True,1,732
99,174535,174857,True,1,322
100,174538,174647,True,2,109
101,175888,176126,False,1,238
102,175888,176126,True,2,238
103,175897,176135,True,1,238
104,176263,176439,True,1,176
105,176648,176824,False,1,176
106,180564,185229,True,1,4665
107,183562,184242,True,1,680
108,183744,184242,False,1,498
109,186458,186463,True,1,5
110,186881,187380,True,1,499
111,189451,192053,True,2,2602
112,189451,192417,True,1,2966
113,194535,198534,True,1,3999
114,194564,197365,False,1,2801
115,196290,197765,True,1,1475
116,202297,203464,False,1,1167
117,205915,207965,False,1,2050
118,207886,209285,True,1,1399
119,214302,214616,True,1,314
120,216253,217888,True,1,1635
121,216815,217027,True,1,212
122,218517,225904,False,1,7387
123,222150,222274,True,2,124
124,223276,223376,False,1,100
125,224203,261418,False,1,37215
126,226491,226626,False,1,135
127,228138,237621,False,1,9483
128,230243,231206,True,3,963
129,242236,254392,False,1,12156
130,242610,242996,False,1,386
131,242610,242996,True,3,386
132,244630,245952,True,1,1322
133,246124,246226,True,1,102
134,246578,249305,True,1,2727
135,248956,279101,True,1,30145
136,249563,251115,False,1,1552
137,254141,256439,True,1,2298
138,256500,257304,True,1,804
139,256500,257590,True,2,1090
140,258359,258451,True,2,92
141,258724,260230,True,3,1506
142,261103,261134,True,1,31
143,262949,263740,True,4,791
144,263995,265262,False,3,1267
145,264003,265267,False,1,1264
146,264013,265280,False,1,1267
147,264190,264673,True,1,483
148,266149,267580,True,1,1431
149,268866,270090,False,1,1224
150,268866,270937,False,1,2071
151,272672,274498,True,5,1826
152,274468,274560,True,1,92
153,276106,278378,False,1,2272
154,276344,277523,True,1,1179
155,281203,283532,True,1,2329
156,283028,292286,False,1,9258
157,286051,291137,False,1,5086
158,286251,300547,True,1,14296
159,292069,297179,True,1,5110
160,296411,298892,True,1,2481
161,296454,296555,False,1,101
162,298662,300125,True,1,1463
163,299650,307720,False,1,8070
164,299875,303150,False,1,3275
165,300387,310448,False,1,10061
166,302143,303003,False,1,860
167,317196,321788,True,3,4592
168,322054,324716,False,1,2662
169,322054,327632,False,1,5578
170,322054,327632,True,1,5578
171,337285,338740,True,1,1455
172,338731,339995,False,1,1264
173,343289,345450,True,1,2161
174,346481,348811,True,1,2330
175,349630,349909,True,2,279
176,349954,350233,False,1,279
177,350022,352591,True,2,2569
178,350346,352915,True,1,2569
179,352650,384358,True,1,31708
180,354198,354329,True,2,131
181,358145,359369,True,1,1224
182,361130,406336,True,1,45206
183,361255,406355,True,3,45100
184,361703,373594,True,1,11891
185,362503,362584,False,1,81
186,362507,362584,True,1,77
187,362922,407355,True,1,44433
188,364614,373021,True,2,8407
189,365007,373205,True,1,8198
190,365077,373205,True,1,8128
191,373419,394851,True,1,21432
192,382610,384258,True,1,1648
193,384177,386446,True,1,2269
194,386051,391137,False,1,5086
195,386233,386789,True,1,556
196,386772,388520,True,1,1748
197,393806,394055,True,2,249
198,394207,394353,True,1,146
199,395527,395632,True,2,105
200,396411,398892,True,1,2481
201,398677,398769,True,1,92
202,405856,406742,True,1,886
203,408392,408532,True,1,140
204,408566,410485,True,1,1919
205,408566,410503,True,6,1937
206,408566,415994,True,3,7428
207,408566,433003,True,2,24437
208,408566,436601,True,1,28035
209,408566,439449,True,1,30883
210,408566,441573,True,1,33007
211,408590,408873,True,1,283
212,409022,433310,True,1,24288
213,409022,439756,True,1,30734
214,410061,412000,True,1,1939
215,410947,421716,True,1,10769
216,412958,453735,True,1,40777
217,414089,419460,True,1,5371
218,415885,417815,True,1,1930
219,417467,417798,True,2,331
220,419068,419637,True,1,569
221,424674,424953,True,1,279
222,425066,427635,True,1,2569
223,429238,429369,True,1,131
224,429440,429946,True,2,506
225,429893,486489,True,2,56596
226,431747,433805,True,2,2058
227,431747,433859,True,5,2112
228,432060,432237,True,1,177
229,436888,441950,True,3,5062
230,437136,442997,False,1,5861
231,437136,442997,True,2,5861
232,437136,443001,False,1,5865
233,437136,448099,False,1,10963
234,437136,448099,True,2,10963
235,443289,445450,True,1,2161
236,445725,448330,False,1,2605
237,445725,448330,True,1,2605
238,445851,445967,True,1,116
239,448316,449748,False,1,1432
240,450405,457044,True,1,6639
241,450491,451887,True,1,1396
242,452001,469782,True,1,17781
243,452001,481760,True,2,29759
244,453488,453604,True,1,116
245,456171,458712,True,1,2541
246,456747,459288,True,1,2541
247,458145,459369,True,1,1224
248,460912,460995,True,1,83
249,472404,472483,False,1,79
250,473951,475803,False,1,1852
251,473951,475803,True,2,1852
252,473951,480846,True,1,6895
253,476853,478092,True,1,1239
254,477024,524572,True,2,47548
255,478311,478901,True,1,590
256,478311,478938,False,1,627
257,478311,478938,True,3,627
258,479100,525619,False,1,46519
259,479100,525619,True,1,46519
260,479103,479507,True,1,404
261,487064,491038,False,1,3974
262,489919,494004,True,2,4085
263,493369,494040,False,1,671
264,503411,508110,True,3,4699
265,511816,538604,True,2,26788
266,512037,512537,True,1,500
267,514128,514291,True,2,163
268,520554,523054,True,1,2500
269,527377,533694,False,1,6317
270,529875,536732,False,1,6857
271,529875,536732,True,4,6857
272,530882,553688,True,2,22806
273,532519,542616,True,2,10097
274,533750,535896,True,3,2146
275,533758,535904,True,3,2146
276,533778,535924,True,3,2146
277,533838,535984,True,3,2146
278,543540,543624,True,1,84
279,543671,544559,True,6,888
280,546147,559506,False,1,13359
281,546147,559506,True,5,13359
282,551498,580054,False,1,28556
283,555641,555938,True,1,297
284,557167,557894,True,2,727
285,559712,562669,True,1,2957
286,560077,563037,True,1,2960
287,562580,563175,True,3,595
288,569656,584346,False,2,14690
289,569656,584346,True,2,14690
290,572333,574139,True,1,1806
291,578376,578939,True,1,563
292,578376,579005,True,1,629
293,579633,579946,True,1,313
294,583055,585395,True,1,2340
295,584660,596726,True,2,12066
296,586302,586431,True,1,129
297,587747,587919,True,1,172
298,589919,594004,True,2,4085
299,596913,597503,True,1,590
300,599200,603932,True,1,4732
301,599619,600884,True,5,1265
302,608627,648297,True,3,39670
303,608928,611074,True,3,2146
304,609288,616505,True,1,7217
305,612037,612537,True,1,500
306,612285,612691,True,1,406
307,614915,618782,True,1,3867
308,614923,618790,True,1,3867
309,614943,618810,True,1,3867
310,615005,618872,False,1,3867
311,615231,619093,True,1,3862
312,616544,617117,True,1,573
313,619765,620742,False,1,977
314,628346,628910,True,1,564
315,637398,643225,False,1,5827
316,637691,637809,True,4,118
317,639418,641014,True,1,1596
318,639657,640235,True,1,578
319,639662,640235,True,1,573
320,643646,647267,True,1,3621
321,644264,646322,True,1,2058
322,644318,644685,True,1,367
323,645478,666707,True,1,21229
324,647951,648177,True,1,226
325,648632,648724,True,1,92
326,655155,657260,True,1,2105
327,660022,660326,True,3,304
328,660377,660752,True,1,375
329,661358,662349,True,2,991
330,663370,669164,True,3,5794
331,665982,666999,True,2,1017
332,673466,680886,True,1,7420
333,675687,676877,True,2,1190
334,689881,693749,True,1,3868
335,702880,704175,False,1,1295
336,713873,719878,True,3,6005
337,722915,729005,True,1,6090
338,723120,729960,True,1,6840
339,724084,725015,True,1,931
340,724482,729119,True,2,4637
341,732142,733606,True,2,1464
342,737377,740107,True,1,2730
343,739748,741901,True,1,2153
344,767182,828068,True,1,60886
345,771291,785572,True,1,14281
346,773351,773556,True,1,205
347,778131,779231,False,3,1100
348,778131,779231,True,2,1100
349,778131,786876,True,2,8745
350,783286,786546,True,4,3260
351,783547,784834,False,1,1287
352,783547,784834,True,3,1287
353,784050,784512,True,1,462
354,784050,791145,True,1,7095
355,785306,786925,True,1,1619
356,788417,789959,True,1,1542
357,788669,789959,True,1,1290
358,788740,790822,True,1,2082
359,788876,789155,True,1,279
360,789268,791837,True,1,2569
361,793440,793571,True,1,131
362,794307,795881,True,1,1574
363,803925,805245,True,1,1320
364,810761,829303,False,1,18542
365,811774,812062,True,3,288
366,812409,812712,True,1,303
367,813843,814446,True,1,603
368,827552,856087,False,1,28535
369,831369,831474,True,2,105
370,832737,834205,False,1,1468
371,833904,835503,True,1,1599
372,834445,834971,True,3,526
373,835165,835709,True,1,544
374,835608,835873,True,2,265
375,836518,836647,True,3,129
376,838098,839017,True,1,919
377,838899,839772,False,1,873
378,839985,850456,True,1,10471
379,839985,885585,True,1,45600
380,840501,841195,False,1,694
381,840511,849160,True,2,8649
382,840511,885965,True,1,45454
383,841593,842162,True,1,569
384,842489,843876,True,2,1387
385,843058,843384,True,2,326
386,844406,846318,True,1,1912
387,844406,846336,True,7,1930
388,844406,851832,True,3,7426
389,844406,868854,True,2,24448
390,844406,872455,True,1,28049
391,844406,875304,True,1,30898
392,844406,877428,True,1,33022
393,845901,847833,True,1,1932
394,846056,847837,True,3,1781
395,849915,855291,True,1,5376
396,857059,858323,True,1,1264
397,858441,865288,False,1,6847
398,859981,868262,False,1,8281
399,864717,865528,False,1,811
400,865201,866105,True,1,904
401,865712,870764,True,1,5052
402,871683,875798,True,4,4115
403,871993,900134,True,2,28141
404,871993,926615,True,1,54622
405,881459,882246,True,1,787
406,882533,884281,True,1,1748
407,886738,889596,True,1,2858
408,893803,895712,False,1,1909
409,894504,896179,True,1,1675
410,900916,910464,True,2,9548
411,903806,903850,True,1,44
412,903900,906811,True,3,2911
413,914854,917535,False,1,2681
414,927709,930992,True,2,3283
415,928057,930355,True,3,2298
416,937090,937349,False,1,259
417,937736,955572,True,1,17836
418,940667,940847,True,1,180
419,942704,943416,False,1,712
420,942868,943722,False,1,854
421,946830,948329,True,2,1499
422,952387,987069,True,1,34682
423,961300,971340,False,1,10040
424,964554,966700,True,3,2146
425,971901,974114,True,3,2213
426,986112,987208,True,1,1096
427,986266,987171,False,1,905
428,986266,987171,True,4,905
429,986542,987211,True,1,669
430,986913,987260,True,1,347
431,989289,989392,True,9,103
432,993040,994320,True,2,1280
433,993040,994983,True,1,1943
434,997167,1013190,True,1,16023
435,997167,1019426,True,1,22259
436,1000550,1001956,True,1,1406
437,1009448,1053799,True,1,44351
438,1009448,1181582,True,2,172134
439,1014488,1014940,False,1,452
440,1014488,1014940,True,1,452
441,1015340,1026383,True,1,11043
442,1021590,1025415,True,2,3825
443,1045761,1049625,True,1,3864
444,1049894,1057372,True,1,7478
445,1063840,1067567,True,1,3727
446,1064763,1064870,False,1,107
447,1064763,1064870,True,1,107
448,1064996,1065516,True,1,520
449,1064996,1065692,True,1,696
450,1065260,1071373,True,1,6113
451,1070415,1076277,True,2,5862
452,1075107,1076962,True,1,1855
453,1075107,1077647,True,1,2540
454,1075126,1076117,True,1,991
455,1081293,1090858,True,1,9565
456,1088159,1091311,True,1,3152
457,1088159,1091315,True,1,3156
458,1094488,1224035,True,1,129547
459,1109960,1110152,True,1,192
460,1117070,1117371,False,1,301
461,1119159,1119253,False,1,94
462,1122003,1122730,True,1,727
463,1122926,1123209,True,2,283
464,1122980,1123742,False,1,762
465,1127028,1128563,True,1,1535
466,1133214,1134009,False,1,795
467,1133509,1134006,False,1,497
468,1139041,1180934,True,1,41893
469,1139253,1213872,True,1,74619
470,1142855,1150774,True,1,7919
471,1142855,1151653,True,1,8798
472,1145154,1150225,True,1,5071
473,1145154,1151951,True,1,6797
474,1153074,1157972,True,4,4898
475,1155884,1161799,False,1,5915
476,1155884,1161799,True,2,5915
477,1155923,1211699,False,1,55776
478,1158505,1159226,True,1,721
479,1165649,1169369,True,1,3720
480,1169945,1174991,True,1,5046
481,1170415,1176277,True,2,5862
482,1179072,1179857,True,7,785
483,1180469,1193434,True,1,12965
484,1184708,1188955,True,1,4247
485,1184826,1187454,False,1,2628
486,1192214,1212808,True,1,20594
487,1192724,1212914,True,1,20190
488,1194126,1203973,True,1,9847
489,1194126,1214983,True,1,20857
490,1205071,1205161,True,1,90
491,1205242,1213843,False,1,8601
492,1216785,1217259,False,1,474
493,1221082,1223675,True,1,2593
494,1224962,1231507,False,1,6545
495,1224962,1231507,True,1,6545
496,1225354,1225551,True,9,197
497,1228875,1232795,True,1,3920
498,1233456,1234685,True,1,1229
499,1234106,1234500,True,1,394
500,1234106,1234525,True,1,419
501,1234334,1234516,True,5,182
502,1234545,1234639,True,1,94
503,1234783,1239278,True,1,4495
504,1237906,1243035,False,1,5129
505,1239002,1239094,True,2,92
506,1239245,1247826,True,2,8581
507,1240063,1244031,True,3,3968
508,1245106,1246569,True,1,1463
509,1248475,1248767,True,1,292
510,1252842,1253007,True,1,165
511,1256828,1260885,True,1,4057
512,1256828,1262140,True,1,5312
513,1264069,1264641,True,1,572
514,1271855,1272182,True,2,327
515,1272688,1277351,True,1,4663
516,1274893,1276735,True,1,1842
517,1278903,1279615,True,1,712
518,1279419,1279927,True,1,508
519,1280064,1283158,True,2,3094
520,1280195,1280335,True,2,140
521,1280605,1307378,True,1,26773
522,1287344,1298350,True,1,11006
523,1288878,1295384,False,1,6506
524,1288878,1298184,True,2,9306
525,1294073,1294604,True,2,531
526,1294483,1294556,False,1,73
527,1295802,1295895,True,1,93
528,1298932,1303031,True,1,4099
529,1299583,1307459,True,1,7876
530,1300392,1300653,True,1,261
531,1304669,1305801,True,1,1132
532,1311944,1312210,True,1,266
533,1315550,1317242,True,2,1692
534,1315550,1326673,True,1,11123
535,1324847,1327409,True,1,2562
536,1325387,1326059,True,2,672
537,1326026,1335655,True,4,9629
538,1326322,1326414,False,1,92
539,1326322,1326414,True,1,92
540,1326322,1329823,True,1,3501
541,1332532,1333314,False,2,782
542,1332532,1333314,True,1,782
543,1337011,1337228,False,1,217
544,1337533,1338151,False,1,618
545,1337647,1337727,False,1,80
546,1337647,1337727,True,1,80
547,1343399,1344482,False,1,1083
548,1343399,1344482,True,1,1083
549,1343528,1344155,True,1,627
550,1344729,1345642,True,3,913
551,1347308,1347842,True,1,534
552,1348643,1349420,False,1,777
553,1349869,1427200,True,1,77331
554,1349869,1447017,True,1,97148
555,1351782,1352185,True,4,403
556,1352914,1354178,True,1,1264
557,1361593,1362045,False,1,452
558,1362435,1363591,True,1,1156
559,1368767,1394995,True,1,26228
560,1369072,1369145,True,5,73
561,1371444,1371833,True,1,389
562,1371467,1372468,True,2,1001
563,1373561,1397442,True,1,23881
564,1373761,1374837,True,1,1076
565,1375411,1459676,True,1,84265
566,1382479,1383971,False,1,1492
567,1383891,1383966,False,1,75
568,1383891,1383966,True,1,75
569,1384368,1388589,False,1,4221
570,1391412,1394457,True,1,3045
571,1391436,1394457,True,3,3021
572,1392005,1392116,True,1,111
573,1392398,1403980,True,1,11582
574,1396885,1398063,False,1,1178
575,1397279,1398459,False,1,1180
576,1397505,1398683,False,1,1178
577,1397599,1398772,False,1,1173
578,1397891,1399069,False,1,1178
579,1398788,1399123,False,1,335
580,1398788,1399123,True,3,335
581,1399331,1423989,False,1,24658
582,1399331,1423989,True,4,24658
583,1400871,1401951,False,1,1080
584,1406923,1409472,True,3,2549
585,1410525,1410628,True,1,103
586,1412407,1415447,True,2,3040
587,1413429,1415956,True,1,2527
588,1413602,1413820,False,1,218
589,1414052,1417607,True,1,3555
590,1415653,1415942,True,1,289
591,1418103,1435088,True,3,16985
592,1418780,1418880,True,1,100
593,1420364,1429938,True,1,9574
594,1422565,1422659,True,1,94
595,1430788,1430935,True,2,147
596,1436318,1436433,True,2,115
597,1442094,1442586,True,1,492
598,1442269,1442346,True,1,77
599,1444474,1444596,True,1,122
600,1445152,1447962,True,1,2810
601,1446223,1454423,True,2,8200
602,1449390,1450287,True,1,897
603,1451534,1452039,True,2,505
604,1452571,1452744,True,1,173
605,1455649,1458878,True,1,3229
606,1456488,1458925,True,1,2437
607,1458509,1460343,True,1,1834
608,1458939,1460772,True,1,1833
609,1459143,1460977,True,1,1834
610,1459237,1461070,True,1,1833
611,1459529,1461363,True,1,1834
612,1460798,1461175,True,1,377
613,1460798,1461264,True,1,466
614,1461442,1462732,True,1,1290
615,1461872,1463161,True,1,1289
616,1462076,1463366,True,1,1290
617,1462170,1463459,True,1,1289
618,1462462,1463752,True,1,1290
619,1464540,1464617,True,2,77
620,1464734,1464986,True,1,252
621,1464994,1467123,True,1,2129
622,1465162,1465414,True,1,252
623,1465368,1465607,True,1,239
624,1465368,1465620,True,1,252
625,1465460,1465712,True,1,252
626,1465754,1465993,True,1,239
627,1465754,1466006,True,1,252
628,1467216,1470664,True,1,3448
629,1469582,1473030,True,1,3448
630,1469603,1469691,True,1,88
631,1471991,1473170,False,1,1179
632,1480207,1481434,False,1,1227
633,1482605,1483066,True,1,461
634,1483192,1484864,True,1,1672
635,1486922,1487131,True,3,209
636,1495009,1503308,True,3,8299
637,1499610,1500095,True,1,485
638,1499610,1500624,True,1,1014
639,1502316,1508033,True,1,5717
640,1526125,1527351,False,5,1226
641,1526406,1527558,False,1,1152
642,1528936,1534155,True,8,5219
643,1530565,1530754,True,1,189
644,1533289,1535635,True,1,2346
645,1533289,1535697,True,1,2408
646,1533643,1535476,True,1,1833
647,1533704,1533983,False,1,279
648,1534595,1537534,True,1,2939
649,1536576,1537865,True,1,1289
650,1538125,1538213,True,2,88
651,1539854,1540812,True,1,958
652,1539866,1540105,True,1,239
653,1539866,1540118,True,1,252
654,1540028,1540307,False,1,279
655,1541581,1541669,False,2,88
656,1541581,1541669,True,1,88
657,1541915,1542142,True,4,227
658,1541975,1542974,True,1,999
659,1542577,1542737,True,2,160
660,1545370,1545501,True,2,131
661,1547875,1547993,True,1,118
662,1547875,1548374,True,1,499
663,1548412,1549494,False,1,1082
664,1549127,1549230,True,1,103
665,1550203,1550354,True,1,151
666,1552424,1555455,False,1,3031
667,1554097,1554367,True,1,270
668,1554280,1554515,True,1,235
669,1554879,1555228,True,2,349
670,1559230,1564963,True,2,5733
671,1560423,1560609,True,2,186
672,1560424,1585871,False,2,25447
673,1561842,1562405,False,1,563
674,1563266,1563863,True,1,597
675,1568187,1568575,True,1,388
676,1568572,1570885,True,1,2313
677,1575767,1577137,True,1,1370
678,1582542,1582614,True,3,72
679,1588417,1588678,True,1,261
680,1592414,1596932,False,1,4518
681,1592414,1596932,True,1,4518
682,1594896,1596802,True,3,1906
683,1598743,1598991,False,1,248
684,1598743,1598991,True,5,248
685,1599428,1599566,True,1,138
686,1600491,1600854,False,2,363
687,1600491,1601957,False,1,1466
688,1600923,1601286,False,2,363
689,1600923,1602389,False,1,1466
690,1601123,1601486,False,2,363
691,1601123,1602589,False,1,1466
692,1601213,1601576,False,2,363
693,1601213,1602679,False,1,1466
694,1601511,1601874,False,2,363
695,1601511,1602977,False,1,1466
696,1607053,1613548,True,1,6495
697,1607505,1612940,False,1,5435
698,1615198,1617555,True,1,2357
699,1616953,1618217,True,1,1264
700,1619974,1620167,True,1,193
701,1621585,1621835,True,1,250
702,1621585,1621895,True,1,310
703,1621940,1623436,True,1,1496
704,1622246,1623742,True,1,1496
705,1626382,1626919,True,3,537
706,1628949,1639704,True,1,10755
707,1632295,1632391,True,1,96
708,1633467,1642059,True,1,8592
709,1637858,1638472,True,1,614
710,1647113,1647218,True,1,105
711,1650644,1659164,False,1,8520
712,1652422,1654384,True,1,1962
713,1653519,1656843,True,1,3324
714,1653519,1700730,True,1,47211
715,1653939,1657262,True,1,3323
716,1653939,1701119,True,1,47180
717,1654151,1657475,True,1,3324
718,1654151,1701353,True,1,47202
719,1654217,1657540,True,1,3323
720,1654217,1701412,True,1,47195
721,1654539,1657863,True,1,3324
722,1654539,1701758,True,1,47219
723,1655295,1655812,True,1,517
724,1655734,1656058,True,1,324
725,1657001,1657079,True,1,78
726,1658836,1659280,True,1,444
727,1665973,1667479,True,1,1506
728,1665973,1669012,True,1,3039
729,1665977,1667479,False,1,1502
730,1665977,1667479,True,1,1502
731,1665977,1669012,True,1,3035
732,1666545,1691107,False,1,24562
733,1671350,1671798,True,2,448
734,1675617,1675980,False,2,363
735,1675617,1677083,False,1,1466
736,1677396,1677547,False,1,151
737,1677396,1677550,True,5,154
738,1680200,1682132,True,1,1932
739,1680321,1683277,True,1,2956
740,1682053,1684443,True,1,2390
741,1683881,1688647,True,2,4766
742,1685738,1690022,True,2,4284
743,1685738,1693109,True,1,7371
744,1685985,1690139,True,1,4154
745,1685990,1690139,True,1,4149
746,1686626,1686742,False,1,116
747,1686626,1686742,True,3,116
748,1686966,1687231,True,1,265
749,1688266,1691279,True,1,3013
750,1689032,1691644,True,1,2612
751,1693667,1694137,False,1,470
752,1696864,1697018,True,1,154
753,1704685,1705164,True,1,479
754,1706052,1706352,False,2,300
755,1707059,1708221,True,1,1162
756,1707059,1712098,True,1,5039
757,1710433,1727333,True,1,16900
758,1711352,1712912,True,1,1560
759,1712006,1713533,True,1,1527
760,1712561,1713166,True,1,605
761,1712561,1728391,True,2,15830
762,1712561,1734684,True,1,22123
763,1719408,1720279,True,1,871
764,1721098,1721829,True,1,731
765,1721963,1723068,True,1,1105
766,1722300,1722420,True,1,120
767,1722694,1726834,False,7,4140
768,1722694,1726834,True,21,4140
769,1722694,1732451,False,1,9757
770,1722694,1732451,True,1,9757
771,1725578,1784894,True,6,59316
772,1728532,1729376,False,2,844
773,1728532,1729376,True,4,844
774,1734934,1737212,True,1,2278
775,1736212,1736375,True,1,163
776,1736461,1736823,True,3,362
777,1737814,1737977,True,6,163
778,1741092,1742041,True,1,949
779,1744379,1750574,True,1,6195
780,1747030,1748690,False,1,1660
781,1747030,1748690,True,3,1660
782,1747545,1748321,True,4,776
783,1747903,1748679,True,4,776
784,1748159,1748935,True,4,776
785,1748211,1748987,True,4,776
786,1748581,1749357,True,4,776
787,1749494,1751176,True,1,1682
788,1752542,1754683,False,1,2141
789,1753209,1754311,True,1,1102
790,1758937,1761121,True,1,2184
791,1759293,1761482,True,1,2189
792,1759549,1761738,True,1,2189
793,1759601,1761790,True,1,2189
794,1759762,1760002,True,3,240
795,1759762,1760017,True,1,255
796,1759973,1762162,True,1,2189
797,1766134,1771030,True,1,4896
798,1776306,1777209,True,1,903
799,1778396,1778714,True,1,318
800,1782111,1783307,False,1,1196
801,1783266,1783830,False,1,564
802,1785138,1786438,True,1,1300
803,1786173,1787868,True,2,1695
804,1788109,1788241,True,1,132
805,1789420,1840704,False,1,51284
806,1792146,1792637,True,1,491
807,1793958,1794032,True,1,74
808,1794042,1795940,True,1,1898
809,1794138,1794212,True,1,74
810,1795311,1795542,False,1,231
811,1795585,1795816,True,1,231
812,1796991,1803883,False,1,6892
813,1800976,1802373,True,1,1397
814,1803870,1803958,True,3,88
815,1808340,1808739,False,1,399
816,1808340,1822576,True,5,14236
817,1810004,1810328,True,1,324
818,1810693,1812854,True,1,2161
819,1816166,1817160,True,6,994
820,1822227,1822455,False,1,228
821,1822227,1822455,True,1,228
822,1828071,1829052,True,1,981
823,1828483,1829662,False,1,1179
824,1832627,1841881,True,1,9254
825,1835087,1835883,True,1,796
826,1851896,1885243,False,1,33347
827,1851896,1885243,True,2,33347
828,1852095,1855296,True,1,3201
829,1852589,1867756,True,7,15167
830,1855751,1857770,True,10,2019
831,1855751,1863078,False,1,7327
832,1855751,1863098,False,1,7347
833,1855751,1864600,True,3,8849
834,1856209,1858228,True,10,2019
835,1856209,1863537,False,1,7328
836,1856209,1863557,False,1,7348
837,1856209,1865059,True,3,8850
838,1856469,1858488,True,10,2019
839,1856469,1863796,False,1,7327
840,1856469,1863816,False,1,7347
841,1856469,1865318,True,3,8849
842,1856537,1858556,True,10,2019
843,1856537,1863864,False,1,7327
844,1856537,1863884,False,1,7347
845,1856537,1865386,True,3,8849
846,1856883,1858901,True,10,2018
847,1856883,1864209,False,1,7326
848,1856883,1864229,False,1,7346
849,1856883,1865731,True,3,8848
850,1862923,1874423,False,1,11500
851,1869153,1869245,True,2,92
852,1876122,1876204,True,5,82
853,1880204,1883671,True,1,3467
854,1880204,1886910,True,1,6706
855,1887617,1889243,True,1,1626
856,1888067,1889688,True,1,1621
857,1888343,1889970,True,1,1627
858,1888411,1890038,True,1,1627
859,1890139,1891971,True,1,1832
860,1893072,1894360,True,1,1288
861,1893307,2025755,False,1,132448
862,1893307,2025755,True,2,132448
863,1896360,1896599,True,1,239
864,1896360,1896612,True,1,252
865,1897802,1898208,True,1,406
866,1907180,1907506,True,2,326
867,1909834,1910408,True,8,574
868,1909834,1910607,True,2,773
869,1911255,1913081,True,1,1826
870,1918529,1918837,True,1,308
871,1919992,1920763,False,1,771
872,1920053,1920824,True,1,771
873,1922808,1923613,False,3,805
874,1930943,1932958,True,10,2015
875,1930943,1938269,False,1,7326
876,1930943,1938289,False,1,7346
877,1930943,1939792,True,3,8849
878,1940687,1941425,True,1,738
879,1944316,1949154,True,1,4838
880,1946154,1957776,True,1,11622
881,1954422,1967006,True,1,12584
882,1961814,1962379,False,1,565
883,1961814,1962379,True,1,565
884,1961814,1975182,True,1,13368
885,1962809,1964434,True,1,1625
886,1965594,1966358,True,2,764
887,1968890,1970190,True,1,1300
888,1976252,1976491,False,1,239
889,1979096,1985808,True,1,6712
890,1983430,1983559,True,5,129
891,1983488,1983617,True,5,129
892,1984138,1984267,True,5,129
893,1984148,1984409,False,1,261
894,1984184,1984313,True,5,129
895,1984206,1984467,True,1,261
896,1984856,1985117,False,1,261
897,1984902,1985163,False,1,261
898,1989994,1998779,True,1,8785
899,1990244,1990737,False,1,493
900,1990307,1991531,False,1,1224
901,1990307,2012067,False,1,21760
902,1990342,1990774,False,1,432
903,1991015,1992239,False,1,1224
904,1991015,2012776,False,1,21761
905,1991061,1992285,False,1,1224
906,1991061,2012814,False,1,21753
907,2001298,2003563,True,1,2265
908,2008428,2009569,False,1,1141
909,2009136,2010277,False,1,1141
910,2009174,2010315,False,1,1141
911,2010023,2011195,True,1,1172
912,2011351,2011865,True,1,514
913,2011534,2012015,True,1,481
914,2011998,2012189,True,1,191
915,2013577,2017300,True,1,3723
916,2014185,2014341,False,1,156
917,2015080,2016519,True,1,1439
918,2018273,2018368,True,2,95
919,2019477,2020366,False,1,889
920,2019477,2023258,False,1,3781
921,2020543,2020637,False,1,94
922,2020543,2020742,True,1,199
923,2020543,2021013,True,1,470
924,2026456,2026720,True,1,264
925,2032127,2032490,False,2,363
926,2032127,2033593,False,1,1466
927,2035564,2036490,False,3,926
928,2035564,2036490,True,2,926
929,2035564,2036928,True,1,1364
930,2043872,2044312,True,5,440
931,2045855,2046880,True,2,1025
932,2046346,2046654,False,1,308
933,2046346,2046654,True,1,308
934,2051072,2051174,True,1,102
935,2052853,2054783,False,1,1930
936,2053020,2057365,True,5,4345
937,2053020,2062710,True,1,9690
938,2057980,2058109,False,1,129
939,2057980,2058109,True,5,129
940,2064151,2065533,True,1,1382
941,2064793,2066016,False,1,1223
942,2064793,2086552,False,1,21759
943,2068815,2072775,True,2,3960
944,2069306,2070575,True,1,1269
945,2069542,2073081,True,1,3539
946,2074062,2076726,True,3,2664
947,2080296,2081323,True,2,1027
948,2083238,2084389,False,1,1151
949,2085135,2088458,True,1,3323
950,2085135,2132323,True,1,47188
951,2085485,2085698,True,1,213
952,2099364,2117477,False,1,18113
953,2100327,2100660,False,1,333
954,2100835,2100971,True,1,136
955,2100835,2101921,True,1,1086
956,2101120,2101913,True,2,793
957,2101394,2102187,True,1,793
958,2103054,2103950,True,1,896
959,2103672,2105254,True,1,1582
960,2113988,2114216,True,1,228
961,2117362,2117433,False,1,71
962,2119112,2119419,True,1,307
963,2119192,2119499,True,1,307
964,2119860,2120167,True,1,307
965,2119882,2120189,False,1,307
966,2119882,2120189,True,1,307
967,2120602,2120732,True,1,130
968,2120682,2120812,True,1,130
969,2121350,2121480,True,1,130
970,2121368,2121498,True,1,130
971,2121687,2121817,True,1,130
972,2125574,2125881,False,1,307
973,2125574,2125881,True,1,307
974,2127060,2127190,True,1,130
975,2127379,2127509,True,1,130
976,2130620,2131551,True,1,931
977,2130801,2132030,False,1,1229
978,2132083,2134332,True,1,2249
979,2132193,2132650,False,1,457
980,2132193,2132650,True,1,457
981,2132246,2132650,True,2,404
982,2134658,2135575,True,1,917
983,2134658,2140310,True,1,5652
984,2135281,2136019,True,1,738
985,2137299,2149804,False,1,12505
986,2137299,2149804,True,1,12505
987,2137299,2150328,True,1,13029
988,2137299,2151303,False,1,14004
989,2137533,2168569,False,1,31036
990,2142576,2144365,True,1,1789
991,2144886,2148599,True,1,3713
992,2149851,2150523,True,1,672
993,2154676,2156332,True,1,1656
994,2160392,2181465,False,1,21073
995,2170734,2183435,False,1,12701
996,2173407,2174533,False,1,1126
997,2173407,2174533,True,3,1126
998,2174897,2177646,True,1,2749
999,2175296,2176046,False,1,750
1000,2175296,2176046,True,1,750
1001,2179115,2179891,True,4,776
1002,2187957,2193299,True,1,5342
1003,2187957,2200044,True,1,12087
1004,2190063,2192070,True,1,2007
1005,2190134,2190821,True,1,687
1006,2190134,2190924,True,2,790
1007,2190236,2190922,True,1,686
1008,2190236,2191025,True,2,789
1009,2190505,2192694,True,1,2189
1010,2190746,2191433,True,1,687
1011,2190746,2191536,True,2,790
1012,2190818,2191505,True,1,687
1013,2190818,2191608,True,2,790
1014,2191058,2213531,True,1,22473
1015,2191864,2191992,False,1,128
1016,2191864,2191992,True,2,128
1017,2191964,2192092,False,1,128
1018,2191964,2192092,True,2,128
1019,2192474,2192699,True,1,225
1020,2192474,2246991,False,1,54517
1021,2192476,2192604,False,1,128
1022,2192476,2192604,True,2,128
1023,2192548,2192676,False,1,128
1024,2192548,2192676,True,2,128
1025,2192574,2192799,True,1,225
1026,2193158,2193383,True,1,225
1027,2193618,2193925,True,1,307
1028,2194739,2194862,False,1,123
1029,2194937,2195060,True,1,123
1030,2195108,2195238,True,1,130
1031,2195859,2196303,False,1,444
1032,2195959,2196403,False,1,444
1033,2196381,2196844,False,1,463
1034,2196471,2196915,False,1,444
1035,2196543,2196987,False,1,444
1036,2198784,2205378,True,2,6594
1037,2200891,2237315,False,1,36424
1038,2200891,2237315,True,2,36424
1039,2201056,2237315,False,2,36259
1040,2204847,2220397,True,1,15550
1041,2205683,2220829,False,1,15146
1042,2205683,2220829,True,2,15146
1043,2208061,2209118,True,2,1057
1044,2209576,2209831,True,1,255
1045,2216335,2216408,True,3,73
1046,2218181,2219034,False,1,853
1047,2218591,2218929,True,1,338
1048,2218591,2218948,True,1,357
1049,2219426,2243412,False,1,23986
1050,2220211,2223178,True,1,2967
1051,2230309,2230488,True,1,179
1052,2230607,2230998,True,1,391
1053,2231431,2259254,True,1,27823
1054,2231456,2232180,True,1,724
1055,2242800,2243688,False,1,888
1056,2243753,2252884,True,1,9131
1057,2245554,2251595,True,1,6041
1058,2253322,2254274,True,1,952
1059,2253322,2257483,True,1,4161
1060,2255679,2258763,True,1,3084
1061,2264680,2265367,True,1,687
1062,2264680,2265470,True,2,790
1063,2266410,2266538,False,1,128
1064,2266410,2266538,True,2,128
1065,2267020,2320962,False,2,53942
1066,2269423,2324228,True,2,54805
1067,2269423,2396988,True,1,127565
1068,2269441,2324237,True,1,54796
1069,2270405,2270849,False,1,444
1070,2273841,2273969,False,1,128
1071,2274651,2329241,True,1,54590
1072,2278227,2278664,True,1,437
1073,2278235,2278299,True,2,64
1074,2278235,2278320,True,1,85
1075,2278819,2281720,True,1,2901
1076,2287433,2289451,True,10,2018
1077,2287433,2294757,False,1,7324
1078,2287433,2294777,False,1,7344
1079,2287433,2296279,True,3,8846
1080,2287779,2293215,False,1,5436
1081,2291370,2291534,False,1,164
1082,2293710,2293787,True,1,77
1083,2293931,2294039,True,1,108
1084,2297199,2298068,False,1,869
1085,2299560,2299690,False,1,130
1086,2299567,2299690,True,1,123
1087,2300268,2442255,True,1,141987
1088,2300289,2300412,False,1,123
1089,2300362,2300492,False,1,130
1090,2300406,2300529,True,2,123
1091,2300406,2353422,True,1,53016
1092,2300417,2442579,True,1,142162
1093,2300421,2300550,True,5,129
1094,2300487,2300610,True,1,123
1095,2301008,2301138,False,1,130
1096,2301052,2301175,True,2,123
1097,2301625,2302203,True,1,578
1098,2302136,2302714,True,1,578
1099,2303278,2305805,True,1,2527
1100,2303562,2445618,False,1,142056
1101,2303640,2356547,True,1,52907
1102,2304288,2357454,True,1,53166
1103,2305355,2306123,False,1,768
1104,2305355,2306123,True,1,768
1105,2305471,2306123,False,1,652
1106,2305471,2306123,True,1,652
1107,2305584,2311704,False,2,6120
1108,2306129,2359433,False,1,53304
1109,2316840,2317313,True,1,473
1110,2319307,2320940,True,1,1633
1111,2322164,2324908,True,3,2744
1112,2323445,2325627,True,2,2182
1113,2324242,2348219,False,1,23977
1114,2325058,2349017,False,1,23959
1115,2325700,2325771,True,1,71
1116,2325724,2349709,False,1,23985
1117,2346848,2347892,False,1,1044
1118,2355851,2356038,True,1,187
1119,2366638,2381739,True,1,15101
1120,2368392,2371608,True,1,3216
1121,2373684,2373814,False,1,130
1122,2373691,2373814,True,1,123
1123,2378624,2378752,False,1,128
1124,2379426,2379554,False,1,128
1125,2380133,2380261,False,1,128
1126,2380158,2380714,True,5,556
1127,2383405,2384625,False,1,1220
1128,2384728,2385317,False,1,589
1129,2385052,2406220,True,1,21168
1130,2385402,2387629,True,1,2227
1131,2385419,2387629,True,1,2210
1132,2389669,2389731,False,1,62
1133,2398376,2422287,False,1,23911
1134,2400386,2403213,False,1,2827
1135,2403676,2410568,True,1,6892
1136,2405419,2405547,True,2,128
1137,2406205,2406334,True,3,129
1138,2406710,2406958,True,2,248
1139,2407132,2407731,True,1,599
1140,2407371,2407500,True,1,129
1141,2407920,2408519,True,1,599
1142,2408058,2408298,True,1,240
1143,2408253,2408583,True,1,330
1144,2409086,2409685,True,1,599
1145,2411438,2411926,True,2,488
1146,2411449,2411934,True,1,485
1147,2411637,2412198,False,1,561
1148,2412148,2415194,True,1,3046
1149,2412999,2424211,True,1,11212
1150,2413587,2415827,True,1,2240
1151,2414798,2414927,True,5,129
1152,2415516,2415777,False,1,261
1153,2418998,2451520,False,1,32522
1154,2419771,2428924,False,1,9153
1155,2421663,2422886,False,1,1223
1156,2421663,2443412,False,1,21749
1157,2426839,2427095,False,1,256
1158,2427359,2427658,False,1,299
1159,2427905,2433271,True,1,5366
1160,2428358,2428487,False,1,129
1161,2428358,2429876,False,1,1518
1162,2431861,2432419,True,2,558
1163,2435103,2435190,True,1,87
1164,2435183,2436844,True,2,1661
1165,2440099,2441243,False,1,1144
1166,2441819,2442286,False,1,467
1167,2451221,2457801,True,1,6580
1168,2452561,2454051,True,4,1490
1169,2452632,2452761,False,1,129
1170,2456851,2456964,True,3,113
1171,2461220,2463369,True,1,2149
1172,2463337,2466323,True,1,2986
1173,2469408,2469474,True,1,66
1174,2471769,2473907,False,1,2138
1175,2472853,2474989,False,1,2136
1176,2479319,2479447,True,2,128
1177,2481032,2481631,True,1,599
1178,2483342,2485480,False,1,2138
1179,2483738,2484201,True,2,463
1180,2486487,2487124,True,1,637
1181,2487364,2508508,True,1,21144
1182,2488093,2488286,True,1,193
1183,2488093,2488457,True,1,364
1184,2488717,2491203,True,2,2486
1185,2488756,2489584,False,1,828
1186,2488889,2524670,False,1,35781
1187,2489118,2489297,True,1,179
1188,2494000,2494255,True,2,255
1189,2494268,2494360,False,1,92
1190,2494268,2494360,True,8,92
1191,2496626,2505336,False,2,8710
1192,2496626,2505336,True,2,8710
1193,2497210,2498438,True,1,1228
1194,2507232,2507767,False,2,535
1195,2507232,2507767,True,4,535
1196,2508964,2509894,True,1,930
1197,2509604,2524075,False,1,14471
1198,2510549,2514035,True,1,3486
1199,2510927,2514112,True,1,3185
1200,2510927,2537943,False,1,27016
1201,2510927,2550285,True,1,39358
1202,2520169,2520402,True,3,233
1203,2520624,2522356,True,1,1732
1204,2525125,2525559,False,1,434
1205,2525125,2557332,False,1,32207
1206,2525988,2558510,False,1,32522
1207,2528345,2528741,True,1,396
1208,2529900,2532303,True,4,2403
1209,2533495,2533795,False,1,300
1210,2533641,2533741,True,1,100
1211,2534349,2534648,False,1,299
1212,2534496,2536014,True,1,1518
1213,2535348,2535477,False,1,129
1214,2535348,2536866,False,1,1518
1215,2535858,2537291,True,1,1433
1216,2536442,2568636,False,1,32194
1217,2538164,2540752,False,4,2588
1218,2538675,2540191,True,3,1516
1219,2538684,2538799,True,1,115
1220,2538718,2539053,True,1,335
1221,2538955,2539201,True,1,246
1222,2539540,2542128,False,2,2588
1223,2542552,2544012,True,3,1460
1224,2543746,2543844,True,1,98
1225,2544811,2545110,False,1,299
1226,2544828,2546966,False,1,2138
1227,2545580,2545807,True,1,227
1228,2545810,2545939,False,1,129
1229,2545810,2547328,True,1,1518
1230,2550498,2550805,False,1,307
1231,2550498,2550805,True,1,307
1232,2550649,2551447,False,2,798
1233,2550649,2551758,True,1,1109
1234,2551348,2552699,True,1,1351
1235,2551984,2552114,True,1,130
1236,2552121,2553199,True,1,1078
1237,2552303,2552433,True,1,130
1238,2554740,2554895,False,1,155
1239,2557149,2557233,True,2,84
1240,2557481,2557678,True,1,197
1241,2557666,2558159,True,1,493
1242,2557972,2559436,True,1,1464
1243,2567441,2589436,False,1,21995
1244,2567441,2589436,True,5,21995
1245,2572459,2581694,True,1,9235
1246,2576782,2577296,True,2,514
1247,2577079,2577296,True,3,217
1248,2581406,2581615,True,1,209
1249,2581693,2581996,True,4,303
1250,2582478,2582613,True,1,135
1251,2585112,2585352,True,1,240
1252,2586140,2586739,True,1,599
1253,2587487,2592305,True,1,4818
1254,2592862,2614017,True,1,21155
1255,2594080,2602827,True,4,8747
1256,2594354,2615496,True,1,21142
1257,2597276,2598446,True,1,1170
1258,2597950,2631214,False,1,33264
1259,2598242,2644957,False,1,46715
1260,2604152,2625265,True,1,21113
1261,2606319,2606618,False,1,299
1262,2606900,2609165,True,1,2265
1263,2607318,2607447,False,1,129
1264,2607318,2608836,True,1,1518
1265,2607382,2609363,True,1,1981
1266,2612159,2659706,False,2,47547
1267,2612412,2659706,False,1,47294
1268,2612635,2612787,True,1,152
1269,2613204,2613339,True,1,135
1270,2618391,2618487,True,4,96
1271,2618572,2639831,True,1,21259
1272,2621358,2622045,True,1,687
1273,2621358,2622148,True,2,790
1274,2623088,2623216,False,1,128
1275,2623088,2623216,True,2,128
1276,2627083,2627527,False,1,444
1277,2629900,2632303,True,4,2403
1278,2633863,2634259,True,1,396
1279,2635331,2635727,True,1,396
1280,2636567,2638728,True,2,2161
1281,2637138,2638105,True,1,967
1282,2642030,2644662,False,1,2632
1283,2644052,2644245,False,1,193
1284,2644052,2644245,True,4,193
1285,2644213,2644328,True,1,115
1286,2644484,2644730,True,1,246
1287,2645071,2645467,True,1,396
1288,2645670,2645785,True,1,115
1289,2645941,2646187,True,1,246
1290,2649839,2670022,True,1,20183
1291,2649907,2652043,False,1,2136
1292,2651590,2664558,True,1,12968
1293,2651590,2664728,True,1,13138
1294,2654328,2654919,True,1,591
1295,2655404,2655519,True,1,115
1296,2655675,2655921,True,1,246
1297,2656145,2656943,False,2,798
1298,2656145,2657254,True,1,1109
1299,2657635,2658433,False,2,798
1300,2657635,2658744,True,1,1109
1301,2662972,2663169,True,1,197
1302,2663463,2664927,True,1,1464
1303,2664467,2664664,True,1,197
1304,2664958,2666422,True,1,1464
1305,2667372,2668170,False,2,798
1306,2667372,2668481,True,1,1109
1307,2667800,2688932,True,1,21132
1308,2669976,2670447,True,1,471
1309,2669978,2670445,True,1,467
1310,2674205,2674402,True,1,197
1311,2674696,2676160,True,1,1464
1312,2674911,2678462,True,1,3551
1313,2675464,2681338,False,1,5874
1314,2675464,2681338,True,6,5874
1315,2675464,2689261,True,1,13797
1316,2681678,2682699,True,1,1021
1317,2682651,2682979,True,1,328
1318,2688340,2688882,True,1,542
1319,2690137,2698748,True,1,8611
1320,2700336,2702338,True,2,2002
1321,2703024,2735216,False,1,32192
1322,2703242,2706239,True,2,2997
1323,2705239,2708488,True,1,3249
1324,2705239,2725831,True,1,20592
1325,2705603,2708852,False,1,3249
1326,2705603,2708852,True,1,3249
1327,2708728,2709229,True,1,501
1328,2708728,2709974,True,1,1246
1329,2708728,2709993,True,1,1265
1330,2708757,2709153,True,1,396
1331,2709994,2711296,True,2,1302
1332,2711391,2711690,False,1,299
1333,2712390,2712519,False,1,129
1334,2712390,2713908,True,1,1518
1335,2712770,2713328,True,2,558
1336,2715716,2715838,True,1,122
1337,2718425,2723172,True,1,4747
1338,2718573,2723172,True,1,4599
1339,2719096,2719211,True,1,115
1340,2719367,2719613,True,1,246
1341,2719401,2721973,True,1,2572
1342,2719401,2723646,True,2,4245
1343,2720083,2729014,True,1,8931
1344,2721741,2722279,True,1,538
1345,2722456,2723695,True,1,1239
1346,2723272,2724439,True,1,1167
1347,2727627,2727852,False,1,225
1348,2728092,2728287,True,1,195
1349,2728117,2728312,True,1,195
1350,2728171,2728482,True,1,311
1351,2728502,2743371,False,1,14869
1352,2729145,2729370,False,1,225
1353,2729689,2730000,True,1,311
1354,2731067,2731865,False,2,798
1355,2731067,2732176,True,1,1109
1356,2736525,2738013,True,3,1488
1357,2737899,2738096,True,1,197
1358,2738390,2739854,True,1,1464
1359,2738467,2738590,True,1,123
1360,2738815,2739040,False,1,225
1361,2739359,2739670,True,1,311
1362,2741955,2742056,False,1,101
1363,2742103,2743207,True,1,1104
1364,2742103,2743602,True,1,1499
1365,2742337,2742413,True,1,76
1366,2743262,2746371,True,1,3109
1367,2747541,2747641,True,1,100
1368,2748041,2750509,False,1,2468
1369,2756168,2866360,False,1,110192
1370,2763154,2787140,False,1,23986
1371,2767132,2767230,True,1,98
1372,2767355,2772144,True,4,4789
1373,2767647,2771514,True,3,3867
1374,2769261,2773043,True,2,3782
1375,2770730,2791855,True,1,21125
1376,2771206,2772492,True,1,1286
1377,2772597,2774736,True,1,2139
1378,2775464,2781338,False,1,5874
1379,2775464,2781338,True,6,5874
1380,2775464,2789261,True,1,13797
1381,2781421,2784997,True,1,3576
1382,2785773,2786053,False,1,280
1383,2786946,2789560,True,4,2614
1384,2787777,2793932,True,1,6155
1385,2793744,2794286,True,1,542
1386,2794522,2795937,True,1,1415
1387,2795302,2795844,True,1,542
1388,2795561,2804173,True,1,8612
1389,2796834,2796934,True,1,100
1390,2797043,2797222,True,6,179
1391,2797119,2805729,True,1,8610
1392,2798849,2799128,True,1,279
1393,2802601,2802826,False,1,225
1394,2803145,2803456,True,1,311
1395,2803242,2806239,True,2,2997
1396,2803917,2804000,True,1,83
1397,2811327,2816127,True,2,4800
1398,2811673,2812069,True,1,396
1399,2812630,2813523,True,1,893
1400,2813772,2815652,True,1,1880
1401,2814632,2819815,True,1,5183
1402,2815384,2825080,True,3,9696
1403,2817569,2817697,False,1,128
1404,2822012,2822127,True,1,115
1405,2822283,2822529,True,1,246
1406,2822733,2868396,False,1,45663
1407,2822733,2868396,True,5,45663
1408,2825063,2825391,True,1,328
1409,2827167,2827705,True,1,538
1410,2827530,2827832,True,2,302
1411,2827882,2829121,True,1,1239
1412,2828721,2829259,True,1,538
1413,2829436,2830675,True,1,1239
1414,2829601,2830296,True,2,695
1415,2829601,2830446,True,2,845
1416,2832414,2833259,True,1,845
1417,2833983,2834781,False,2,798
1418,2833983,2835092,True,1,1109
1419,2834549,2835410,True,2,861
1420,2834554,2835410,True,3,856
1421,2836453,2844994,True,2,8541
1422,2840599,2841222,False,1,623
1423,2840815,2841012,True,1,197
1424,2841306,2842770,True,1,1464
1425,2842379,2842649,True,1,270
1426,2844151,2844280,True,5,129
1427,2845114,2846153,True,2,1039
1428,2845355,2845933,True,1,578
1429,2845866,2846444,True,1,578
1430,2847362,2849115,True,4,1753
1431,2848718,2851827,True,1,3109
1432,2849811,2862263,True,1,12452
1433,2850242,2853351,True,1,3109
1434,2863808,2888940,True,1,25132
1435,2865244,2889649,True,1,24405
1436,2868578,2872684,False,1,4106
1437,2868770,2869312,True,1,542
1438,2870587,2879191,True,1,8604
1439,2876789,2877166,True,1,377
1440,2884236,2884324,False,1,88
1441,2892396,2895011,True,4,2615
1442,2893926,2896540,True,4,2614
1443,2895375,2898912,True,2,3537
1444,2895979,2899299,True,1,3320
1445,2897247,2897678,True,1,431
1446,2898859,2900909,True,14,2050
1447,2898859,2931866,True,1,33007
1448,2899128,2946321,True,2,47193
1449,2900484,2903128,True,2,2644
1450,2902122,2902201,True,1,79
1451,2902166,2902704,True,1,538
1452,2902881,2904120,True,1,1239
1453,2903270,2907885,False,1,4615
1454,2904428,2904531,True,2,103
1455,2904980,2905522,True,1,542
1456,2905461,2905686,False,1,225
1457,2906005,2906316,True,1,311
1458,2906797,2915408,True,1,8611
1459,2909591,2911727,False,1,2136
1460,2910696,2911214,True,1,518
1461,2911327,2916127,True,2,4800
1462,2912216,2913216,True,2,1000
1463,2915332,2916193,True,1,861
1464,2915498,2916394,True,1,896
1465,2919156,2921551,False,1,2395
1466,2919226,2921106,True,1,1880
1467,2920752,2922632,True,1,1880
1468,2923584,2940532,False,1,16948
1469,2923728,2926837,True,1,3109
1470,2925491,2928403,True,2,2912
1471,2927555,2928053,False,1,498
1472,2938401,2938939,True,1,538
1473,2938902,2939776,False,2,874
1474,2939116,2940355,True,1,1239
1475,2940165,2940266,True,1,101
1476,2940357,2940435,True,1,78
1477,2941044,2941124,True,1,80
1478,2943840,2944415,True,1,575
1479,2944413,2953654,True,4,9241
1480,2948302,2948729,True,1,427
1481,2948302,2948734,True,1,432
1482,2948456,2951850,True,1,3394
1483,2948456,2951970,True,1,3514
1484,2950109,2955480,True,1,5371
1485,2954599,2956299,True,1,1700
1486,2956754,2957584,True,2,830
1487,2957926,2958800,True,1,874
1488,2959914,2963023,True,1,3109
1489,2962730,2995251,False,1,32521
1490,2963632,2963776,True,3,144
1491,2964825,2965244,True,1,419
1492,2965430,2965999,True,1,569
1493,2965489,2966058,True,1,569
1494,2966576,2967145,True,1,569
1495,2967382,2969984,True,4,2602
1496,2968923,2969055,True,1,132
1497,2968923,2969138,True,1,215
1498,2971091,2971390,False,1,299
1499,2971644,2972186,True,1,542
1500,2972090,2972219,False,1,129
1501,2972090,2973608,False,1,1518
1502,2973461,2982065,True,1,8604
1503,2976993,2985939,False,1,8946
1504,2976993,2985939,True,1,8946
1505,2977891,2982640,True,2,4749
1506,2978822,2991945,True,1,13123
1507,2982402,2983207,True,3,805
1508,2982406,2983215,True,1,809
1509,2982547,2986455,True,2,3908
1510,2989327,2989420,True,1,93
1511,2989690,2989778,False,1,88
1512,2991216,2991304,False,1,88
1513,2991651,2991938,True,3,287
1514,2992807,2994911,False,1,2104
1515,2994184,2996064,True,1,1880
1516,2998027,3007587,True,1,9560
1517,3003564,3006178,True,4,2614
1518,3005040,3005578,True,1,538
1519,3005755,3006994,True,1,1239
1520,3009696,3014950,True,1,5254
1521,3010696,3011214,True,1,518
1522,3011331,3011603,True,3,272
1523,3020240,3020392,True,1,152
1524,3026586,3029695,True,1,3109
1525,3029983,3032695,True,1,2712
1526,3030370,3032249,True,1,1879
1527,3031094,3052242,True,1,21148
1528,3038902,3039776,False,2,874
1529,3040642,3040870,True,1,228
1530,3042166,3042394,True,1,228
1531,3044413,3053654,True,4,9241
1532,3045402,3045550,True,1,148
1533,3048317,3049374,True,1,1057
1534,3049878,3083295,True,3,33417
1535,3050374,3050549,True,1,175
1536,3056067,3056233,True,1,166
1537,3064670,3064758,False,1,88
1538,3066940,3137277,True,1,70337
1539,3070240,3072842,True,4,2602
1540,3071904,3078069,False,1,6165
1541,3072083,3072479,True,1,396
1542,3072519,3073254,True,1,735
1543,3076062,3077152,False,1,1090
1544,3076062,3077152,True,3,1090
1545,3076169,3076321,True,1,152
1546,3082422,3082537,True,1,115
1547,3082693,3082939,True,1,246
1548,3086957,3087596,True,1,639
1549,3086957,3087631,True,1,674
1550,3091171,3091825,True,2,654
1551,3094387,3095185,False,2,798
1552,3094387,3095496,True,1,1109
1553,3097042,3098922,True,1,1880
1554,3098268,3104904,False,1,6636
1555,3099357,3099642,True,1,285
1556,3099782,3106418,False,1,6636
1557,3100836,3100924,False,1,88
1558,3101219,3101416,True,1,197
1559,3101373,3103243,False,2,1870
1560,3101710,3103174,True,1,1464
1561,3101807,3102680,True,6,873
1562,3102724,3103130,True,2,406
1563,3102887,3104757,False,2,1870
1564,3103683,3110456,True,1,6773
1565,3103738,3104904,False,1,1166
1566,3105252,3106418,False,1,1166
1567,3105630,3120583,False,1,14953
1568,3108172,3108322,True,1,150
1569,3111589,3122128,True,1,10539
1570,3114814,3115042,True,1,228
1571,3116646,3118931,True,1,2285
1572,3118478,3119326,True,1,848
1573,3120935,3121034,True,1,99
1574,3121578,3128642,True,2,7064
1575,3129176,3129502,True,1,326
1576,3135312,3135719,True,2,407
1577,3135730,3142366,False,1,6636
1578,3136453,3136726,True,1,273
1579,3137300,3137691,True,1,391
1580,3137749,3142931,True,1,5182
1581,3137918,3167628,True,1,29710
1582,3138835,3140705,False,1,1870
1583,3140901,3149150,True,1,8249
1584,3141200,3142366,False,1,1166
1585,3142317,3142396,True,9,79
1586,3144473,3146367,False,1,1894
1587,3150972,3151200,False,1,228
1588,3151384,3151695,False,1,311
1589,3154084,3154302,True,1,218
1590,3154833,3155008,True,2,175
1591,3155214,3157766,True,1,2552
1592,3155215,3155905,False,1,690
1593,3155615,3158231,False,1,2616
1594,3156913,3157451,True,1,538
1595,3157538,3162674,True,1,5136
1596,3165939,3166164,False,1,225
1597,3166483,3166794,True,1,311
1598,3166940,3237277,True,1,70337
1599,3168213,3175577,True,1,7364
1600,3168687,3169246,True,3,559
1601,3172426,3179063,False,1,6637
1602,3173760,3175645,False,1,1885
1603,3174707,3176708,True,1,2001
1604,3175180,3177073,True,1,1893
1605,3175531,3177401,False,2,1870
1606,3176215,3178216,True,1,2001
1607,3176268,3177460,True,1,1192
1608,3176268,3177480,True,1,1212
1609,3176688,3178581,True,1,1893
1610,3177776,3178968,True,1,1192
1611,3177776,3178988,True,1,1212
1612,3177896,3179063,False,1,1167
1613,3178816,3182562,True,1,3746
1614,3180424,3181433,True,1,1009
1615,3181932,3182941,True,1,1009
1616,3182559,3190751,True,1,8192
1617,3188268,3212446,False,1,24178
1618,3189569,3212952,False,1,23383
1619,3190396,3192702,True,4,2306
1620,3195367,3196562,True,1,1195
1621,3197613,3200475,False,2,2862
1622,3198419,3198775,False,2,356
1623,3202803,3204159,True,1,1356
1624,3204880,3234787,False,1,29907
1625,3204944,3208776,True,1,3832
1626,3208622,3215262,False,1,6640
1627,3211712,3211780,True,3,68
1628,3211730,3213601,False,2,1871
1629,3211912,3212003,True,1,91
1630,3212177,3214178,True,1,2001
1631,3212650,3214543,True,1,1893
1632,3213218,3213286,True,3,68
1633,3213418,3213509,True,1,91
1634,3213738,3214930,True,1,1192
1635,3213738,3214950,True,1,1212
1636,3214096,3215262,False,1,1166
1637,3214455,3215727,True,2,1272
1638,3217599,3218874,True,1,1275
1639,3217894,3218903,True,1,1009
1640,3219598,3221287,False,1,1689
1641,3219877,3224057,False,1,4180
1642,3220047,3221249,True,1,1202
1643,3220079,3220663,True,3,584
1644,3220656,3220989,True,1,333
1645,3221136,3221492,True,1,356
1646,3221136,3224570,True,3,3434
1647,3223177,3225734,False,1,2557
1648,3230490,3231792,False,2,1302
1649,3230986,3231792,False,1,806
1650,3232105,3234219,False,1,2114
1651,3232118,3232660,True,1,542
1652,3233935,3242549,True,1,8614
1653,3238342,3238886,False,1,544
1654,3239743,3251098,True,1,11355
1655,3239743,3253488,True,1,13745
1656,3248500,3248739,True,2,239
1657,3248869,3250870,True,1,2001
1658,3249180,3249248,True,3,68
1659,3249342,3251235,True,1,1893
1660,3249380,3249471,True,1,91
1661,3250430,3251622,True,1,1192
1662,3250430,3251642,True,1,1212
1663,3254586,3255595,True,1,1009
1664,3255913,3261505,True,1,5592
1665,3258545,3259322,False,1,777
1666,3258545,3261557,False,1,3012
1667,3258545,3261758,False,1,3213
1668,3258614,3259391,False,1,777
1669,3258614,3261626,False,1,3012
1670,3260044,3261796,True,1,1752
1671,3262888,3263161,True,1,273
1672,3263738,3264129,True,1,391
1673,3265545,3266083,True,1,538
1674,3266260,3267499,True,1,1239
1675,3267454,3267720,True,1,266
1676,3268607,3268686,False,1,79
1677,3268607,3268686,True,4,79
1678,3271756,3272003,True,1,247
1679,3272452,3273067,True,1,615
1680,3273753,3274836,True,1,1083
1681,3274251,3275926,False,1,1675
1682,3280623,3280707,True,3,84
1683,3282035,3284657,True,1,2622
1684,3284941,3287521,True,1,2580
1685,3284941,3298310,True,2,13369
1686,3285055,3287056,True,1,2001
1687,3285300,3285362,True,1,62
1688,3285528,3287421,True,1,1893
1689,3285866,3285934,True,3,68
1690,3286066,3286157,True,1,91
1691,3286616,3287808,True,1,1192
1692,3286616,3287828,True,1,1212
1693,3287078,3290187,True,1,3109
1694,3290772,3291781,True,1,1009
1695,3292331,3294413,True,2,2082
1696,3292689,3294603,True,1,1914
1697,3295701,3298549,True,2,2848
1698,3295701,3298579,True,1,2878
1699,3312255,3317736,True,1,5481
1700,3313137,3322403,True,1,9266
1701,3314404,3315017,True,1,613
1702,3321147,3322820,False,1,1673
1703,3321147,3322820,True,2,1673
1704,3322062,3322130,True,3,68
1705,3322264,3322355,True,1,91
1706,3322785,3324950,True,1,2165
1707,3328701,3348300,True,1,19599
1708,3329626,3340612,True,1,10986
1709,3330665,3335453,True,1,4788
1710,3330784,3333395,True,4,2611
1711,3337575,3338713,True,1,1138
1712,3351134,3377195,True,1,26061
1713,3357574,3359452,True,1,1878
1714,3364578,3370035,False,1,5457
1715,3367169,3367674,True,4,505
1716,3367561,3369155,True,1,1594
1717,3367829,3424284,True,1,56455
1718,3368101,3375970,True,1,7869
1719,3368186,3376055,True,1,7869
1720,3371370,3371529,True,1,159
1721,3371437,3371637,True,1,200
1722,3373822,3374491,False,1,669
1723,3389966,3391025,True,4,1059
1724,3409763,3409921,False,1,158
1725,3419085,3419257,False,1,172
1726,3421147,3422820,False,1,1673
1727,3421147,3422820,True,2,1673
1728,3423920,3430965,True,1,7045
1729,3428050,3428138,False,1,88
1730,3428701,3448300,True,1,19599
1731,3435216,3435483,True,2,267
1732,3436833,3436919,False,1,86
1733,3436833,3436919,True,1,86
1734,3436833,3437555,True,1,722
1735,3446586,3448362,True,3,1776
1736,3452530,3466683,True,1,14153
1737,3456634,3461785,True,2,5151
1738,3456634,3463715,True,2,7081
1739,3456634,3470119,False,1,13485
1740,3460836,3465775,True,1,4939
1741,3466166,3466258,True,1,92
1742,3466692,3479367,True,1,12675
1743,3468101,3475970,True,1,7869
1744,3468186,3476055,True,1,7869
1745,3476948,3478873,True,1,1925
1746,3479004,3479232,True,1,228
1747,3480577,3481799,True,1,1222
1748,3497685,3532735,True,1,35050
1749,3500384,3500513,False,1,129
1750,3500384,3500513,True,2,129
1751,3500890,3501133,True,1,243
1752,3501834,3501963,False,1,129
1753,3501834,3501963,True,2,129
1754,3502340,3502583,True,1,243
1755,3508198,3509165,False,1,967
1756,3508514,3528811,True,1,20297
1757,3510298,3522534,True,1,12236
1758,3512878,3530776,False,1,17898
1759,3512878,3530776,True,5,17898
1760,3536490,3543126,False,1,6636
1761,3539595,3541465,False,2,1870
1762,3541960,3543126,False,1,1166
1763,3544427,3546359,True,1,1932
1764,3544427,3563665,True,2,19238
1765,3548881,3549012,True,1,131
1766,3557103,3560108,False,1,3005
1767,3565342,3566889,False,1,1547
1768,3565342,3566889,True,2,1547
1769,3579134,3579263,False,1,129
1770,3579134,3579263,True,2,129
1771,3579640,3579883,True,1,243
1772,3588663,3588975,True,3,312
1773,3590230,3590596,True,4,366
1774,3591329,3596538,False,1,5209
1775,3597559,3598402,True,1,843
1776,3598913,3599015,True,2,102
1777,3600603,3663668,True,1,63065
1778,3600639,3663682,True,1,63043
1779,3603158,3603928,True,1,770
1780,3606356,3606438,True,2,82
1781,3609050,3609431,True,4,381
1782,3610506,3610887,True,4,381
1783,3610710,3610839,False,1,129
1784,3610710,3610839,True,1,129
1785,3611216,3611459,True,1,243
1786,3612931,3614932,True,1,2001
1787,3613404,3615297,True,1,1893
1788,3613738,3614877,True,1,1139
1789,3613902,3614981,True,1,1079
1790,3614492,3615684,True,1,1192
1791,3614492,3615704,True,1,1212
1792,3616412,3620599,True,1,4187
1793,3618648,3619657,True,1,1009
1794,3629505,3630594,True,1,1089
1795,3631397,3631466,True,2,69
1796,3631885,3631969,True,1,84
1797,3633508,3633912,False,1,404
1798,3635520,3636218,True,1,698
1799,3635520,3639902,True,1,4382
1800,3636976,3637674,True,1,698
1801,3636976,3641358,True,1,4382
1802,3641087,3641200,False,1,113
1803,3641087,3641200,True,1,113
1804,3644409,3644498,True,1,89
1805,3644906,3644974,True,1,68
1806,3645343,3645707,False,1,364
1807,3646530,3646911,False,1,381
1808,3646530,3646911,True,1,381
1809,3646703,3646932,True,2,229
1810,3649116,3655015,True,1,5899
1811,3649930,3649998,True,3,68
1812,3650130,3650221,True,1,91
1813,3654156,3654458,True,3,302
1814,3655506,3657579,True,1,2073
1815,3656360,3658939,True,1,2579
1816,3661715,3664565,True,1,2850
1817,3664318,3670167,True,3,5849
1818,3665776,3671627,True,3,5851
1819,3665969,3669468,True,2,3499
1820,3671519,3672964,True,2,1445
1821,3678282,3678411,False,1,129
1822,3678282,3678411,True,1,129
1823,3678788,3679031,True,1,243
1824,3679072,3766115,True,1,87043
1825,3682815,3684049,True,1,1234
1826,3682815,3685251,True,1,2436
1827,3682929,3684049,True,1,1120
1828,3687798,3688179,True,4,381
1829,3693011,3693387,True,1,376
1830,3697566,3698478,True,1,912
1831,3698629,3698718,True,2,89
1832,3707156,3715435,True,1,8279
1833,3707222,3707421,True,2,199
1834,3711291,3793261,True,7,81970
1835,3711504,3711995,True,1,491
1836,3711608,3712086,True,1,478
1837,3712755,3712850,True,1,95
1838,3714264,3714962,True,1,698
1839,3714264,3718646,True,1,4382
1840,3718486,3718856,True,3,370
1841,3719388,3719769,True,4,381
1842,3720495,3721135,True,1,640
1843,3721475,3721621,True,1,146
1844,3721838,3721981,True,1,143
1845,3722899,3723062,True,1,163
1846,3723427,3723703,True,2,276
1847,3724887,3725163,True,2,276
1848,3737739,3738411,True,1,672
1849,3743062,3748912,True,3,5850
1850,3745856,3746554,True,1,698
1851,3745856,3750238,True,1,4382
1852,3746391,3775473,True,4,29082
1853,3748626,3775514,True,1,26888
1854,3749975,3750895,True,2,920
1855,3750866,3751507,True,1,641
1856,3751997,3771568,True,1,19571
1857,3752256,3771827,True,1,19571
1858,3754398,3754479,True,3,81
1859,3754660,3756892,True,1,2232
1860,3755090,3765239,True,1,10149
1861,3755090,3766485,True,1,11395
1862,3756446,3757156,True,6,710
1863,3757019,3758567,True,2,1548
1864,3758481,3760029,True,2,1548
1865,3768350,3771766,True,2,3416
1866,3768350,3773237,True,1,4887
1867,3771667,3771817,False,1,150
1868,3772040,3772808,True,1,768
1869,3772886,3774087,True,1,1201
1870,3773547,3773713,True,1,166
1871,3774650,3780497,True,3,5847
1872,3775195,3775661,True,4,466
1873,3775511,3777957,False,1,2446
1874,3775527,3775711,True,2,184
1875,3776657,3777123,True,4,466
1876,3776989,3777173,True,2,184
1877,3780118,3791217,True,1,11099
1878,3784356,3793468,True,1,9112
1879,3784740,3793413,True,1,8673
1880,3786952,3787333,True,4,381
1881,3789126,3789963,False,2,837
1882,3789126,3789963,True,2,837
1883,3789126,3795454,True,1,6328
1884,3789126,3796859,True,1,7733
1885,3802069,3803298,True,1,1229
1886,3802169,3802445,True,2,276
1887,3804047,3805585,True,1,1538
1888,3805330,3808293,True,2,2963
1889,3806718,4076424,False,1,269706
1890,3809779,3811415,False,2,1636
1891,3809779,3811415,True,2,1636
1892,3810808,3817257,True,1,6449
1893,3810808,3820346,True,3,9538
1894,3810808,3823061,True,1,12253
1895,3813420,3814118,True,1,698
1896,3813420,3817802,True,1,4382
1897,3815709,3817962,True,1,2253
1898,3815709,3819398,True,1,3689
1899,3816252,3817962,True,1,1710
1900,3817169,3819422,True,1,2253
1901,3817169,3820858,True,1,3689
1902,3817712,3819422,True,1,1710
1903,3827844,3829209,True,3,1365
1904,3828275,3851929,True,1,23654
1905,3829304,3830669,True,3,1365
1906,3831660,3831885,True,1,225
1907,3833755,3834031,True,2,276
1908,3835763,3837311,True,2,1548
1909,3837277,3837986,True,1,709
1910,3842214,3848061,True,3,5847
1911,3842577,3843653,False,1,1076
1912,3844144,3870492,True,1,26348
1913,3853939,3854405,True,4,466
1914,3854271,3854455,True,2,184
1915,3856188,3860014,False,1,3826
1916,3856996,3861480,False,1,4484
1917,3859412,3866003,True,1,6591
1918,3859412,3866006,True,2,6594
1919,3859412,3872863,True,1,13451
1920,3866954,3870227,True,3,3273
1921,3867349,3868897,True,2,1548
1922,3873637,3873757,True,1,120
1923,3875096,3876985,True,2,1889
1924,3875350,3913645,True,1,38295
1925,3876554,3878443,True,2,1889
1926,3877937,3878047,True,3,110
1927,3881790,3883388,True,1,1598
1928,3881790,3884883,True,5,3093
1929,3882512,3893804,True,1,11292
1930,3882577,3910665,True,1,28088
1931,3885375,3885768,True,1,393
1932,3885525,3885991,True,4,466
1933,3885857,3886041,True,2,184
1934,3887179,3887308,True,1,129
1935,3888129,3888284,True,2,155
1936,3888129,3890335,True,1,2206
1937,3888207,3888362,False,3,155
1938,3888880,3889025,True,1,145
1939,3890801,3891173,True,1,372
1940,3891090,3891453,False,1,363
1941,3894455,3896708,True,1,2253
1942,3894455,3898144,True,1,3689
1943,3894998,3896708,True,1,1710
1944,3898408,3898740,False,1,332
1945,3898408,3898740,True,3,332
1946,3898408,3899489,True,1,1081
1947,3898408,3899511,True,2,1103
1948,3898408,3900306,True,1,1898
1949,3899866,3900198,False,1,332
1950,3899866,3900198,True,3,332
1951,3899866,3900947,True,1,1081
1952,3899866,3900969,True,2,1103
1953,3899866,3901764,True,1,1898
1954,3901321,3901597,True,2,276
1955,3901697,3907146,True,1,5449
1956,3905535,3905908,False,1,373
1957,3905728,3906631,True,1,903
1958,3906586,3907951,True,3,1365
1959,3907792,3908311,True,1,519
1960,3912522,3914411,True,2,1889
1961,3915979,3917410,True,1,1431
1962,3916794,3918225,True,1,1431
1963,3919243,3919566,True,1,323
1964,3921005,3923001,True,5,1996
1965,3921856,3923776,True,2,1920
1966,3923312,3925231,True,2,1919
1967,3923670,3929374,True,1,5704
1968,3926039,3928287,True,1,2248
1969,3926039,3929723,True,1,3684
1970,3926582,3928287,True,1,1705
1971,3928048,3931497,True,4,3449
1972,3931138,3932420,True,1,1282
1973,3932592,3933875,True,1,1283
1974,3934917,3936465,True,2,1548
1975,3935834,3936166,False,1,332
1976,3935834,3936166,True,3,332
1977,3935834,3936915,True,1,1081
1978,3935834,3936937,True,2,1103
1979,3935834,3937732,True,1,1898
1980,3937110,3940628,True,1,3518
1981,3938176,3939539,True,3,1363
1982,3938682,3938811,False,1,129
1983,3938682,3938811,True,2,129
1984,3939188,3939431,True,1,243
1985,3939464,3944612,True,1,5148
1986,3946643,3946935,True,2,292
1987,3948099,3948391,True,2,292
1988,3953093,3953559,True,4,466
1989,3953425,3953609,True,2,184
1990,3953838,3955727,False,1,1889
1991,3959280,3961199,True,2,1919
1992,3962358,3964330,True,1,1972
1993,3963812,3965784,True,1,1972
1994,3964048,3968786,True,1,4738
1995,3964959,3965596,True,1,637
1996,3966413,3967050,True,1,637
1997,3967011,3984423,False,1,17412
1998,3968560,3969843,True,1,1283
1999,3969670,3969761,True,4,91
2000,3972094,3972273,True,3,179
2001,3977296,3979172,True,2,1876
2002,3977377,3979010,True,1,1633
2003,3978748,3980623,True,2,1875
2004,3984067,3984359,True,2,292
2005,3985422,3987311,True,2,1889
2006,3986440,3992024,True,1,5584
2007,3986440,4030986,True,1,44546
2008,3989473,3990077,True,1,604
2009,3993611,3995864,True,1,2253
2010,3993611,3997300,True,1,3689
2011,3994154,3995864,True,1,1710
2012,3999780,4001752,True,1,1972
2013,4000606,4002525,True,2,1919
2014,4002381,4003018,True,1,637
2015,4005758,4007121,True,3,1363
2016,4008734,4009066,False,1,332
2017,4008734,4009066,True,3,332
2018,4008734,4009815,True,1,1081
2019,4008734,4009837,True,2,1103
2020,4008734,4010632,True,1,1898
2021,4008806,4008917,True,1,111
2022,4009886,4011169,True,1,1283
2023,4010266,4010377,True,1,111
2024,4010353,4010516,False,1,163
2025,4010453,4071784,True,1,61331
2026,4011138,4072123,True,1,60985
2027,4014716,4016591,True,1,1875
2028,4019271,4020668,True,2,1397
2029,4024332,4024557,False,1,225
2030,4024332,4024557,True,2,225
2031,4025393,4025685,True,2,292
2032,4030126,4030401,False,1,275
2033,4030745,4044326,True,3,13581
2034,4032182,4034101,True,2,1919
2035,4033423,4033509,False,1,86
2036,4033429,4033509,False,1,80
2037,4033633,4033712,False,1,79
2038,4033759,4034147,True,1,388
2039,4041110,4043082,True,1,1972
2040,4041462,4042745,True,1,1283
2041,4043711,4044348,True,1,637
2042,4044269,4046118,True,2,1849
2043,4047340,4047721,True,4,381
2044,4049218,4049300,True,1,82
2045,4050027,4050114,True,1,87
2046,4053000,4054889,True,2,1889
2047,4055185,4055255,False,1,70
2048,4056046,4057921,True,2,1875
2049,4056969,4057261,True,2,292
2050,4058267,4058341,True,4,74
2051,4068626,4068895,True,1,269
2052,4069655,4070576,True,1,921
2053,4072488,4102853,True,1,30365
2054,4072684,4074656,True,1,1972
2055,4073810,4074508,True,1,698
2056,4073810,4078192,True,1,4382
2057,4075285,4075922,True,1,637
2058,4075297,4077600,True,2,2303
2059,4076312,4076644,False,1,332
2060,4076312,4076644,True,3,332
2061,4076312,4077393,True,1,1081
2062,4076312,4077415,True,2,1103
2063,4076312,4078210,True,1,1898
2064,4077324,4077600,True,3,276
2065,4078674,4079308,True,1,634
2066,4078963,4083985,False,1,5022
2067,4080147,4081918,True,1,1771
2068,4087514,4087771,True,1,257
2069,4087582,4087693,True,1,111
2070,4087620,4089495,True,1,1875
2071,4087678,4087828,True,1,150
2072,4096238,4096353,True,2,115
2073,4097003,4103105,True,1,6102
2074,4099760,4101679,True,2,1919
2075,4101713,4106072,True,1,4359
2076,4102608,4108456,True,3,5848
2077,4109040,4110323,True,1,1283
2078,4110665,4113463,True,1,2798
2079,4112302,4112486,True,1,184
2080,4119136,4119247,True,1,111
2081,4122852,4123961,True,1,1109
2082,4124547,4124839,True,2,292
2083,4139833,4140052,True,1,219
2084,4140262,4142234,True,1,1972
2085,4142863,4143500,True,1,637
2086,4144457,4147842,True,2,3385
2087,4147670,4148337,True,1,667
2088,4147670,4148364,True,1,694
2089,4153745,4154259,False,1,514
2090,4153745,4154259,True,1,514
2091,4154087,4156449,True,2,2362
2092,4155198,4157073,True,1,1875
2093,4161717,4161993,True,2,276
2094,4163099,4163576,True,1,477
2095,4165348,4165939,True,1,591
2096,4166691,4169587,True,1,2896
2097,4166697,4169587,True,2,2890
2098,4167424,4207841,True,1,40417
2099,4176824,4198616,True,1,21792
2100,4179863,4179947,True,1,84
2101,4194028,4194116,True,3,88
2102,4195311,4196859,True,2,1548
2103,4196055,4196575,True,6,520
2104,4196055,4198388,True,1,2333
2105,4201329,4203778,True,1,2449
2106,4203253,4209670,True,4,6417
2107,4204325,4208867,True,1,4542
2108,4213487,4213953,True,4,466
2109,4213819,4214003,True,2,184
2110,4228697,4244393,True,1,15696
2111,4232850,4233339,False,2,489
2112,4232850,4240974,True,2,8124
2113,4242207,4246063,True,2,3856
2114,4247747,4248409,True,1,662
2115,4253997,4256250,True,1,2253
2116,4253997,4257686,True,1,3689
2117,4254540,4256250,True,1,1710
2118,4266128,4267493,True,3,1365
2119,4266514,4266924,True,1,410
2120,4276824,4298616,True,1,21792
2121,4278905,4278994,True,2,89
2122,4281211,4281505,True,1,294
2123,4281211,4282789,True,1,1578
2124,4282059,4282306,False,1,247
2125,4287427,4293130,True,1,5703
2126,4289658,4295361,True,1,5703
2127,4289756,4290147,True,1,391
2128,4290775,4291688,True,1,913
2129,4290775,4294751,True,2,3976
2130,4291738,4295193,True,1,3455
2131,4291986,4292377,True,1,391
2132,4293005,4293918,True,1,913
2133,4293005,4296981,True,2,3976
2134,4293085,4295960,True,1,2875
2135,4293968,4297423,True,1,3455
2136,4295315,4298190,True,1,2875
2137,4298730,4298822,True,1,92
2138,4299029,4299121,True,4,92
2139,4300960,4301052,True,1,92
2140,4301259,4301351,True,4,92
2141,4304386,4304909,True,1,523
2142,4304408,4326135,False,1,21727
2143,4304794,4305086,False,2,292
2144,4304794,4305086,True,5,292
2145,4306616,4307153,True,1,537
2146,4313355,4315012,False,1,1657
2147,4313376,4315265,True,2,1889
2148,4316347,4316633,True,1,286
2149,4317004,4318263,True,1,1259
2150,4317042,4318267,True,1,1225
2151,4317433,4318267,True,1,834
2152,4320882,4321947,True,1,1065
2153,4321307,4394548,True,1,73241
2154,4323934,4329230,False,1,5296
2155,4323934,4329230,True,1,5296
2156,4323934,4329341,False,1,5407
2157,4325192,4386803,True,23,61611
2158,4328411,4344857,True,1,16446
2159,4330395,4333270,True,1,2875
2160,4335827,4336646,True,1,819
2161,4336688,4337020,False,1,332
2162,4336688,4337020,True,3,332
2163,4336688,4337769,True,1,1081
2164,4336688,4337791,True,2,1103
2165,4336688,4338586,True,1,1898
2166,4338126,4338755,True,2,629
2167,4338126,4339156,True,1,1030
2168,4340380,4341009,True,2,629
2169,4340380,4341410,True,1,1030
2170,4350072,4350531,True,1,459
2171,4350072,4350536,True,1,464
2172,4350072,4350882,True,1,810
2173,4350323,4350657,True,1,334
2174,4350371,4350488,True,1,117
2175,4351370,4351487,False,2,117
2176,4351370,4351487,True,1,117
2177,4352326,4352785,True,1,459
2178,4352326,4352790,True,1,464
2179,4352326,4353136,True,1,810
2180,4352577,4352911,True,1,334
2181,4352625,4352742,True,1,117
2182,4353624,4353741,False,2,117
2183,4353624,4353741,True,1,117
2184,4360113,4360369,True,1,256
2185,4360130,4362050,True,2,1920
2186,4362235,4363021,True,3,786
2187,4362272,4363094,True,1,822
2188,4362385,4362641,True,1,256
2189,4363379,4363635,True,1,256
2190,4367870,4367990,True,1,120
2191,4369412,4370695,True,1,1283
2192,4370142,4370262,True,1,120
2193,4370780,4371618,True,6,838
2194,4373890,4374127,False,1,237
2195,4384419,4384550,True,1,131
2196,4384919,4385211,True,2,292
2197,4386697,4386828,True,1,131
2198,4396469,4396935,True,1,466
2199,4397623,4403326,True,1,5703
2200,4397629,4398590,True,1,961
2201,4399952,4400343,True,1,391
2202,4400632,4402604,True,1,1972
2203,4400971,4401884,True,1,913
2204,4400971,4404947,True,2,3976
2205,4401934,4405389,True,1,3455
2206,4403233,4403870,True,1,637
2207,4403281,4406156,True,1,2875
2208,4403580,4411043,True,1,7463
2209,4405866,4413329,True,1,7463
2210,4406157,4408505,True,1,2348
2211,4408926,4409018,True,1,92
2212,4409225,4409317,True,4,92
2213,4411657,4419680,True,1,8023
2214,4414558,4426096,True,1,11538
2215,4414582,4415099,True,1,517
2216,4415564,4417440,True,2,1876
2217,4422308,4422845,True,1,537
2218,4426720,4427518,False,1,798
2219,4432928,4433116,True,1,188
2220,4437693,4439833,True,1,2140
2221,4442446,4443274,True,1,828
2222,4447086,4447197,True,1,111
2223,4448314,4448943,True,2,629
2224,4448314,4449344,True,1,1030
2225,4453649,4453777,True,1,128
2226,4455830,4456084,True,1,254
2227,4459086,4787630,True,2,328544
2228,4459375,4467299,True,1,7924
2229,4460260,4460719,True,1,459
2230,4460260,4460724,True,1,464
2231,4460260,4461070,True,1,810
2232,4460511,4460845,True,1,334
2233,4460559,4460676,True,1,117
2234,4461558,4461675,False,2,117
2235,4461558,4461675,True,1,117
2236,4463982,4468048,True,2,4066
2237,4465367,4471070,True,1,5703
2238,4467058,4467149,False,1,91
2239,4467058,4467149,True,1,91
2240,4467696,4468087,True,1,391
2241,4468715,4472691,True,1,3976
2242,4469678,4473133,True,1,3455
2243,4470327,4470566,True,1,239
2244,4471025,4473900,True,1,2875
2245,4471321,4471560,True,1,239
2246,4473715,4480194,True,1,6479
2247,4476670,4476762,True,1,92
2248,4476969,4477061,True,1,92
2249,4478050,4478170,True,1,120
2250,4481844,4487642,True,3,5798
2251,4489250,4491486,True,1,2236
2252,4489457,4491551,True,1,2094
2253,4491502,4493713,True,1,2211
2254,4491709,4493778,False,1,2069
2255,4492150,4495055,False,2,2905
2256,4494639,4494770,True,1,131
2257,4495719,4495808,False,1,89
2258,4497663,4497980,True,1,317
2259,4498855,4499446,True,1,591
2260,4501587,4501968,True,1,381
2261,4505044,4505158,True,1,114
2262,4505713,4508229,True,1,2516
2263,4510690,4511207,True,4,517
2264,4510690,4511237,True,2,547
2265,4511607,4511761,True,2,154
2266,4511607,4511791,False,1,184
2267,4511686,4511828,True,1,142
2268,4516066,4516695,True,2,629
2269,4516066,4517096,True,1,1030
2270,4518710,4518805,True,1,95
2271,4519069,4519311,True,1,242
2272,4519446,4521793,False,1,2347
2273,4525656,4525739,True,1,83
2274,4526558,4528769,True,1,2211
2275,4526765,4528834,False,1,2069
2276,4527756,4531470,True,1,3714
2277,4528012,4528471,True,1,459
2278,4528012,4528476,True,1,464
2279,4528012,4528822,True,1,810
2280,4528263,4528597,True,1,334
2281,4528311,4528428,True,1,117
2282,4529310,4529427,False,2,117
2283,4529310,4529427,True,1,117
2284,4532719,4533036,True,1,317
2285,4534492,4539032,True,1,4540
2286,4534492,4539067,True,1,4575
2287,4535860,4540396,True,1,4536
2288,4535860,4540431,True,1,4571
2289,4538049,4538305,True,1,256
2290,4539262,4540901,True,1,1639
2291,4539262,4604118,True,1,64856
2292,4543906,4544359,True,4,453
2293,4545806,4545926,True,1,120
2294,4547337,4551937,True,3,4600
2295,4549124,4551573,False,1,2449
2296,4549124,4552976,True,2,3852
2297,4551118,4553211,True,1,2093
2298,4553328,4566913,True,1,13585
2299,4559762,4559904,True,1,142
2300,4561264,4661372,True,1,100108
2301,4562355,4562486,True,1,131
2302,4563747,4564414,True,2,667
2303,4563747,4566052,True,1,2305
2304,4563822,4564453,True,2,631
2305,4565149,4566735,True,1,1586
2306,4565222,4566735,True,1,1513
2307,4567172,4610289,True,1,43117
2308,4567172,4610324,True,1,43152
2309,4570914,4575450,True,1,4536
2310,4570914,4575485,True,1,4571
2311,4573028,4573244,True,1,216
2312,4573028,4573267,True,1,239
2313,4573384,4573460,True,2,76
2314,4573518,4575484,True,1,1966
2315,4578296,4578502,True,1,206
2316,4580018,4582917,True,2,2899
2317,4580083,4580688,True,1,605
2318,4581516,4588981,True,1,7465
2319,4581594,4597846,True,1,16252
2320,4586208,4587911,True,1,1703
2321,4587299,4603046,True,1,15747
2322,4599452,4601673,True,1,2221
2323,4599659,4601738,True,1,2079
2324,4607163,4608683,False,1,1520
2325,4607163,4608683,True,4,1520
2326,4612100,4616635,True,1,4535
2327,4612100,4616670,True,1,4570
2328,4619912,4620039,True,1,127
2329,4620798,4627961,True,1,7163
2330,4634836,4635403,False,2,567
2331,4636657,4638162,True,2,1505
2332,4636892,4637459,False,2,567
2333,4639792,4641227,False,2,1435
2334,4640841,4687965,True,1,47124
2335,4643237,4643370,True,1,133
2336,4643340,4645641,True,1,2301
2337,4645771,4645904,False,1,133
2338,4645771,4645904,True,1,133
2339,4646158,4650792,False,1,4634
2340,4646610,4650434,True,2,3824
2341,4646687,4647314,False,1,627
2342,4646687,4647314,True,4,627
2343,4648125,4649272,True,1,1147
2344,4648261,4649408,True,2,1147
2345,4652684,4653474,True,2,790
2346,4657402,4658922,True,1,1520
2347,4657402,4663227,True,3,5825
2348,4659722,4660481,False,1,759
2349,4661174,4667735,True,1,6561
2350,4661174,4669437,True,1,8263
2351,4664754,4669409,True,1,4655
2352,4667172,4669393,True,1,2221
2353,4667379,4669458,False,1,2079
2354,4671952,4672519,False,2,567
2355,4673353,4673670,True,1,317
2356,4673513,4674161,True,2,648
2357,4674162,4674837,True,1,675
2358,4677590,4677816,True,1,226
2359,4678669,4681187,True,1,2518
2360,4679641,4679749,True,1,108
2361,4690442,4690972,False,1,530
2362,4700900,4706117,False,1,5217
2363,4711532,4716067,True,1,4535
2364,4711532,4716102,True,1,4570
2365,4712497,4713064,False,2,567
2366,4713264,4723310,True,1,10046
2367,4713267,4722804,True,1,9537
2368,4713267,4723310,True,1,10043
2369,4723174,4736649,True,2,13475
2370,4725649,4731352,True,1,5703
2371,4727978,4728369,True,1,391
2372,4728997,4729910,True,1,913
2373,4728997,4732973,True,2,3976
2374,4729960,4733415,True,1,3455
2375,4731307,4734182,True,1,2875
2376,4736952,4737044,True,1,92
2377,4737251,4737343,True,4,92
2378,4739244,4739811,False,2,567
2379,4742608,4743131,True,1,523
2380,4747032,4747746,True,1,714
2381,4750703,4750899,True,1,196
2382,4753411,4753607,True,1,196
2383,4756911,4767699,False,1,10788
2384,4756911,4781686,True,1,24775
2385,4758048,4776124,False,1,18076
2386,4759619,4770400,True,1,10781
2387,4759619,4784333,True,1,24714
2388,4759803,4762613,True,1,2810
2389,4762511,4765314,True,1,2803
2390,4776306,4776935,True,2,629
2391,4776306,4777336,True,1,1030
2392,4778622,4800405,False,1,21783
2393,4778714,4782462,False,1,3748
2394,4779708,4786318,True,2,6610
2395,4781408,4785132,False,1,3724
2396,4782296,4802037,False,2,19741
2397,4788252,4788711,True,1,459
2398,4788252,4788716,True,1,464
2399,4788252,4789062,True,1,810
2400,4788503,4788837,True,1,334
2401,4788551,4788668,True,1,117
2402,4789251,4789367,True,1,116
2403,4789528,4794816,True,2,5288
2404,4789550,4789667,False,2,117
2405,4789550,4789667,True,1,117
2406,4797391,4810186,True,1,12795
2407,4798049,4798288,True,1,239
2408,4798370,4853295,False,1,54925
2409,4799013,4799252,True,1,239
2410,4800881,4802622,True,1,1741
2411,4803086,4803749,True,1,663
2412,4805669,4806333,True,1,664
2413,4805742,4805862,True,1,120
2414,4806400,4806967,False,2,567
2415,4812376,4812621,True,4,245
2416,4813264,4823310,True,1,10046
2417,4813267,4822804,True,1,9537
2418,4813267,4823310,True,1,10043
2419,4814968,4815213,True,4,245
2420,4815904,4817666,True,1,1762
2421,4816820,4816911,True,1,91
2422,4819406,4819497,True,1,91
2423,4822323,4822454,True,1,131
2424,4823373,4827507,True,4,4134
2425,4832319,4833931,False,1,1612
2426,4841460,4848915,True,1,7455
2427,4841520,4848884,True,1,7364
2428,4843745,4845239,True,2,1494
2429,4844503,4844676,True,1,173
2430,4844503,4844922,True,1,419
2431,4847057,4847230,True,1,173
2432,4847057,4847476,True,1,419
2433,4847203,4847362,True,1,159
2434,4847211,4848096,False,2,885
2435,4852018,4852500,True,3,482
2436,4852665,4852873,True,1,208
2437,4855759,4855955,True,1,196
2438,4856461,4856722,True,4,261
2439,4856498,4866784,True,1,10286
2440,4859005,4859266,True,4,261
2441,4859112,4859706,True,1,594
2442,4860449,4860703,True,1,254
2443,4861989,4872770,True,1,10781
2444,4861989,4886748,True,1,24759
2445,4864881,4867684,True,1,2803
2446,4875059,4875262,False,1,203
2447,4877603,4877806,False,1,203
2448,4880473,4881273,True,2,800
2449,4883778,4887518,False,1,3740
2450,4884719,4885560,True,1,841
2451,4884865,4885560,True,1,695
2452,4885694,4886020,True,2,326
2453,4886474,4915390,True,1,28916
2454,4886488,4915390,True,1,28902
2455,4886502,4915390,True,1,28888
2456,4894842,4895132,True,1,290
2457,4895415,4899729,False,1,4314
2458,4905438,4906840,False,1,1402
2459,4908129,4908793,True,1,664
2460,4917424,4917669,True,4,245
2461,4921371,4921466,True,1,95
2462,4921862,4921953,True,1,91
2463,4922673,4922846,True,1,173
2464,4922673,4923092,True,1,419
2465,4922880,4927373,True,1,4493
2466,4922917,4923113,True,1,196
2467,4923541,5228819,True,2,305278
2468,4925475,4929960,True,1,4485
2469,4927080,4929306,True,1,2226
2470,4927768,4935809,True,3,8041
2471,4929125,4939906,True,1,10781
2472,4929125,4953893,True,1,24768
2473,4932017,4934820,True,1,2803
2474,4932881,4932926,False,1,45
2475,4932934,5008927,True,1,75993
2476,4932934,5015376,True,1,82442
2477,4934631,4934892,True,4,261
2478,4941779,4962856,True,2,21077
2479,4942948,4943891,True,1,943
2480,4949557,4949730,True,1,173
2481,4949557,4949976,True,1,419
2482,4950914,4954663,False,1,3749
2483,4952522,4952647,True,1,125
2484,4952981,4953378,True,1,397
2485,4953225,4953428,False,1,203
2486,4954827,4956340,False,2,1513
2487,4954952,4962972,False,1,8020
2488,4958892,4960523,True,2,1631
2489,4961445,4961706,True,4,261
2490,4963071,4963368,False,1,297
2491,4963071,4963787,False,1,716
2492,4963891,4964150,False,1,259
2493,4965609,5031821,True,2,66212
2494,4971478,4976013,True,1,4535
2495,4971478,4976048,True,1,4570
2496,4974297,4974576,True,1,279
2497,4975283,4975947,True,1,664
2498,4975976,4976967,True,4,991
2499,4980047,4980250,False,1,203
2500,4984580,4984825,True,4,245
2501,4989018,4989109,True,1,91
2502,4994222,5038313,False,1,44091
2503,4994222,5038313,True,1,44091
2504,5001085,5005570,True,1,4485
2505,5016715,5016888,True,1,173
2506,5016715,5017134,True,1,419
2507,5020285,5020396,True,2,111
2508,5020527,5020767,True,1,240
2509,5022041,5022562,True,1,521
2510,5023294,5023468,True,1,174
2511,5026362,5031821,True,1,5459
2512,5028603,5028864,True,4,261
2513,5028633,5330581,True,2,301948
2514,5034553,5035165,True,1,612
2515,5034553,5056352,True,1,21799
2516,5035928,5036426,False,1,498
2517,5035928,5036426,True,1,498
2518,5036575,5036716,True,6,141
2519,5037250,5037694,True,1,444
2520,5044129,5044199,True,1,70
2521,5044608,5045074,False,1,466
2522,5044608,5045074,True,1,466
2523,5047203,5047406,False,1,203
2524,5050317,5071179,True,2,20862
2525,5054827,5056340,False,2,1513
2526,5059710,5059715,True,1,5
2527,5060139,5060302,True,2,163
2528,5060774,5060880,False,1,106
2529,5062768,5063787,False,1,1019
2530,5064424,5064429,True,1,5
2531,5064464,5064709,True,1,245
2532,5064853,5065016,True,2,163
2533,5065488,5065594,False,1,106
2534,5069178,5069423,True,1,245
2535,5071669,5072011,False,1,342
2536,5071946,5072513,False,2,567
2537,5076667,5081715,True,1,5048
2538,5076667,5084875,True,1,8208
2539,5078521,5081603,True,2,3082
2540,5093148,5115251,True,1,22103
2541,5095127,5099663,True,1,4536
2542,5096635,5098072,False,1,1437
2543,5104497,5104951,True,1,454
2544,5106653,5166370,True,1,59717
2545,5108527,5116799,False,1,8272
2546,5115074,5115676,True,1,602
2547,5118695,5141688,True,3,22993
2548,5119405,5123805,True,2,4400
2549,5127503,5127805,True,1,302
2550,5128053,5133087,True,1,5034
2551,5140166,5140171,True,1,5
2552,5140595,5140758,True,2,163
2553,5140904,5141130,True,3,226
2554,5140904,5141345,True,1,441
2555,5142556,5228069,True,1,85513
2556,5143191,5144483,True,1,1292
2557,5144920,5145165,True,1,245
2558,5144920,5230543,True,1,85623
2559,5146140,5148507,True,1,2367
2560,5147081,5149403,True,1,2322
2561,5155841,5156254,True,2,413
2562,5165743,5166688,True,1,945
2563,5167263,5167426,True,3,163
2564,5168062,5168168,False,1,106
2565,5171752,5171997,True,1,245
2566,5171752,5256655,True,1,84903
2567,5176101,5195666,True,4,19565
2568,5176936,5195866,True,1,18930
2569,5186750,5187580,True,2,830
2570,5187659,5187736,True,1,77
2571,5188475,5188671,True,1,196
2572,5194683,5205469,True,1,10786
2573,5194683,5219449,True,1,24766
2574,5195883,5224814,True,1,28931
2575,5197482,5205379,True,3,7897
2576,5197482,5207217,True,2,9735
2577,5197482,5209789,True,2,12307
2578,5197575,5200383,True,1,2808
2579,5214860,5218375,True,1,3515
2580,5216482,5220222,False,1,3740
2581,5218695,5241688,True,3,22993
2582,5227306,5235577,True,1,8271
2583,5228118,5235983,True,1,7865
2584,5230753,5230924,True,2,171
2585,5231570,5231675,False,1,105
2586,5234548,5234711,True,3,163
2587,5234549,5234794,True,1,245
2588,5235348,5235454,False,1,106
2589,5236674,5321160,True,1,84486
2590,5239038,5239282,True,1,244
2591,5239038,5323636,True,1,84598
2592,5240712,5258925,False,5,18213
2593,5240837,5241501,True,1,664
2594,5244063,5257243,False,1,13180
2595,5244063,5257243,True,2,13180
2596,5247324,5256808,True,1,9484
2597,5250228,5250473,True,4,245
2598,5254429,5255293,False,2,864
2599,5254429,5255293,True,4,864
2600,5254666,5254757,True,1,91
2601,5266486,5266663,False,1,177
2602,5266486,5266663,True,1,177
2603,5267492,5267596,True,1,104
2604,5278208,5279209,True,1,1001
2605,5278523,5279209,True,2,686
2606,5279618,5279829,True,1,211
2607,5282315,5282488,True,1,173
2608,5282315,5282734,True,1,419
2609,5282726,5285201,True,1,2475
2610,5286558,5286719,False,1,161
2611,5294263,5294524,True,4,261
2612,5305469,5307265,False,1,1796
2613,5307112,5313845,False,2,6733
2614,5311239,5311420,True,2,181
2615,5312076,5312181,False,1,105
2616,5312145,5322039,True,1,9894
2617,5312861,5313064,False,1,203
2618,5313003,5315675,True,1,2672
2619,5313980,5314124,False,1,144
2620,5315036,5315278,True,1,242
2621,5322992,5332871,True,2,9879
2622,5322992,5428103,True,1,105111
2623,5323924,5333783,True,1,9859
2624,5329741,5336681,True,1,6940
2625,5331995,5335370,True,2,3375
2626,5332895,5334602,True,1,1707
2627,5336631,5336812,True,2,181
2628,5337468,5337573,False,1,105
2629,5339372,5339516,False,1,144
2630,5340428,5340670,True,1,242
2631,5340468,5341029,False,1,561
2632,5340468,5358681,True,2,18213
2633,5343514,5358087,True,1,14573
2634,5347317,5347828,False,1,511
2635,5347317,5347828,True,1,511
2636,5360741,5365226,True,1,4485
2637,5374323,5376250,True,1,1927
2638,5375024,5376535,True,1,1511
2639,5399596,5403538,True,2,3942
2640,5401648,5404420,False,1,2772
2641,5403281,5403462,True,2,181
2642,5403696,5413474,True,2,9778
2643,5403696,5505553,True,1,101857
2644,5404118,5404223,False,1,105
2645,5404621,5495846,True,1,91225
2646,5404628,5414386,True,1,9758
2647,5406044,5406188,False,1,144
2648,5407100,5407344,True,1,244
2649,5410443,5417283,True,1,6840
2650,5412829,5413920,False,1,1091
2651,5419194,5419730,True,1,536
2652,5421797,5427799,False,1,6002
2653,5421797,5429983,False,1,8186
2654,5422251,5423952,False,1,1701
2655,5428972,5438742,True,1,9770
2656,5428972,5530309,True,1,101337
2657,5429904,5439654,True,1,9750
2658,5432437,5435864,True,1,3427
2659,5435717,5442550,True,1,6833
2660,5435717,5534117,True,2,98400
2661,5436620,5446969,True,1,10349
2662,5438467,5459028,True,1,20561
2663,5455765,5467701,True,1,11936
2664,5464485,5464952,True,1,467
2665,5465295,5478428,True,1,13133
2666,5466005,5469566,True,1,3561
2667,5471900,5474464,True,1,2564
2668,5484632,5490329,True,1,5697
2669,5487633,5489498,True,2,1865
2670,5493178,5493931,True,1,753
2671,5493878,5494962,True,5,1084
2672,5494008,5494735,True,1,727
2673,5496267,5507064,True,2,10797
2674,5496276,5507092,True,1,10816
2675,5496337,5509380,True,1,13043
2676,5499985,5500148,True,3,163
2677,5501557,5511436,True,1,9879
2678,5502114,5502237,True,1,123
2679,5502114,5586778,True,1,84664
2680,5502726,5510258,True,2,7532
2681,5504484,5589255,True,1,84771
2682,5504839,5504995,True,2,156
2683,5504839,5505053,False,2,214
2684,5504839,5507402,True,1,2563
2685,5510642,5512044,True,1,1402
2686,5519332,5519706,True,1,374
2687,5519332,5526670,True,2,7338
2688,5523552,5523642,False,1,90
2689,5525237,5525950,True,3,713
2690,5526771,5527136,True,1,365
2691,5532343,5534588,True,2,2245
2692,5539124,5540823,True,2,1699
2693,5539124,5602300,True,1,63176
2694,5546229,5547570,True,1,1341
2695,5549791,5549895,True,2,104
2696,5554843,5565445,True,2,10602
2697,5554852,5565473,True,1,10621
2698,5561308,5568642,True,2,7334
2699,5564862,5565422,True,1,560
2700,5567384,5567710,True,5,326
2701,5571181,5575922,True,1,4741
2702,5572229,5584470,False,1,12241
2703,5573797,5575372,True,1,1575
2704,5574365,5574555,False,3,190
2705,5576196,5577209,True,4,1013
2706,5579896,5581974,False,1,2078
2707,5581062,5581622,True,1,560
2708,5583584,5583910,True,5,326
2709,5587150,5597763,True,1,10613
2710,5589140,5592866,True,3,3726
2711,5589614,5590637,True,1,1023
2712,5589614,5617088,True,1,27474
2713,5591295,5591428,True,2,133
2714,5591746,5591838,True,1,92
2715,5592201,5595700,True,1,3499
2716,5592396,5593409,True,4,1013
2717,5593526,5593899,True,1,373
2718,5593526,5600865,True,2,7339
2719,5594036,5594163,True,1,127
2720,5596096,5598172,False,1,2076
2721,5596699,5597345,True,1,646
2722,5596741,5597267,True,2,526
2723,5600525,5601712,False,1,1187
2724,5600525,5601712,True,2,1187
2725,5602026,5602436,True,2,410
2726,5605176,5608662,True,1,3486
2727,5605176,5609800,True,1,4624
2728,5605481,5608959,True,1,3478
2729,5605481,5610097,True,1,4616
2730,5606598,5625059,True,2,18461
2731,5607327,5625465,True,1,18138
2732,5607327,5632630,True,1,25303
2733,5608617,5611966,True,2,3349
2734,5612893,5613539,True,1,646
2735,5612935,5613461,True,2,526
2736,5616719,5617906,False,1,1187
2737,5616719,5617906,True,2,1187
2738,5618220,5618630,True,2,410
2739,5620013,5620161,True,1,148
2740,5623076,5623636,True,1,560
2741,5625598,5625925,True,2,327
2742,5628149,5636284,True,1,8135
2743,5632315,5632643,True,3,328
2744,5632883,5633153,True,1,270
2745,5634412,5635425,True,1,1013
2746,5638112,5640190,False,1,2078
2747,5639993,5642907,True,2,2914
2748,5640028,5642250,True,1,2222
2749,5641337,5642879,True,2,1542
2750,5642845,5661735,True,2,18890
2751,5643019,5643407,True,1,388
2752,5643517,5646864,True,1,3347
2753,5647683,5648770,True,1,1087
2754,5651032,5651464,True,1,432
2755,5651371,5651659,True,1,288
2756,5652596,5652842,True,2,246
2757,5652596,5653086,False,1,490
2758,5652596,5653334,False,1,738
2759,5655310,5655870,True,1,560
2760,5657096,5657382,True,1,286
2761,5657832,5658159,True,5,327
2762,5658129,5658734,True,1,605
2763,5659729,5659915,True,1,186
2764,5666646,5667659,True,4,1013
2765,5666811,5668653,False,1,1842
2766,5666811,5668653,True,2,1842
2767,5667226,5667658,True,1,432
2768,5667565,5667853,True,1,288
2769,5668356,5668750,True,2,394
2770,5668756,5668954,True,1,198
2771,5668790,5669036,True,2,246
2772,5668790,5669280,False,1,490
2773,5668790,5669528,False,1,738
2774,5669099,5669280,True,2,181
2775,5669125,5669751,True,1,626
2776,5669936,5670041,False,1,105
2777,5670346,5672424,False,1,2078
2778,5671840,5671982,False,1,142
2779,5672893,5673138,True,1,245
2780,5674323,5674930,True,1,607
2781,5675927,5676113,True,1,186
2782,5677184,5678362,True,1,1178
2783,5679133,5680016,False,2,883
2784,5679133,5680016,True,2,883
2785,5679532,5680092,True,1,560
2786,5680145,5680536,True,1,391
2787,5680426,5680685,False,1,259
2788,5681157,5681478,False,1,321
2789,5681157,5681478,True,2,321
2790,5681157,5681781,False,1,624
2791,5681157,5681781,True,1,624
2792,5681157,5682336,False,1,1179
2793,5682013,5682227,True,1,214
2794,5682054,5682380,True,5,326
2795,5683005,5692015,True,2,9010
2796,5684555,5684949,True,2,394
2797,5684702,5685050,True,1,348
2798,5684757,5685050,True,1,293
2799,5684955,5695569,True,2,10614
2800,5684964,5695597,True,1,10633
2801,5685305,5685441,True,1,136
2802,5686681,5686810,True,1,129
2803,5687153,5687799,True,1,646
2804,5687195,5687721,True,2,526
2805,5689757,5689833,True,1,76
2806,5690865,5691878,True,4,1013
2807,5690987,5692174,False,1,1187
2808,5690987,5692174,True,2,1187
2809,5691334,5723204,True,5,31870
2810,5691418,5698765,True,2,7347
2811,5692438,5715574,True,1,23136
2812,5692488,5692898,True,2,410
2813,5694347,5694832,True,1,485
2814,5694564,5696642,False,1,2078
2815,5695327,5696210,False,2,883
2816,5695327,5696210,True,2,883
2817,5696339,5696730,True,1,391
2818,5696620,5696879,False,1,259
2819,5697100,5697443,True,1,343
2820,5697351,5697672,False,1,321
2821,5697351,5697672,True,2,321
2822,5697351,5697975,False,1,624
2823,5697351,5697975,True,1,624
2824,5697351,5698530,False,1,1179
2825,5698207,5698421,True,1,214
2826,5700896,5701244,True,1,348
2827,5700951,5701244,True,1,293
2828,5701499,5701635,True,1,136
2829,5705903,5707453,True,3,1550
2830,5708547,5745726,True,1,37179
2831,5708547,5757992,True,5,49445
2832,5710814,5731415,False,1,20601
2833,5711335,5711981,True,1,646
2834,5711377,5711903,True,2,526
2835,5715161,5716348,False,1,1187
2836,5715161,5716348,True,2,1187
2837,5716662,5717072,True,2,410
2838,5718100,5718286,True,1,186
2839,5726711,5727105,True,2,394
2840,5734496,5734592,False,1,96
2841,5734496,5734592,True,4,96
2842,5734754,5740824,True,2,6070
2843,5737213,5737439,True,2,226
2844,5737313,5737478,True,1,165
2845,5737483,5738366,False,2,883
2846,5737483,5738366,True,2,883
2847,5738495,5738886,True,1,391
2848,5738776,5739035,False,1,259
2849,5738860,5739057,True,1,197
2850,5739457,5747222,True,1,7765
2851,5739507,5739828,False,1,321
2852,5739507,5739828,True,2,321
2853,5739507,5740131,False,1,624
2854,5739507,5740131,True,1,624
2855,5739507,5740684,False,1,1177
2856,5740363,5740577,True,1,214
2857,5740830,5746905,True,1,6075
2858,5741556,5741986,True,1,430
2859,5741895,5742181,True,1,286
2860,5742294,5818359,False,1,76065
2861,5743048,5743396,True,1,348
2862,5743103,5743396,True,1,293
2863,5743116,5743362,True,2,246
2864,5743116,5743606,False,1,490
2865,5743116,5743854,False,1,738
2866,5743651,5743787,True,1,136
2867,5748228,5750061,True,1,1833
2868,5748228,5750098,False,1,1870
2869,5748228,5750098,True,1,1870
2870,5748649,5749254,True,1,605
2871,5750249,5750435,True,1,186
2872,5753202,5753762,True,1,560
2873,5753345,5753571,True,2,226
2874,5753445,5753610,True,1,165
2875,5754992,5755189,True,1,197
2876,5755724,5756050,True,5,326
2877,5758877,5759271,True,2,394
2878,5760501,5760586,True,1,85
2879,5761492,5771274,True,2,9782
2880,5762424,5772186,True,1,9762
2881,5764366,5766193,True,1,1827
2882,5764366,5766230,False,1,1864
2883,5764366,5766230,True,1,1864
2884,5764536,5765549,True,4,1013
2885,5765722,5766152,True,1,430
2886,5766061,5766347,True,1,286
2887,5767282,5767528,True,2,246
2888,5767282,5767772,False,1,490
2889,5767282,5768020,False,1,738
2890,5768236,5770314,False,1,2078
2891,5768247,5775087,True,2,6840
2892,5768536,5769164,False,1,628
2893,5769651,5770534,False,2,883
2894,5769651,5770534,True,2,883
2895,5770663,5771054,True,1,391
2896,5770944,5771203,False,1,259
2897,5771675,5771996,False,1,321
2898,5771675,5771996,True,2,321
2899,5771675,5772299,False,1,624
2900,5771675,5772299,True,1,624
2901,5771675,5772852,False,1,1177
2902,5772531,5772745,True,1,214
2903,5772815,5773420,True,1,605
2904,5774415,5774601,True,1,186
2905,5775216,5775564,True,1,348
2906,5775271,5775564,True,1,293
2907,5775819,5775955,True,1,136
2908,5778303,5779564,True,2,1261
2909,5778677,5784968,True,1,6291
2910,5779505,5780735,True,2,1230
2911,5783042,5783436,True,2,394
2912,5783356,5784335,False,1,979
2913,5784949,5785221,True,4,272
2914,5784949,5785920,True,2,971
2915,5785037,5785683,True,1,646
2916,5785079,5785605,True,2,526
2917,5788863,5790050,False,1,1187
2918,5788863,5790050,True,2,1187
2919,5790364,5790774,True,2,410
2920,5793815,5794698,False,2,883
2921,5793815,5794698,True,2,883
2922,5794827,5795218,True,1,391
2923,5795108,5795367,False,1,259
2924,5795839,5796160,False,1,321
2925,5795839,5796160,True,2,321
2926,5795839,5796463,False,1,624
2927,5795839,5796463,True,1,624
2928,5795839,5797016,False,1,1177
2929,5796695,5796909,True,1,214
2930,5799271,5799777,False,1,506
2931,5799380,5799728,True,1,348
2932,5799435,5799728,True,1,293
2933,5799508,5799922,True,1,414
2934,5799983,5800119,True,1,136
2935,5801075,5801348,True,4,273
2936,5801075,5802047,True,2,972
2937,5801941,5816413,True,1,14472
2938,5806057,5806591,True,1,534
2939,5807783,5832478,True,1,24695
2940,5808517,5810409,True,1,1892
2941,5809587,5809674,True,2,87
2942,5809592,5809674,True,2,82
2943,5811672,5815591,False,1,3919
2944,5811672,5815591,True,1,3919
2945,5814262,5822623,True,1,8361
2946,5818685,5819075,True,1,390
2947,5819191,5829950,True,1,10759
2948,5819191,5833138,False,1,13947
2949,5827677,5827903,True,2,226
2950,5827777,5827942,True,1,165
2951,5827790,5831708,False,1,3918
2952,5827790,5831708,True,1,3918
2953,5829324,5829521,True,1,197
2954,5830650,5831791,True,5,1141
2955,5834801,5835191,True,1,390
2956,5837426,5837765,True,1,339
2957,5838690,5840517,True,1,1827
2958,5838690,5840554,False,1,1864
2959,5838690,5840554,True,1,1864
2960,5838800,5839411,True,4,611
2961,5839362,5839794,True,1,432
2962,5839701,5839989,True,1,288
2963,5840437,5841400,True,5,963
2964,5840437,5844688,True,1,4251
2965,5840926,5841172,True,2,246
2966,5840926,5841416,False,1,490
2967,5840926,5841664,False,1,738
2968,5841986,5845392,True,1,3406
2969,5843808,5848173,False,1,4365
2970,5843808,5848173,True,2,4365
2971,5843808,5851036,True,1,7228
2972,5846459,5847064,True,1,605
2973,5846771,5847913,True,5,1142
2974,5847105,5847953,True,1,848
2975,5848059,5848245,True,1,186
2976,5848672,5848818,True,1,146
2977,5849398,5852722,True,1,3324
2978,5854927,5855538,True,4,611
2979,5856563,5857526,True,5,963
2980,5856563,5860814,True,1,4251
2981,5856687,5857081,True,2,394
2982,5860517,5862497,False,2,1980
2983,5860517,5862497,True,1,1980
2984,5862852,5864679,True,1,1827
2985,5862852,5864716,False,1,1864
2986,5862852,5864716,True,1,1864
2987,5864798,5864944,True,1,146
2988,5864967,5865073,True,2,106
2989,5865164,5865239,True,1,75
2990,5866468,5878414,True,1,11946
2991,5866558,5878414,True,1,11856
2992,5866562,5878414,True,1,11852
2993,5867453,5868336,False,2,883
2994,5867453,5868336,True,2,883
2995,5867842,5876265,True,2,8423
2996,5868028,5869735,True,1,1707
2997,5868465,5868856,True,1,391
2998,5868746,5869005,False,1,259
2999,5869477,5869798,False,1,321
3000,5869477,5869798,True,2,321
3001,5869477,5870101,False,1,624
3002,5869477,5870101,True,1,624
3003,5869477,5870652,False,1,1175
3004,5870333,5870547,True,1,214
3005,5870978,5871302,True,1,324
3006,5871986,5872124,True,1,138
3007,5873014,5873362,True,1,348
3008,5873069,5873362,True,1,293
3009,5873617,5873753,True,1,136
3010,5874087,5876102,False,2,2015
3011,5875405,5875678,True,4,273
3012,5875405,5876377,True,2,972
3013,5875894,5876754,False,1,860
3014,5876643,5878623,False,2,1980
3015,5876643,5878623,True,1,1980
3016,5877146,5877695,False,1,549
3017,5878563,5887590,False,1,9027
3018,5879578,5880200,True,1,622
3019,5879717,5883632,True,1,3915
3020,5880941,5881142,True,5,201
3021,5880981,5881237,True,1,256
3022,5881320,5881410,False,1,90
3023,5892103,5895987,False,1,3884
3024,5892185,5895391,True,1,3206
3025,5892598,5892806,True,1,208
3026,5897083,5897284,True,5,201
3027,5897325,5897538,False,1,213
3028,5897325,5897538,True,7,213
3029,5899399,5899626,True,1,227
3030,5899573,5899845,True,4,272
3031,5899573,5900544,True,2,971
3032,5902112,5906030,False,1,3918
3033,5902112,5906030,True,1,3918
3034,5905812,5906840,False,1,1028
3035,5908740,5908948,True,1,208
3036,5909123,5909513,True,1,390
3037,5916656,5944386,True,1,27730
3038,5919215,5945623,True,1,26408
3039,5920562,5921060,True,2,498
3040,5921093,5922236,True,5,1143
3041,5924134,5926154,True,3,2020
3042,5925451,5925677,True,2,226
3043,5925551,5925716,True,1,165
3044,5926292,5930211,False,1,3919
3045,5926292,5930211,True,1,3919
3046,5927098,5927295,True,1,197
3047,5929251,5929862,True,4,611
3048,5930784,5931331,False,1,547
3049,5930887,5931850,True,5,963
3050,5930887,5935138,True,1,4251
3051,5931191,5932310,True,1,1119
3052,5931191,5951580,True,2,20389
3053,5931191,5955794,True,2,24603
3054,5931570,5931691,True,1,121
3055,5931595,5931696,False,1,101
3056,5931823,5932793,True,1,970
3057,5932535,5936114,True,1,3579
3058,5932535,5938146,False,1,5611
3059,5932535,5938146,True,2,5611
3060,5933305,5933695,True,1,390
3061,5935675,5937309,True,1,1634
3062,5935675,5940330,True,4,4655
3063,5936161,5936392,True,1,231
3064,5936464,5938297,True,1,1833
3065,5936464,5938334,False,1,1870
3066,5936464,5938334,True,1,1870
3067,5936690,5937188,True,2,498
3068,5937459,5937549,True,1,90
3069,5937673,5939628,True,1,1955
3070,5939122,5939268,True,1,146
3071,5944651,5945432,False,1,781
3072,5944651,5945432,True,1,781
3073,5944769,5955390,True,2,10621
3074,5944778,5955418,True,1,10640
3075,5945272,5946413,True,5,1141
3076,5946922,5947469,False,1,547
3077,5947708,5947829,True,1,121
3078,5947733,5947834,False,1,101
3079,5947961,5948931,True,1,970
3080,5950967,5952947,False,2,1980
3081,5950967,5952947,True,1,1980
3082,5951232,5958586,True,2,7354
3083,5952481,5952972,False,1,491
3084,5953421,5954032,True,4,611
3085,5953481,5953674,True,7,193
3086,5953597,5953687,True,1,90
3087,5953811,5955760,True,1,1949
3088,5955057,5956020,True,5,963
3089,5955057,5959308,True,1,4251
3090,5955143,5955729,True,1,586
3091,5955152,5957631,True,1,2479
3092,5960777,5961558,False,1,781
3093,5960777,5961558,True,1,781
3094,5961084,5961272,True,2,188
3095,5961501,5964534,True,1,3033
3096,5963292,5963438,True,1,146
3097,5966713,5966845,True,1,132
3098,5968275,5969487,True,2,1212
3099,5969601,5969794,True,7,193
3100,5969752,5970951,True,1,1199
3101,5971104,5982498,True,1,11394
3102,5971409,5971610,True,5,201
3103,5971601,6088428,True,4,116827
3104,5972812,5980690,True,1,7878
3105,5972812,5980791,True,1,7979
3106,5972812,5980811,False,1,7999
3107,5972812,5980811,True,2,7999
3108,5972812,5983439,True,1,10627
3109,5972812,6005057,False,1,32245
3110,5973181,5973453,True,4,272
3111,5973181,5974152,True,2,971
3112,5974459,5975257,True,1,798
3113,5975137,5977117,False,2,1980
3114,5975137,5977117,True,1,1980
3115,5976465,5977960,False,1,1495
3116,5976465,5982363,True,1,5898
3117,5977206,5977394,True,2,188
3118,5977824,5978641,True,1,817
3119,5983074,5983282,True,1,208
3120,5984397,5985609,True,2,1212
3121,5986711,5987101,True,3,390
3122,5986869,5987101,True,1,232
3123,5995577,5995778,True,5,201
3124,5995588,5998278,True,4,2690
3125,5995588,5999984,True,1,4396
3126,5995836,5998640,True,1,2804
3127,5999874,6003793,False,1,3919
3128,5999874,6003793,True,1,3919
3129,6000186,6018725,True,4,18539
3130,6000385,6002348,True,1,1963
3131,6000385,6006766,True,1,6381
3132,6002839,6003229,True,4,390
3133,6002997,6003229,True,1,232
3134,6006887,6007277,True,1,390
3135,6007234,6007442,True,1,208
3136,6011044,6011542,True,2,498
3137,6011958,6014767,True,1,2809
3138,6013024,6013584,True,1,560
3139,6013084,6015282,True,1,2198
3140,6015546,6015873,True,5,327
3141,6017802,6024184,True,1,6382
3142,6018852,6019993,True,5,1141
3143,6020006,6020259,True,1,253
3144,6021278,6021825,False,1,547
3145,6022064,6022185,True,1,121
3146,6022089,6022190,False,1,101
3147,6022317,6023287,True,1,970
3148,6024360,6025373,True,4,1013
3149,6025654,6025926,False,1,272
3150,6027001,6027612,True,4,611
3151,6027953,6028043,True,1,90
3152,6028060,6030138,False,1,2078
3153,6028167,6030122,True,1,1955
3154,6028637,6029600,True,5,963
3155,6028637,6032888,True,1,4251
3156,6028831,6029074,True,6,243
3157,6035145,6035926,False,1,781
3158,6035145,6035926,True,1,781
3159,6035202,6035700,True,2,498
3160,6036471,6036724,True,1,253
3161,6036872,6037018,True,1,146
3162,6038081,6038192,True,1,111
3163,6039182,6040497,True,1,1315
3164,6039182,6040614,True,1,1432
3165,6039182,6040855,True,1,1673
3166,6039346,6039423,True,1,77
3167,6042423,6042558,True,1,135
3168,6043975,6044168,True,7,193
3169,6044629,6045341,True,3,712
3170,6044629,6045349,False,1,720
3171,6044629,6045349,True,3,720
3172,6044861,6045507,True,1,646
3173,6044903,6045429,True,2,526
3174,6044938,6045408,False,1,470
3175,6045430,6045977,False,1,547
3176,6045856,6045928,False,1,72
3177,6045856,6045928,True,4,72
3178,6046216,6046337,True,1,121
3179,6046241,6046342,False,1,101
3180,6046469,6047439,True,1,970
3181,6048026,6048112,True,1,86
3182,6048578,6049319,True,3,741
3183,6048578,6049324,True,1,746
3184,6048687,6049874,False,1,1187
3185,6048687,6049874,True,2,1187
3186,6048717,6050696,False,2,1979
3187,6048717,6050696,True,1,1979
3188,6050188,6050598,True,2,410
3189,6051580,6051768,True,2,188
3190,6052105,6052195,True,1,90
3191,6052319,6054270,True,1,1951
3192,6053600,6053691,True,1,91
3193,6058771,6059983,True,2,1212
3194,6059289,6060070,False,1,781
3195,6059289,6060070,True,1,781
3196,6061899,6063202,True,2,1303
3197,6068119,6068312,True,7,193
3198,6069157,6069358,True,5,201
3199,6070169,6070253,False,1,84
3200,6075726,6075914,True,2,188
3201,6077199,6077589,True,2,390
3202,6077357,6077589,True,1,232
3203,6078303,6078556,True,1,253
3204,6078607,6079140,False,1,533
3205,6080551,6080745,False,1,194
3206,6080770,6081023,True,2,253
3207,6080814,6081022,True,1,208
3208,6082917,6084129,True,2,1212
3209,6083992,6084264,False,1,272
3210,6096419,6096530,True,1,111
3211,6097684,6097761,True,1,77
3212,6097935,6098856,False,3,921
3213,6099186,6099616,True,1,430
3214,6099526,6099812,True,1,286
3215,6100205,6100377,False,1,172
3216,6100746,6100992,True,2,246
3217,6100746,6101236,False,1,490
3218,6100746,6101484,False,1,738
3219,6101343,6101733,True,2,390
3220,6101501,6101733,True,1,232
3221,6101991,6102097,True,1,106
3222,6103274,6103744,False,1,470
3223,6103429,6112631,False,1,9202
3224,6104686,6104986,True,1,300
3225,6106191,6106323,False,1,132
3226,6106191,6106323,True,1,132
3227,6106279,6106884,True,1,605
3228,6106942,6107023,True,1,81
3229,6106945,6107023,True,2,78
3230,6107879,6108065,True,1,186
3231,6108631,6109215,True,1,584
3232,6108780,6109278,True,2,498
3233,6111849,6112102,True,1,253
3234,6116116,6116388,False,1,272
3235,6116507,6116901,True,2,394
3236,6118117,6118223,True,1,106
3237,6119014,6119561,False,1,547
3238,6119800,6119921,True,1,121
3239,6119825,6119926,False,1,101
3240,6120053,6121023,True,1,970
3241,6120235,6121538,True,2,1303
3242,6125689,6125779,True,1,90
3243,6125903,6127856,True,1,1953
3244,6126649,6126822,True,1,173
3245,6127279,6128162,False,2,883
3246,6127279,6128162,True,2,883
3247,6128291,6128682,True,1,391
3248,6128331,6131233,True,1,2902
3249,6128331,6131925,True,1,3594
3250,6128414,6137992,True,1,9578
3251,6128414,6141117,True,1,12703
3252,6128505,6128589,False,1,84
3253,6128543,6128654,True,1,111
3254,6128572,6128831,False,1,259
3255,6129303,6129624,False,1,321
3256,6129303,6129624,True,2,321
3257,6129303,6129927,False,1,624
3258,6129303,6129927,True,1,624
3259,6129303,6130476,False,1,1173
3260,6129808,6129885,True,1,77
3261,6130159,6130373,True,1,214
3262,6130399,6136675,False,1,6276
3263,6130755,6132860,True,1,2105
3264,6132836,6133184,True,1,348
3265,6132877,6133658,False,1,781
3266,6132877,6133658,True,1,781
3267,6132891,6133184,True,1,293
3268,6133439,6133575,True,1,136
3269,6134357,6138634,True,2,4277
3270,6135398,6135868,False,1,470
3271,6137124,6137589,True,2,465
3272,6137953,6188915,True,1,50962
3273,6138067,6138138,False,1,71
3274,6138101,6138595,True,1,494
3275,6138305,6139015,True,1,710
3276,6140804,6141526,True,1,722
3277,6140804,6141866,True,1,1062
3278,6141707,6141900,True,7,193
3279,6141710,6141944,True,1,234
3280,6144453,6147354,True,1,2901
3281,6144453,6148046,True,1,3593
3282,6145624,6145857,True,3,233
3283,6148128,6148233,True,1,105
3284,6148397,6149738,True,2,1341
3285,6149312,6149500,True,2,188
3286,6152357,6153660,True,2,1303
3287,6153222,6165071,True,1,11849
3288,6154187,6154258,False,1,71
3289,6154218,6155008,True,2,790
3290,6154221,6154715,True,1,494
3291,6154425,6155135,True,1,710
3292,6156141,6156214,True,2,73
3293,6156503,6157715,True,2,1212
3294,6160327,6160433,True,1,106
3295,6160629,6160713,False,1,84
3296,6160783,6160904,True,1,121
3297,6162489,6162983,True,1,494
3298,6163262,6165299,True,1,2037
3299,6165033,6165151,False,1,118
3300,6174931,6175321,True,3,390
3301,6175089,6175321,True,1,232
3302,6175773,6177675,False,1,1902
3303,6176843,6177051,True,2,208
3304,6176843,6178876,False,1,2033
3305,6178617,6179111,True,1,494
3306,6179173,6184167,True,1,4994
3307,6179178,6184167,True,1,4989
3308,6179178,6190246,True,1,11068
3309,6184040,6186856,True,1,2816
3310,6185299,6185525,True,2,226
3311,6185399,6185564,True,1,165
3312,6186679,6189581,True,1,2902
3313,6186679,6190273,True,1,3594
3314,6186946,6187143,True,1,197
3315,6189192,6204552,True,1,15360
3316,6192987,6193195,True,2,208
3317,6192987,6195018,False,1,2031
3318,6193698,6194095,True,1,397
3319,6194963,6197423,True,1,2460
3320,6196318,6198145,True,1,1827
3321,6196318,6198182,False,1,1864
3322,6196318,6198182,True,1,1864
3323,6196415,6196486,False,1,71
3324,6196449,6196943,True,1,494
3325,6196653,6197363,True,1,710
3326,6204094,6206934,False,1,2840
3327,6208232,6208485,True,1,253
3328,6213884,6214156,False,1,272
3329,6217918,6219419,True,5,1501
3330,6219610,6234289,True,1,14679
3331,6220002,6223459,True,1,3457
3332,6220002,6224471,True,4,4469
3333,6220002,6226220,True,1,6218
3334,6220843,6221337,True,1,494
3335,6221752,6222282,True,1,530
3336,6223010,6236007,True,1,12997
3337,6225722,6225817,True,1,95
3338,6226311,6226422,True,1,111
3339,6227576,6227653,True,1,77
3340,6229507,6229588,True,1,81
3341,6230807,6230932,True,1,125
3342,6230807,6231092,True,1,285
3343,6230807,6231095,True,4,288
3344,6230807,6232688,True,1,1881
3345,6231267,6231394,True,1,127
3346,6231309,6231404,True,2,95
3347,6231373,6231445,True,1,72
3348,6231611,6233160,False,1,1549
3349,6231611,6233160,True,2,1549
3350,6233033,6233306,True,4,273
3351,6233033,6234005,True,2,972
3352,6233166,6233636,False,1,470
3353,6233666,6234568,True,3,902
3354,6235177,6235385,True,2,208
3355,6235177,6237212,False,1,2035
3356,6238006,6238442,False,1,436
3357,6238006,6238442,True,1,436
3358,6238006,6242814,False,1,4808
3359,6238006,6242814,True,1,4808
3360,6242132,6242227,True,1,95
3361,6250075,6250978,True,3,903
3362,6250129,6251432,True,2,1303
3363,6257070,6267574,True,1,10504
3364,6258399,6258483,False,1,84
3365,6259752,6263670,False,1,3918
3366,6259752,6263670,True,1,3918
3367,6263796,6265762,True,2,1966
3368,6266741,6267148,True,5,407
3369,6266763,6267153,True,1,390
3370,6267539,6270474,True,2,2935
3371,6272783,6284777,True,2,11994
3372,6278730,6279872,True,5,1142
3373,6279541,6280433,True,4,892
3374,6283161,6283568,True,5,407
3375,6284060,6284155,True,1,95
3376,6286881,6287492,True,4,611
3377,6288517,6289480,True,5,963
3378,6288517,6292768,True,1,4251
3379,6289070,6289413,True,2,343
3380,6290221,6290327,True,1,106
3381,6292004,6292906,True,3,902
3382,6293864,6294189,True,1,325
3383,6295487,6297943,False,1,2456
3384,6296752,6296898,True,1,146
3385,6298634,6298722,True,1,88
3386,6300144,6300840,True,1,696
3387,6302444,6338115,True,2,35671
3388,6307659,6308169,True,1,510
3389,6308597,6310576,False,2,1979
3390,6308597,6310576,True,1,1979
3391,6308855,6341329,True,1,32474
3392,6309058,6309758,True,2,700
3393,6311273,6314529,True,1,3256
3394,6315052,6315140,True,1,88
3395,6318862,6354530,True,2,35668
3396,6320046,6320141,True,1,95
3397,6321415,6322742,True,1,1327
3398,6321415,6325254,False,2,3839
3399,6324079,6324589,True,1,510
3400,6325085,6325492,True,5,407
3401,6325245,6325910,True,1,665
3402,6325245,6325978,True,1,733
3403,6325275,6357745,True,1,32470
3404,6325530,6325927,True,1,397
3405,6327990,6328892,True,3,902
3406,6329035,6329236,True,5,201
3407,6337273,6339295,False,2,2022
3408,6337273,6339295,True,2,2022
3409,6338405,6339399,False,1,994
3410,6340668,6340763,True,1,95
3411,6340692,6340900,True,1,208
3412,6342476,6342845,True,1,369
3413,6350166,6350527,True,1,361
3414,6356992,6357080,True,1,88
3415,6358488,6360580,False,1,2092
3416,6360234,6360343,True,3,109
3417,6360356,6361992,True,1,1636
3418,6360955,6361520,True,2,565
3419,6361063,6361470,True,4,407
3420,6362014,6362169,True,4,155
3421,6362014,6367824,True,1,5810
3422,6367011,6374110,False,2,7099
3423,6367753,6368954,False,1,1201
3424,6368656,6369154,True,2,498
3425,6370444,6372221,False,1,1777
3426,6370444,6372221,True,2,1777
3427,6370579,6372298,True,1,1719
3428,6372086,6378340,False,1,6254
3429,6372086,6378340,True,1,6254
3430,6373139,6379337,True,1,6198
3431,6373139,6496861,True,1,123722
3432,6373533,6384397,False,1,10864
3433,6374846,6375583,True,1,737
3434,6378426,6378581,True,4,155
3435,6378426,6384236,True,1,5810
3436,6378870,6379417,False,1,547
3437,6379192,6383326,False,1,4134
3438,6379656,6379777,True,1,121
3439,6379681,6379782,False,1,101
3440,6379819,6380196,False,1,377
3441,6379909,6380879,True,1,970
3442,6380268,6383818,False,1,3550
3443,6380268,6383818,True,1,3550
3444,6380268,6384634,True,1,4366
3445,6380314,6384035,False,1,3721
3446,6380345,6383946,True,1,3601
3447,6381153,6382921,True,1,1768
3448,6384045,6385454,True,2,1409
3449,6385545,6385635,True,1,90
3450,6385759,6387718,True,1,1959
3451,6386019,6388923,False,1,2904
3452,6386019,6388923,True,1,2904
3453,6388544,6388671,True,1,127
3454,6392745,6393526,False,1,781
3455,6392745,6393526,True,1,781
3456,6392945,6394331,True,1,1386
3457,6397564,6399334,True,1,1770
3458,6397709,6400333,False,1,2624
3459,6398958,6399044,True,3,86
3460,6401575,6401768,True,7,193
3461,6409180,6409368,True,2,188
3462,6409319,6410505,True,1,1186
3463,6411214,6412543,True,2,1329
3464,6412866,6414201,False,1,1335
3465,6414306,6414401,True,1,95
3466,6415370,6415456,True,3,86
3467,6416371,6417583,True,2,1212
3468,6416564,6416965,False,1,401
3469,6416564,6416965,True,3,401
3470,6422250,6423152,True,3,902
3471,6424737,6424818,True,3,81
3472,6427626,6428955,True,2,1329
3473,6434781,6435171,True,3,390
3474,6434939,6435171,True,1,232
3475,6441149,6441230,True,3,81
3476,6443868,6446670,True,1,2802
3477,6446554,6446637,True,2,83
3478,6448842,6449088,True,1,246
3479,6449168,6449761,True,1,593
3480,6449696,6475681,True,3,25985
3481,6449801,6450003,True,1,202
3482,6449926,6453491,True,2,3565
3483,6450539,6450885,True,1,346
3484,6450766,6450850,True,1,84
3485,6450804,6450888,True,2,84
3486,6451098,6476463,False,1,25365
3487,6451099,6451207,True,1,108
3488,6451532,6457920,False,1,6388
3489,6455323,6455730,True,5,407
3490,6456273,6461750,True,1,5477
3491,6456360,6456515,True,4,155
3492,6456360,6462120,True,1,5760
3493,6458198,6515978,False,1,57780
3494,6462966,6463049,True,2,83
3495,6463277,6464317,True,3,1040
3496,6465254,6465500,True,1,246
3497,6465580,6466173,True,1,593
3498,6466213,6466415,True,1,202
3499,6467178,6467262,True,1,84
3500,6467216,6467300,True,2,84
3501,6467511,6467619,True,1,108
3502,6467944,6474335,False,1,6391
3503,6468364,6468617,True,1,253
3504,6468366,6468448,True,2,82
3505,6468366,6470504,True,1,2138
3506,6470944,6471075,True,2,131
3507,6472352,6472560,True,1,208
3508,6473662,6473934,False,1,272
3509,6475397,6477167,True,1,1770
3510,6476956,6477111,True,4,155
3511,6476956,6482517,True,1,5561
3512,6479350,6480489,True,1,1139
3513,6479350,6482359,True,1,3009
3514,6486091,6486202,True,1,111
3515,6487230,6487318,True,1,88
3516,6487352,6487429,True,1,77
3517,6487362,6487493,True,2,131
3518,6488564,6488646,True,2,82
3519,6488564,6490699,True,1,2135
3520,6488770,6488978,True,1,208
3521,6491040,6526670,True,2,35630
3522,6492920,6493390,False,1,470
3523,6493202,6493288,True,3,86
3524,6495221,6504025,True,1,8804
3525,6495434,6500756,True,1,5322
3526,6495585,6497361,True,1,1776
3527,6496261,6496771,True,1,510
3528,6497457,6529887,True,1,32430
3529,6499130,6502409,True,1,3279
3530,6502035,6505698,True,1,3663
3531,6504595,6505501,True,1,906
3532,6505458,6506787,True,2,1329
3533,6508870,6509034,False,1,164
3534,6509877,6511180,True,2,1303
3535,6513422,6513508,True,3,86
3536,6518147,6518231,False,1,84
3537,6518191,6518287,True,1,96
3538,6518591,6523077,True,3,4486
3539,6518813,6518919,True,1,106
3540,6518991,6519072,True,3,81
3541,6523854,6524173,True,1,319
3542,6524345,6534990,True,1,10645
3543,6525288,6525452,False,1,164
3544,6525364,6535490,True,1,10126
3545,6525498,6535596,True,1,10098
3546,6534601,6534697,True,1,96
3547,6534601,6535069,True,1,468
3548,6535029,6535036,True,1,7
3549,6536424,6536555,True,2,131
3550,6537832,6538040,True,1,208
3551,6540266,6540585,True,3,319
3552,6540808,6540891,True,2,83
3553,6542046,6546426,True,1,4380
3554,6542852,6553290,True,3,10438
3555,6543096,6543342,True,1,246
3556,6543422,6544015,True,1,593
3557,6544055,6544257,True,1,202
3558,6544732,6545068,False,1,336
3559,6545020,6545104,True,1,84
3560,6545058,6545142,True,2,84
3561,6545353,6545461,True,1,108
3562,6545786,6552176,False,1,6390
3563,6546934,6554743,True,3,7809
3564,6546937,6554743,True,3,7806
3565,6547790,6549721,False,1,1931
3566,6549963,6550069,True,1,106
3567,6550630,6550785,True,4,155
3568,6550630,6556389,True,1,5759
3569,6550865,6552591,True,1,1726
3570,6561612,6561776,False,1,164
3571,6565202,6565333,True,2,131
3572,6566610,6566818,True,1,208
3573,6567907,6569009,True,1,1102
3574,6569665,6571435,True,1,1770
3575,6570925,6571021,True,1,96
3576,6570925,6571393,True,1,468
3577,6576319,6579220,True,1,2901
3578,6576319,6579912,True,1,3593
3579,6576590,6576909,True,3,319
3580,6585721,6585885,False,1,164
3581,6585721,6585885,True,6,164
3582,6586053,6586124,False,1,71
3583,6586087,6586581,True,1,494
3584,6586291,6587001,True,1,710
3585,6587470,6587556,True,3,86
3586,6589580,6612549,True,1,22969
3587,6589580,6639416,True,1,49836
3588,6599726,6601055,True,2,1329
3589,6603126,6603290,False,1,164
3590,6606641,6608835,False,1,2194
3591,6610479,6610973,True,1,494
3592,6612445,6612541,True,2,96
3593,6612445,6645645,True,1,33200
3594,6613121,6613227,True,1,106
3595,6613259,6613340,True,3,81
3596,6618108,6618427,True,1,319
3597,6622957,6629246,False,1,6289
3598,6624821,6625029,True,2,208
3599,6624821,6626853,False,1,2032
3600,6627682,6653190,True,1,25508
3601,6627902,6628103,False,1,201
3602,6629535,6630891,False,1,1356
3603,6630678,6630809,True,2,131
3604,6632086,6632294,True,1,208
3605,6632549,6633668,True,2,1119
3606,6635076,6635159,True,2,83
3607,6637364,6637610,True,1,246
3608,6637574,6662458,True,1,24884
3609,6637690,6638283,True,1,593
3610,6638323,6638525,True,1,202
3611,6639288,6639372,True,1,84
3612,6639326,6639410,True,2,84
3613,6639621,6639729,True,1,108
3614,6640054,6646445,False,1,6391
3615,6647793,6733977,True,1,86184
3616,6667691,6668543,True,1,852
3617,6668602,6668766,False,1,164
3618,6674044,6674139,True,1,95
3619,6678011,6678107,True,1,96
3620,6678011,6678479,True,1,468
3621,6679945,6688496,True,1,8551
3622,6681988,6682890,True,3,902
3623,6682595,6999789,True,1,317194
3624,6683574,6683893,True,3,319
3625,6686937,6689771,True,6,2834
3626,6686937,6693069,True,1,6132
3627,6688450,6688807,True,1,357
3628,6689945,6708196,True,1,18251
3629,6689945,6708420,True,1,18475
3630,6700816,6704017,True,1,3201
3631,6711075,6717183,True,1,6108
3632,6711207,6711303,False,1,96
3633,6712376,6712695,True,1,319
3634,6712672,6717731,True,1,5059
3635,6715085,6715492,True,5,407
3636,6717195,6720110,False,1,2915
3637,6717265,6717378,True,1,113
3638,6719243,6741268,True,2,22025
3639,6721934,7151764,False,1,429830
3640,6724946,6725077,True,2,131
3641,6725137,6725647,True,2,510
3642,6726354,6726562,True,1,208
3643,6728045,6728259,True,1,214
3644,6729630,6731715,True,1,2085
3645,6733228,6748272,True,3,15044
3646,6735272,6735357,True,2,85
3647,6742521,6750774,True,1,8253
3648,6743771,6759864,True,2,16093
3649,6746978,6747066,True,1,88
3650,6750788,6786456,True,2,35668
3651,6751133,6753691,True,1,2558
3652,6752458,6752697,True,1,239
3653,6754871,6756829,True,1,1958
3654,6755346,6755483,True,3,137
3655,6756003,6756513,True,1,510
3656,6757199,6789670,True,1,32471
3657,6758984,6764190,True,1,5206
3658,6760951,6761104,True,2,153
3659,6760951,6762127,True,3,1176
3660,6760951,6762181,True,1,1230
3661,6760951,6762930,True,1,1979
3662,6760951,6771359,True,5,10408
3663,6762870,6763034,False,1,164
3664,6763554,6764117,False,2,563
3665,6764041,6764146,False,2,105
3666,6764667,6765616,True,1,949
3667,6765325,6766298,True,1,973
3668,6765972,6766163,True,1,191
3669,6765982,6766163,False,1,181
3670,6765982,6766163,True,2,181
3671,6766841,6767092,True,1,251
3672,6767055,6774834,True,1,7779
3673,6767092,6774834,True,1,7742
3674,6767435,6768976,True,1,1541
3675,6772180,6772276,True,1,96
3676,6772180,6772647,True,1,467
3677,6772607,6772614,True,1,7
3678,6774033,6775023,True,1,990
3679,6776210,6803843,True,3,27633
3680,6776525,6777810,True,2,1285
3681,6777840,6778159,True,3,319
3682,6783831,6796936,True,1,13105
3683,6786829,6788308,True,1,1479
3684,6786879,6788334,True,1,1455
3685,6791656,6791793,True,3,137
3686,6795247,6795763,True,4,516
3687,6796038,6796554,True,2,516
3688,6799873,6800436,False,2,563
3689,6800360,6800465,False,2,105
3690,6800987,6801936,True,1,949
3691,6802292,6802483,True,1,191
3692,6802302,6802483,False,1,181
3693,6802302,6802483,True,1,181
3694,6803161,6803412,True,1,251
3695,6804464,6806880,False,3,2416
3696,6810352,6810507,True,4,155
3697,6810352,6816162,True,1,5810
3698,6811658,6811979,True,2,321
3699,6812793,6814512,True,1,1719
3700,6814629,6815517,True,2,888
3701,6819702,6820083,True,1,381
3702,6819800,6819910,False,3,110
3703,6819800,6819910,True,7,110
3704,6819800,6820083,True,10,283
3705,6822028,6822206,True,1,178
3706,6823184,6823273,True,1,89
3707,6823897,6824018,True,1,121
3708,6824323,6830210,True,1,5887
3709,6824812,6824941,True,1,129
3710,6828797,6828925,True,1,128
3711,6829490,6831260,True,1,1770
3712,6830385,6830752,True,1,367
3713,6831100,6831680,False,2,580
3714,6831100,6831680,True,4,580
3715,6831103,6831680,False,1,577
3716,6831103,6831680,True,2,577
3717,6831955,6832205,True,1,250
3718,6835346,6837129,True,1,1783
3719,6836695,6838448,False,1,1753
3720,6839858,6840062,True,2,204
3721,6844013,6846134,True,1,2121
3722,6847294,6847380,True,3,86
3723,6848582,6848754,False,2,172
3724,6848582,6848754,True,2,172
3725,6848582,6849354,True,1,772
3726,6849958,6850459,True,1,501
3727,6856775,6860396,False,1,3621
3728,6859550,6860879,True,2,1329
3729,6862788,6862925,True,3,137
3730,6865795,6866541,True,4,746
3731,6868627,6881252,True,1,12625
3732,6868758,6873825,True,2,5067
3733,6871003,6871566,False,2,563
3734,6871490,6871595,False,2,105
3735,6872117,6873066,True,1,949
3736,6873083,6873164,True,3,81
3737,6873422,6873613,True,1,191
3738,6873432,6873613,False,1,181
3739,6873432,6873613,True,2,181
3740,6874291,6874542,True,1,251
3741,6887570,6888182,True,2,612
3742,6890505,6890597,False,1,92
3743,6890533,6890617,True,1,84
3744,6891223,6909489,True,1,18266
3745,6891223,6909713,True,1,18490
3746,6894269,6895749,True,1,1480
3747,6894293,6894388,True,1,95
3748,6894319,6895775,True,1,1456
3749,6894900,6894983,True,2,83
3750,6895402,6903957,True,1,8555
3751,6897188,6897434,True,1,246
3752,6897514,6898107,True,1,593
3753,6898147,6898349,True,1,202
3754,6899112,6899196,True,1,84
3755,6899150,6899234,True,2,84
3756,6899445,6899553,True,1,108
3757,6899878,6906268,False,1,6390
3758,6900040,6900290,True,1,250
3759,6900040,6906322,True,1,6282
3760,6900674,6906521,True,2,5847
3761,6902689,6903205,True,4,516
3762,6903363,6907940,True,1,4577
3763,6903445,6967562,True,1,64117
3764,6903480,6903996,True,2,516
3765,6903595,6905613,True,3,2018
3766,6903828,6967562,True,2,63734
3767,6903970,6907940,True,1,3970
3768,6907625,6910121,True,1,2496
3769,6911989,6912772,True,1,783
3770,6912421,6914814,False,1,2393
3771,6919002,6919139,True,3,137
3772,6919294,6919425,True,2,131
3773,6920702,6920910,True,1,208
3774,6922071,6922959,True,2,888
3775,6926445,6926955,True,2,510
3776,6927144,6927525,True,1,381
3777,6927215,6927778,False,2,563
3778,6927242,6927352,False,3,110
3779,6927242,6927352,True,7,110
3780,6927242,6927525,True,10,283
3781,6927702,6927807,False,2,105
3782,6928329,6929278,True,1,949
3783,6928764,6928901,True,3,137
3784,6929353,6929567,True,1,214
3785,6929470,6929648,True,1,178
3786,6929634,6929825,True,1,191
3787,6929644,6929825,False,1,181
3788,6929644,6929825,True,2,181
3789,6930188,6930263,True,2,75
3790,6930503,6930754,True,1,251
3791,6930626,6930715,True,1,89
3792,6931339,6931460,True,1,121
3793,6932254,6932383,True,1,129
3794,6936239,6936367,True,1,128
3795,6936580,6936665,True,1,85
3796,6936977,6937540,False,2,563
3797,6937464,6937569,False,2,105
3798,6938091,6939040,True,1,949
3799,6939020,6943555,True,7,4535
3800,6939396,6939587,True,1,191
3801,6939397,6939647,True,1,250
3802,6939406,6939587,False,1,181
3803,6939406,6939587,True,2,181
3804,6940265,6940516,True,1,251
3805,6944482,6944646,False,1,164
3806,6947298,6947502,True,2,204
3807,6948099,6952711,False,1,4612
3808,6949398,6952819,True,1,3421
3809,6950443,6951922,True,1,1479
3810,6950493,6951948,True,1,1455
3811,6953770,6954009,True,1,239
3812,6953795,6953891,True,1,96
3813,6953795,6954263,True,1,468
3814,6954473,6954579,True,1,106
3815,6956022,6956194,True,3,172
3816,6956022,6956795,True,1,773
3817,6957398,6957900,True,1,502
3818,6958855,6959371,True,4,516
3819,6959460,6959779,True,3,319
3820,6959646,6960162,True,2,516
3821,6960243,6961723,True,1,1480
3822,6960293,6961749,True,1,1456
3823,6968663,6969179,True,4,516
3824,6969454,6969970,True,2,516
3825,6969579,6976247,True,1,6668
3826,6972840,6973534,True,1,694
3827,6973647,6976914,True,1,3267
3828,6978237,6979125,True,2,888
3829,6981122,7140284,True,1,159162
3830,6982627,6983076,True,2,449
3831,6983310,6983691,True,1,381
3832,6983408,6983518,False,3,110
3833,6983408,6983518,True,7,110
3834,6983408,6983691,True,10,283
3835,6985636,6985814,True,1,178
3836,6986792,6986881,True,1,89
3837,6987504,6992136,True,1,4632
3838,6987505,6987626,True,1,121
3839,6987508,6992150,True,1,4642
3840,6988045,6988933,True,2,888
3841,6988420,6988549,True,1,129
3842,6989731,6993066,True,1,3335
3843,6992405,6992533,True,1,128
3844,6992960,6993097,True,3,137
3845,6993118,6993499,True,1,381
3846,6993216,6993326,False,3,110
3847,6993216,6993326,True,7,110
3848,6993216,6993499,True,10,283
3849,6995421,6998518,True,6,3097
3850,6995444,6995622,True,1,178
3851,6995563,6995813,True,1,250
3852,6996600,6996689,True,1,89
3853,6997313,6997434,True,1,121
3854,6998228,6998357,True,1,129
3855,7001173,7001736,False,2,563
3856,7001660,7001765,False,2,105
3857,7002214,7002342,True,1,128
3858,7002287,7003236,True,1,949
3859,7003464,7003668,True,2,204
3860,7003592,7003783,True,1,191
3861,7003602,7003783,False,1,181
3862,7003602,7003783,True,2,181
3863,7004461,7004712,True,1,251
3864,7004542,7006272,False,1,1730
3865,7004542,7006272,True,1,1730
3866,7004785,7010708,True,2,5923
3867,7005373,7005623,True,1,250
3868,7005661,7012332,True,1,6671
3869,7012188,7012360,False,2,172
3870,7012188,7012360,True,2,172
3871,7012188,7012961,True,1,773
3872,7012766,7029246,True,1,16480
3873,7013274,7013478,True,2,204
3874,7013564,7014066,True,1,502
3875,7016172,7034211,False,2,18039
3876,7016172,7034211,True,3,18039
3877,7016172,7037460,True,1,21288
3878,7020086,7021800,True,1,1714
3879,7021998,7022170,False,2,172
3880,7021998,7022170,True,2,172
3881,7021998,7022771,True,1,773
3882,7023374,7023876,True,1,502
3883,7024447,7025926,True,1,1479
3884,7024497,7025952,True,1,1455
3885,7025821,7030184,True,1,4363
3886,7032865,7033381,True,4,516
3887,7033656,7034172,True,2,516
3888,7044724,7050599,True,4,5875
3889,7046009,7048817,True,2,2808
3890,7049369,7052599,True,1,3230
3891,7052247,7053133,True,2,886
3892,7052550,7055682,True,1,3132
3893,7054195,7054279,True,1,84
3894,7057316,7057697,True,1,381
3895,7057414,7057524,False,3,110
3896,7057414,7057524,True,7,110
3897,7057414,7057697,True,10,283
3898,7059642,7059820,True,1,178
3899,7060798,7060887,True,1,89
3900,7061511,7061632,True,1,121
3901,7062426,7062555,True,1,129
3902,7063949,7064033,True,1,84
3903,7066411,7066539,True,1,128
3904,7069569,7069819,True,1,250
3905,7072879,7091151,True,1,18272
3906,7072879,7091375,True,1,18496
3907,7077016,7081034,True,1,4018
3908,7077016,7083067,True,1,6051
3909,7077470,7077674,True,2,204
3910,7078412,7082385,True,1,3973
3911,7079763,7080160,True,1,397
3912,7079886,7080160,True,4,274
3913,7080780,7086666,True,4,5886
3914,7083295,7083573,True,1,278
3915,7083392,7083541,True,2,149
3916,7086194,7086366,False,2,172
3917,7086194,7086366,True,2,172
3918,7086194,7086967,True,1,773
3919,7087470,7088005,True,1,535
3920,7087570,7088072,True,1,502
3921,7088926,7089001,True,2,75
3922,7095011,7095358,True,1,347
3923,7095557,7096111,True,1,554
3924,7102033,7105662,True,2,3629
3925,7102122,7103772,True,1,1650
3926,7108113,7108623,True,2,510
3927,7111021,7111235,True,1,214
3928,7118248,7118333,True,2,85
3929,7119862,7125399,True,1,5537
3930,7128192,7128276,True,1,84
3931,7128855,7129308,True,1,453
3932,7132913,7139582,True,1,6669
3933,7133365,7133673,False,1,308
3934,7133365,7133673,True,1,308
3935,7133365,7134157,True,1,792
3936,7134432,7138120,True,1,3688
3937,7135434,7135673,True,1,239
3938,7138333,7168023,True,6,29690
3939,7139938,7143058,True,1,3120
3940,7142805,7149477,True,1,6672
3941,7144282,7144479,True,1,197
3942,7144395,7144479,True,1,84
3943,7145934,7146230,True,2,296
3944,7146344,7146687,True,1,343
3945,7146634,7146977,True,1,343
3946,7153692,7159403,True,5,5711
3947,7157445,7168195,False,1,10750
3948,7164991,7165444,True,2,453
3949,7171388,7172059,True,1,671
3950,7174646,7174783,True,3,137
3951,7180950,7181224,True,1,274
3952,7182862,7183425,False,2,563
3953,7183349,7183454,False,2,105
3954,7183977,7184926,True,1,949
3955,7185282,7185473,True,1,191
3956,7185292,7185473,False,1,181
3957,7185292,7185473,True,2,181
3958,7186151,7186402,True,1,251
3959,7186151,7188209,True,2,2058
3960,7187195,7187275,True,1,80
3961,7188349,7188527,True,1,178
3962,7189577,7190236,True,1,659
3963,7190434,7194348,True,1,3914
3964,7191647,7194775,False,1,3128
3965,7192662,7195504,True,1,2842
3966,7196352,7197274,True,1,922
3967,7196562,7197162,True,1,600
3968,7198418,7203035,True,1,4617
3969,7201229,7250133,True,1,48904
3970,7206151,7207630,True,1,1479
3971,7206201,7207656,True,1,1455
3972,7207948,7210285,False,1,2337
3973,7207958,7253529,True,1,45571
3974,7207975,7213859,True,4,5884
3975,7208334,7212952,True,1,4618
3976,7209989,7210604,True,1,615
3977,7212563,7212967,False,1,404
3978,7212563,7213011,False,1,448
3979,7212563,7214880,False,1,2317
3980,7214569,7215085,True,4,516
3981,7214651,7218440,True,1,3789
3982,7214743,7231346,True,7,16603
3983,7215360,7215876,True,2,516
3984,7217876,7263442,True,1,45566
3985,7217893,7223780,True,4,5887
3986,7221611,7221867,False,1,256
3987,7221611,7222542,True,1,931
3988,7223037,7223680,True,3,643
3989,7226418,7226515,False,1,97
3990,7229111,7232491,True,1,3380
3991,7229324,7238720,True,2,9396
3992,7233951,7234839,True,2,888
3993,7236154,7237898,False,1,1744
3994,7236154,7237898,True,1,1744
3995,7238534,7239392,False,1,858
3996,7239024,7239405,True,1,381
3997,7239122,7239232,False,3,110
3998,7239122,7239232,True,7,110
3999,7239122,7239405,True,10,283
4000,7241350,7241528,True,1,178
4001,7242506,7242595,True,1,89
4002,7243219,7243340,True,1,121
4003,7244134,7244263,True,1,129
4004,7245792,7246032,True,1,240
4005,7246455,7246586,True,1,131
4006,7247030,7248042,False,1,1012
4007,7247030,7248042,True,2,1012
4008,7247030,7248046,False,1,1016
4009,7248119,7248247,True,1,128
4010,7251277,7251527,True,1,250
4011,7253230,7253773,False,1,543
4012,7259178,7259382,True,2,204
4013,7263345,7263611,True,1,266
4014,7263345,7269058,True,1,5713
4015,7263877,7264279,True,1,402
4016,7267902,7268074,False,2,172
4017,7267902,7268074,True,2,172
4018,7267902,7268675,True,1,773
4019,7269278,7269780,True,1,502
4020,7274209,7275478,True,1,1269
4021,7274614,7275472,False,1,858
4022,7277115,7279876,False,1,2761
4023,7280574,7280741,True,2,167
4024,7282490,7282572,True,1,82
4025,7283112,7284124,False,1,1012
4026,7283112,7284124,True,2,1012
4027,7283112,7284128,False,1,1016
4028,7285179,7294324,True,6,9145
4029,7288375,7288732,True,1,357
4030,7295239,7298619,True,1,3380
4031,7295252,7297149,False,1,1897
4032,7295499,7295589,False,1,90
4033,7298261,7298561,True,3,300
4034,7298266,7298563,True,3,297
4035,7299108,7300636,True,1,1528
4036,7301486,7301955,False,1,469
4037,7302929,7307094,True,1,4165
4038,7303875,7309595,True,1,5720
4039,7304653,7309939,True,1,5286
4040,7306456,7307892,True,1,1436
4041,7306965,7309342,False,2,2377
4042,7307474,7314540,True,2,7066
4043,7307474,7338762,True,1,31288
4044,7307474,7341507,True,1,34033
4045,7307510,7307586,True,1,76
4046,7307510,7307595,True,1,85
4047,7307624,7309342,False,1,1718
4048,7308446,7308481,False,1,35
4049,7309498,7311913,False,1,2415
4050,7309841,7309925,True,1,84
4051,7314872,7317219,True,1,2347
4052,7319758,7319966,True,2,208
4053,7319890,7319972,True,1,82
4054,7320119,7320198,True,1,79
4055,7326918,7327518,True,1,600
4056,7332769,7343092,True,1,10323
4057,7332769,7346750,True,1,13981
4058,7336882,7337416,True,1,534
4059,7336882,7337861,True,1,979
4060,7337163,7339575,True,1,2412
4061,7338327,7339644,True,1,1317
4062,7338529,7339603,True,1,1074
4063,7340345,7340960,True,2,615
4064,7345556,7346414,False,1,858
4065,7350907,7353647,False,1,2740
4066,7354054,7355066,False,1,1012
4067,7354054,7355066,True,2,1012
4068,7354054,7355070,False,1,1016
4069,7355336,7355963,True,1,627
4070,7367805,7368177,True,1,372
4071,7371653,7374065,True,2,2412
4072,7374610,7375276,True,3,666
4073,7378685,7378958,True,1,273
4074,7378756,7378976,True,1,220
4075,7388685,7395354,True,1,6669
4076,7393845,7393976,True,3,131
4077,7394683,7394857,True,1,174
4078,7402487,7403345,False,1,858
4079,7402907,7403652,False,1,745
4080,7407984,7408311,True,1,327
4081,7410986,7411998,False,1,1012
4082,7410986,7411998,True,2,1012
4083,7410986,7412002,False,1,1016
4084,7411669,7424469,True,1,12800
4085,7411701,7412559,False,1,858
4086,7416268,7416829,True,3,561
4087,7416846,7437478,True,1,20632
4088,7416893,7436754,True,1,19861
4089,7416893,7436934,True,1,20041
4090,7420200,7421212,False,1,1012
4091,7420200,7421212,True,2,1012
4092,7420200,7421216,False,1,1016
4093,7426617,7427658,True,3,1041
4094,7426757,7432619,True,4,5862
4095,7433113,7440416,False,1,7303
4096,7442048,7505547,True,1,63499
4097,7442239,7443037,True,2,798
4098,7442263,7508023,False,1,65760
4099,7443604,7450116,True,1,6512
4100,7444184,7508302,True,1,64118
4101,7446805,7450618,True,1,3813
4102,7448705,7450218,True,1,1513
4103,7451990,7453150,True,1,1160
4104,7456851,7456973,True,1,122
4105,7458507,7459064,False,1,557
4106,7460725,7461486,True,1,761
4107,7463842,7509429,True,1,45587
4108,7463859,7469745,True,4,5886
4109,7465777,7472579,True,1,6802
4110,7467016,7468104,True,2,1088
4111,7468950,7469187,True,4,237
4112,7470409,7473336,True,1,2927
4113,7471394,7472056,False,2,662
4114,7475931,7476789,False,1,858
4115,7484430,7485442,False,1,1012
4116,7484430,7485442,True,2,1012
4117,7484430,7485446,False,1,1016
4118,7485672,7486073,True,1,401
4119,7489446,7491221,False,1,1775
4120,7499547,7501960,True,1,2413
4121,7500833,7501721,True,1,888
4122,7501865,7501955,True,2,90
4123,7508755,7511167,True,1,2412
4124,7514887,7520484,True,1,5597
4125,7517116,7517216,True,1,100
4126,7525480,7527826,True,1,2346
4127,7529193,7532816,True,2,3623
4128,7535363,7545844,True,2,10481
4129,7535363,7545886,True,1,10523
4130,7537755,7541229,True,1,3474
4131,7539146,7539504,False,1,358
4132,7540045,7540611,True,2,566
4133,7544032,7549893,True,1,5861
4134,7548049,7548502,True,1,453
4135,7548125,7549124,False,4,999
4136,7548125,7549124,True,7,999
4137,7549181,7549979,True,1,798
4138,7549215,7551314,False,1,2099
4139,7549970,7596003,False,1,46033
4140,7552911,7554652,True,2,1741
4141,7552911,7554694,True,1,1783
4142,7553778,7554667,True,2,889
4143,7553778,7554709,True,1,931
4144,7554930,7556246,True,2,1316
4145,7556386,7556471,True,4,85
4146,7561692,7561823,True,1,131
4147,7565621,7567427,False,1,1806
4148,7571439,7571913,False,1,474
4149,7572975,7575387,True,1,2412
4150,7578389,7579682,False,1,1293
4151,7586135,7587837,True,1,1702
4152,7601057,7601185,True,1,128
4153,7602519,7603917,True,1,1398
4154,7602575,7603917,True,2,1342
4155,7602671,7603917,True,1,1246
4156,7610144,7611189,True,1,1045
4157,7612333,7612827,False,1,494
4158,7612333,7612827,True,1,494
4159,7617174,7627151,True,1,9977
4160,7618432,7625606,True,1,7174
4161,7620880,7626743,True,1,5863
4162,7634162,7637494,False,1,3332
4163,7634162,7647924,False,1,13762
4164,7634162,7650016,False,1,15854
4165,7637926,7648475,True,1,10549
4166,7638260,7648570,False,2,10310
4167,7638260,7648570,True,5,10310
4168,7638518,7648710,False,1,10192
4169,7639969,7640483,False,1,514
4170,7639969,7640483,True,2,514
4171,7639969,7642018,True,1,2049
4172,7640906,7641627,True,1,721
4173,7642814,7643414,False,1,600
4174,7646924,7649621,True,1,2697
4175,7647420,7653631,False,1,6211
4176,7652535,7653435,False,1,900
4177,7652535,7653435,True,3,900
4178,7654995,7662648,True,4,7653
4179,7655257,7655850,True,1,593
4180,7655894,7659117,True,1,3223
4181,7655897,7658435,True,3,2538
4182,7655897,7658681,True,1,2784
4183,7655897,7658694,True,1,2797
4184,7655897,7659117,True,1,3220
4185,7657674,7658532,False,1,858
4186,7658556,7658761,True,2,205
4187,7659646,7662243,True,3,2597
4188,7659646,7674606,True,1,14960
4189,7659646,7674876,True,1,15230
4190,7666156,7667168,False,1,1012
4191,7666156,7667168,True,2,1012
4192,7666156,7667172,False,1,1016
4193,7682723,7727166,True,1,44443
4194,7684204,7688022,True,1,3818
4195,7684236,7684311,False,1,75
4196,7692645,7692946,True,1,301
4197,7694747,7695112,False,1,365
4198,7694747,7695246,False,1,499
4199,7697643,7710329,True,1,12686
4200,7699351,7699652,True,1,301
4201,7701022,7784883,True,1,83861
4202,7701197,7701498,True,1,301
4203,7704415,7707201,False,1,2786
4204,7704415,7720764,True,1,16349
4205,7711620,7734861,True,1,23241
4206,7718715,7719834,True,1,1119
4207,7721552,7722067,True,1,515
4208,7722994,7725882,True,1,2888
4209,7739036,7758056,True,1,19020
4210,7740116,7741630,False,1,1514
4211,7740116,7758312,False,1,18196
4212,7740116,7758312,True,1,18196
4213,7741041,7759033,True,2,17992
4214,7754571,7865712,True,3,111141
4215,7756337,7758748,True,2,2411
4216,7756470,7773948,False,1,17478
4217,7761623,7766340,True,2,4717
4218,7764977,7765278,True,1,301
4219,7773987,7777680,True,1,3693
4220,7784235,7784393,False,1,158
4221,7795385,7796173,False,1,788
4222,7797088,7830611,True,1,33523
4223,7797604,7799476,False,1,1872
4224,7798888,7883746,False,1,84858
4225,7801526,7810707,False,1,9181
4226,7812963,7813572,False,1,609
4227,7812963,7814078,True,1,1115
4228,7812963,7814704,True,1,1741
4229,7818002,7819913,True,1,1911
4230,7819098,7820282,True,1,1184
4231,7824604,7828294,True,1,3690
4232,7826916,7827707,True,3,791
4233,7839631,7841227,False,1,1596
4234,7839631,7841227,True,4,1596
4235,7851831,7853920,True,2,2089
4236,7866276,7866554,True,1,278
4237,7867150,7870026,True,1,2876
4238,7868400,7932274,True,1,63874
4239,7868583,7869381,True,2,798
4240,7868615,7934750,False,1,66135
4241,7871577,7872278,False,1,701
4242,7874410,7882545,True,1,8135
4243,7882630,7886273,True,1,3643
4244,7888258,7891969,True,1,3711
4245,7888282,7891978,True,1,3696
4246,7888767,7892019,False,1,3252
4247,7888767,7892537,False,1,3770
4248,7898589,7898747,False,1,158
4249,7901156,7946031,False,1,44875
4250,7912357,7913172,True,1,815
4251,7913198,7913666,True,1,468
4252,7918086,7918506,True,3,420
4253,7924039,7924649,False,1,610
4254,7924039,7925158,True,1,1119
4255,7924039,7925786,False,1,1747
4256,7924782,7955441,False,1,30659
4257,7928962,7930409,True,1,1447
4258,7947407,7948279,True,1,872
4259,7952798,7953264,True,1,466
4260,7957518,7958145,True,1,627
4261,7958490,7958961,True,1,471
4262,7959298,7959405,True,1,107
4263,7967374,7969233,False,1,1859
4264,7983590,7987225,True,1,3635
4265,7989792,7990505,True,1,713
4266,7995018,7998651,True,1,3633
4267,8001429,8001723,False,1,294
4268,8011775,8012748,False,1,973
4269,8013245,8014060,True,1,815
4270,8014086,8014554,True,1,468
4271,8015533,8020667,True,1,5134
4272,8015651,8016863,False,1,1212
4273,8024673,8025487,True,1,814
4274,8025513,8025980,True,1,467
4275,8029616,8037317,True,1,7701
4276,8043268,8053359,True,1,10091
4277,8043918,8050997,True,1,7079
4278,8044009,8053717,False,1,9708
4279,8054080,8054082,True,1,2
4280,8054209,8054573,True,1,364
4281,8069806,8072934,False,1,3128
4282,8075434,8078634,False,1,3200
4283,8077422,8081133,True,1,3711
4284,8077446,8081142,True,1,3696
4285,8081531,8082013,True,2,482
4286,8084779,8085538,True,1,759
4287,8087753,8087911,False,1,158
4288,8088127,8088496,False,1,369
4289,8088127,8088661,False,1,534
4290,8088127,8089181,False,1,1054
4291,8088127,8089269,False,1,1142
4292,8090761,8092042,True,2,1281
4293,8092828,8096462,True,1,3634
4294,8093068,8099644,True,1,6576
4295,8093457,8099182,True,2,5725
4296,8093760,8099644,True,1,5884
4297,8093971,8100097,True,1,6126
4298,8101342,8102322,True,1,980
4299,8101479,8124201,False,1,22722
4300,8108217,8110064,True,2,1847
4301,8111286,8115104,True,1,3818
4302,8113242,8113851,False,1,609
4303,8113242,8114357,True,1,1115
4304,8121829,8122194,False,1,365
4305,8121829,8122328,False,1,499
4306,8122483,8123298,True,1,815
4307,8122853,8126546,True,1,3693
4308,8123324,8123792,True,1,468
4309,8124619,8124806,True,1,187
4310,8126161,8126646,True,1,485
4311,8127171,8127612,True,1,441
4312,8133101,8133259,False,1,158
4313,8135893,8136080,True,1,187
4314,8137435,8137920,True,1,485
4315,8137869,8139154,True,4,1285
4316,8138445,8138886,True,1,441
4317,8138746,8142099,True,2,3353
4318,8142756,8149689,True,1,6933
4319,8145073,8146498,True,1,1425
4320,8145807,8146926,True,1,1119
4321,8148644,8149159,True,1,515
4322,8150086,8152974,True,1,2888
4323,8152560,8152569,True,1,9
4324,8154010,8160942,True,1,6932
4325,8156028,8156392,True,1,364
4326,8159353,8167020,True,1,7667
4327,8159353,8178671,False,1,19318
4328,8160147,8160487,True,1,340
4329,8163812,8163821,True,1,9
4330,8166626,8167745,True,1,1119
4331,8167280,8167644,True,1,364
4332,8168690,8169205,True,1,515
4333,8170132,8173017,True,1,2885
4334,8175542,8186814,False,1,11272
4335,8175542,8186814,True,1,11272
4336,8180073,8180555,True,3,482
4337,8181025,8184768,True,2,3743
4338,8186669,8187038,False,1,369
4339,8186669,8187203,False,1,534
4340,8186669,8187723,False,1,1054
4341,8186669,8187811,False,1,1142
4342,8188266,8221304,False,1,33038
4343,8188860,8194851,False,1,5991
4344,8188959,8194851,False,1,5892
4345,8189303,8190584,True,2,1281
4346,8191325,8191807,True,2,482
4347,8194573,8195332,True,1,759
4348,8196242,8196466,True,1,224
4349,8197921,8198290,False,1,369
4350,8197921,8198455,False,1,534
4351,8197921,8198975,False,1,1054
4352,8197921,8199063,False,1,1142
4353,8200555,8201836,True,2,1281
4354,8201326,8202213,False,1,887
4355,8206759,8208607,True,2,1848
4356,8218011,8219858,True,2,1847
4357,8232184,8239144,True,4,6960
4358,8232189,8233466,True,5,1277
4359,8235226,8236959,False,1,1733
4360,8235369,8235556,True,1,187
4361,8236648,8243499,True,5,6851
4362,8236648,8262604,True,1,25956
4363,8236648,8403803,True,2,167155
4364,8236648,8416149,True,1,179501
4365,8236648,8417186,True,1,180538
4366,8236911,8237396,True,1,485
4367,8237921,8238362,True,1,441
4368,8240224,8258876,True,1,18652
4369,8253496,8260568,True,1,7072
4370,8259049,8285100,True,6,26051
4371,8263644,8263646,True,1,2
4372,8263773,8264137,True,1,364
4373,8269423,8269776,False,1,353
4374,8269423,8269776,True,2,353
4375,8269423,8269970,True,1,547
4376,8269423,8271606,True,1,2183
4377,8272787,8273898,False,1,1111
4378,8273405,8275190,True,1,1785
4379,8273827,8275053,True,1,1226
4380,8274897,8276855,False,1,1958
4381,8274897,8276855,True,1,1958
4382,8281800,8285432,True,1,3632
4383,8287308,8293300,False,1,5992
4384,8287407,8293300,False,1,5893
4385,8291071,8291553,True,2,482
4386,8294319,8295078,True,1,759
4387,8297290,8297691,True,1,401
4388,8297667,8298036,False,1,369
4389,8297667,8298201,False,1,534
4390,8297667,8298721,False,1,1054
4391,8297667,8298809,False,1,1142
4392,8298578,8304576,False,1,5998
4393,8298677,8304576,False,1,5899
4394,8300249,8302393,True,1,2144
4395,8300301,8301582,True,2,1281
4396,8304908,8308031,True,1,3123
4397,8307368,8308491,True,4,1123
4398,8310266,8313899,True,1,3633
4399,8311449,8312262,True,1,813
4400,8312288,8312755,True,1,467
4401,8317757,8319604,True,2,1847
4402,8332780,8336423,True,1,3643
4403,8337557,8340094,True,1,2537
4404,8338511,8340752,True,1,2241
4405,8339045,8341271,True,1,2226
4406,8339921,8340735,True,1,814
4407,8340761,8341228,True,1,467
4408,8341926,8342322,False,1,396
4409,8341926,8342322,True,2,396
4410,8344363,8345896,True,1,1533
4411,8346054,8347385,True,1,1331
4412,8347629,8349663,False,1,2034
4413,8348322,8358602,True,1,10280
4414,8349048,8349128,True,5,80
4415,8362507,8363322,True,1,815
4416,8363348,8363816,True,1,468
4417,8366824,8369619,True,1,2795
4418,8367843,8368196,False,1,353
4419,8367843,8368196,True,2,353
4420,8367843,8368390,True,1,547
4421,8367843,8370026,True,1,2183
4422,8371825,8373611,True,1,1786
4423,8372247,8373473,True,1,1226
4424,8372728,8386140,True,1,13412
4425,8379137,8379490,False,1,353
4426,8379137,8379490,True,2,353
4427,8379137,8379684,True,1,547
4428,8379137,8381320,True,1,2183
4429,8381229,8389420,True,1,8191
4430,8383119,8384905,True,1,1786
4431,8383541,8384767,True,1,1226
4432,8395714,8396115,True,1,401
4433,8396962,8398303,True,1,1341
4434,8398324,8404322,False,1,5998
4435,8398423,8404322,False,1,5899
4436,8398673,8400817,True,1,2144
4437,8404054,8429769,True,1,25715
4438,8407010,8407411,True,1,401
4439,8409969,8412113,True,1,2144
4440,8410763,8411000,True,1,237
4441,8410763,8411231,True,1,468
4442,8414336,8414755,True,1,419
4443,8416815,8431868,False,1,15053
4444,8423433,8423620,True,1,187
4445,8424975,8425460,True,1,485
4446,8425985,8426426,True,1,441
4447,8441550,8448482,True,1,6932
4448,8450627,8450814,True,1,187
4449,8451352,8451361,True,1,9
4450,8452169,8452654,True,1,485
4451,8453179,8453620,True,1,441
4452,8454085,8454204,True,2,119
4453,8454820,8455184,True,1,364
4454,8459153,8460725,True,1,1572
4455,8468764,8475843,True,1,7079
4456,8475251,8476820,True,2,1569
4457,8476948,8477696,True,1,748
4458,8476948,8480190,True,1,3242
4459,8478863,8479345,True,2,482
4460,8478871,8479224,False,1,353
4461,8478871,8479224,True,2,353
4462,8478871,8479418,True,1,547
4463,8478871,8481054,True,1,2183
4464,8478926,8478928,True,1,2
4465,8479055,8479419,True,1,364
4466,8479478,8485199,True,1,5721
4467,8482111,8482870,True,1,759
4468,8482339,8484926,False,1,2587
4469,8482339,8484926,True,1,2587
4470,8482853,8484639,True,1,1786
4471,8483275,8484501,True,1,1226
4472,8485459,8485828,False,1,369
4473,8485459,8485993,False,1,534
4474,8485459,8486513,False,1,1054
4475,8485459,8486601,False,1,1142
4476,8488093,8489374,True,2,1281
4477,8494096,8501175,True,1,7079
4478,8494277,8496333,True,1,2056
4479,8504258,8504260,True,1,2
4480,8504387,8504751,True,1,364
4481,8505549,8507396,True,2,1847
4482,8506373,8506855,True,2,482
4483,8506744,8507145,True,1,401
4484,8509274,8509511,True,1,237
4485,8509274,8509742,True,1,468
4486,8509621,8510380,True,1,759
4487,8509703,8511847,True,1,2144
4488,8512846,8513265,True,1,419
4489,8512969,8513338,False,1,369
4490,8512969,8513503,False,1,534
4491,8512969,8514023,False,1,1054
4492,8512969,8514111,False,1,1142
4493,8515603,8516884,True,2,1281
4494,8529502,8539900,False,1,10398
4495,8530371,8533660,True,3,3289
4496,8531709,8532191,True,2,482
4497,8533059,8534906,True,2,1847
4498,8534073,8539903,True,1,5830
4499,8534957,8535716,True,1,759
4500,8537740,8537953,True,1,213
4501,8538305,8538674,False,1,369
4502,8538305,8538839,False,1,534
4503,8538305,8539359,False,1,1054
4504,8538305,8539447,False,1,1142
4505,8539178,8539683,True,3,505
4506,8540939,8542220,True,2,1281
4507,8546999,8549536,True,1,2537
4508,8547953,8550194,True,1,2241
4509,8551368,8551764,False,1,396
4510,8551368,8551764,True,2,396
4511,8552522,8557057,False,2,4535
4512,8552522,8557057,True,1,4535
4513,8552522,8593377,True,1,40855
4514,8553805,8555338,True,1,1533
4515,8555496,8556827,True,1,1331
4516,8558395,8560242,True,2,1847
4517,8558954,8561462,True,1,2508
4518,8562074,8566083,True,1,4009
4519,8572061,8584957,True,1,12896
4520,8584002,8593575,False,1,9573
4521,8584002,8593575,True,2,9573
4522,8585106,8586786,True,2,1680
4523,8585106,8586798,True,1,1692
4524,8585106,8594559,False,1,9453
4525,8586112,8592112,False,1,6000
4526,8586211,8592112,False,1,5901
4527,8592887,8597146,False,1,4259
4528,8608855,8626402,True,1,17547
4529,8609348,8610531,True,1,1183
4530,8609348,8610570,True,1,1222
4531,8609348,8610609,True,1,1261
4532,8613704,8619696,False,1,5992
4533,8613803,8619696,False,1,5893
4534,8615436,8617275,True,1,1839
4535,8620302,8620539,True,1,237
4536,8620302,8620770,True,1,468
4537,8623640,8628769,True,1,5129
4538,8623876,8624295,True,1,419
4539,8625594,8629971,False,1,4377
4540,8625594,8629971,True,1,4377
4541,8628147,8631436,True,3,3289
4542,8635516,8635729,True,1,213
4543,8639040,8645031,False,1,5991
4544,8639107,8642396,True,3,3289
4545,8639139,8645031,False,1,5892
4546,8646476,8646689,True,1,213
4547,8648233,8648489,False,1,256
4548,8648233,8648489,True,4,256
4549,8650298,8654827,False,2,4529
4550,8650298,8654827,True,1,4529
4551,8659838,8663843,True,1,4005
4552,8661222,8665757,False,2,4535
4553,8661222,8665757,True,1,4535
4554,8661222,8701998,True,1,40776
4555,8666677,8667030,False,1,353
4556,8666677,8667030,True,2,353
4557,8666677,8667224,True,1,547
4558,8666677,8668860,True,1,2183
4559,8670659,8672445,True,1,1786
4560,8670774,8674771,True,1,3997
4561,8671081,8672307,True,1,1226
4562,8674679,8680169,True,2,5490
4563,8687120,8687226,False,1,106
4564,8687120,8687226,True,2,106
4565,8690197,8699567,True,4,9370
4566,8690197,8700316,True,1,10119
4567,8690848,8699876,True,1,9028
4568,8694217,8694570,False,1,353
4569,8694217,8694570,True,2,353
4570,8694217,8694764,True,1,547
4571,8694217,8696400,True,1,2183
4572,8694550,8694951,True,1,401
4573,8697509,8699653,True,1,2144
4574,8698199,8699985,True,1,1786
4575,8698621,8699847,True,1,1226
4576,8700066,8732576,True,1,32510
4577,8700066,8737066,True,1,37000
4578,8719591,8719944,False,1,353
4579,8719591,8719944,True,2,353
4580,8719591,8720138,True,1,547
4581,8719591,8721774,True,1,2183
4582,8722090,8722491,True,1,401
4583,8722156,8722687,True,3,531
4584,8723573,8725359,True,1,1786
4585,8723995,8725221,True,1,1226
4586,8725049,8727193,True,1,2144
4587,8726509,8726956,True,4,447
4588,8734212,8738551,False,1,4339
4589,8734212,8738551,True,1,4339
4590,8734805,8737342,True,1,2537
4591,8735759,8738000,True,1,2241
4592,8739174,8739570,True,2,396
4593,8739215,8742504,True,3,3289
4594,8740700,8790703,True,1,50003
4595,8746584,8746797,True,1,213
4596,8747460,8747861,True,1,401
4597,8750419,8752561,True,1,2142
4598,8761330,8765865,False,2,4535
4599,8761330,8765865,True,1,4535
4600,8761330,8802106,False,1,40776
4601,8762345,8764882,True,1,2537
4602,8763299,8765540,True,1,2241
4603,8764668,8765561,True,1,893
4604,8766302,8768070,True,1,1768
4605,8766714,8767110,False,1,396
4606,8766714,8767110,True,2,396
4607,8769151,8770684,True,1,1533
4608,8770207,8773740,False,1,3533
4609,8770842,8772173,True,1,1331
4610,8770882,8774879,True,1,3997
4611,8773260,8774802,True,1,1542
4612,8775953,8776912,True,1,959
4613,8776483,8776912,True,2,429
4614,8780657,8781170,False,1,513
4615,8780657,8781170,True,2,513
4616,8787723,8790260,True,1,2537
4617,8788412,8788526,True,3,114
4618,8788677,8790918,True,1,2241
4619,8791646,8792042,True,1,396
4620,8792092,8792488,False,1,396
4621,8792092,8792488,True,2,396
4622,8792390,8793544,True,3,1154
4623,8794529,8796062,True,1,1533
4624,8796220,8797551,True,1,1331
4625,8801763,8802065,True,2,302
4626,8802481,8802568,True,1,87
4627,8804840,8818668,True,1,13828
4628,8805470,8808566,True,1,3096
4629,8806766,8820840,True,3,14074
4630,8806766,8855375,True,1,48609
4631,8809356,8809536,True,1,180
4632,8809706,8809827,True,4,121
4633,8813209,8813511,True,1,302
4634,8815859,8816670,True,1,811
4635,8817160,8817279,True,3,119
4636,8819353,8819480,True,1,127
4637,8820041,8821701,False,1,1660
4638,8820993,8821386,False,1,393
4639,8823851,8824301,True,1,450
4640,8824677,8825124,True,4,447
4641,8834320,8838659,False,1,4339
4642,8835571,8835808,True,1,237
4643,8835571,8836039,True,1,468
4644,8839144,8839563,True,1,419
4645,8842041,8843574,False,1,1533
4646,8842551,8843284,True,1,733
4647,8843310,8844641,True,1,1331
4648,8843842,8852716,True,1,8874
4649,8853106,8877082,False,1,23976
4650,8860827,8870802,True,1,9975
4651,8860959,8861196,True,1,237
4652,8860959,8861427,True,1,468
4653,8864532,8864951,True,1,419
4654,8871430,8872972,True,1,1542
4655,8880297,8880802,True,1,505
4656,8884460,8884922,True,1,462
4657,8885452,8885831,True,3,379
4658,8886581,8886695,True,3,114
4659,8889814,8890210,True,1,396
4660,8890558,8891712,True,3,1154
4661,8890622,8891046,True,2,424
4662,8899182,8899315,False,1,133
4663,8899931,8900233,True,2,302
4664,8900649,8900736,True,1,87
4665,8901250,8901779,True,2,529
4666,8907524,8907704,True,1,180
4667,8908008,8908245,True,1,237
4668,8908008,8908476,True,1,468
4669,8911580,8911999,True,1,419
4670,8915320,8915439,True,3,119
4671,8917513,8917640,True,1,127
4672,8922573,8922857,True,3,284
4673,8922573,8923072,True,1,499
4674,8935472,8935596,True,2,124
4675,8935913,8936022,True,1,109
4676,8944222,8944726,False,1,504
4677,8944222,8944726,True,1,504
4678,8944673,8947524,True,2,2851
4679,8944802,8947721,False,1,2919
4680,8951021,8964112,False,1,13091
4681,8951898,8960188,True,2,8290
4682,8951898,8967310,True,1,15412
4683,8953829,8957118,True,1,3289
4684,8957341,8959150,True,1,1809
4685,8958508,8958629,True,2,121
4686,8961198,8961411,True,1,213
4687,8973728,8973923,False,1,195
4688,8974668,8982929,True,1,8261
4689,8975980,8980508,False,2,4528
4690,8975980,8980508,True,1,4528
4691,8975980,9016723,True,1,40743
4692,8976132,8983487,True,1,7355
4693,8979256,8979404,True,1,148
4694,8979264,8979404,True,1,140
4695,8979264,8979409,True,1,145
4696,8979594,8979846,True,1,252
4697,8980549,8983838,True,3,3289
4698,8981196,9034991,True,1,53795
4699,8984006,8984118,True,4,112
4700,8985518,8989467,False,1,3949
4701,8987598,8988218,True,1,620
4702,8987918,8988131,True,1,213
4703,8997384,8997517,False,1,133
4704,8999203,9000688,True,1,1485
4705,8999203,9001408,True,1,2205
4706,8999452,8999981,True,2,529
4707,9000388,9000395,True,2,7
4708,9002700,9007235,False,2,4535
4709,9002700,9007235,True,2,4535
4710,9002700,9043559,True,1,40859
4711,9006988,9007062,True,2,74
4712,9007675,9007812,True,1,137
4713,9008959,9009308,True,1,349
4714,9009103,9016927,True,1,7824
4715,9012252,9016265,True,1,4013
4716,9023654,9025353,True,3,1699
4717,9026477,9029766,True,3,3289
4718,9027871,9033799,True,1,5928
4719,9031435,9032102,True,1,667
4720,9031435,9032327,True,1,892
4721,9033618,9033742,True,2,124
4722,9033846,9034059,True,1,213
4723,9034059,9034168,True,1,109
4724,9037410,9037603,True,6,193
4725,9040795,9040938,True,1,143
4726,9042394,9042898,False,1,504
4727,9042394,9042898,True,1,504
4728,9046640,9047516,True,1,876
4729,9048628,9053157,False,2,4529
4730,9048628,9053157,True,1,4529
4731,9048884,9053233,False,1,4349
4732,9048884,9053233,True,1,4349
4733,9049566,9080201,True,1,30635
4734,9052828,9059976,True,1,7148
4735,9052828,9081823,True,1,28995
4736,9056674,9056795,True,2,121
4737,9058168,9062181,True,1,4013
4738,9058316,9060075,True,1,1759
4739,9069287,9069395,True,3,108
4740,9070320,9071144,True,5,824
4741,9071894,9072089,False,1,195
4742,9075780,9080157,False,1,4377
4743,9075780,9080157,True,1,4377
4744,9076189,9077218,True,1,1029
4745,9077422,9077570,True,1,148
4746,9077430,9077570,True,1,140
4747,9077430,9077575,True,1,145
4748,9077760,9078012,True,1,252
4749,9082172,9082287,True,4,115
4750,9085535,9090902,True,1,5367
4751,9085770,9086390,True,1,620
4752,9086864,9096604,True,1,9740
4753,9087140,9088825,True,1,1685
4754,9088059,9090320,False,1,2261
4755,9091886,9092003,True,1,117
4756,9091886,9101341,True,1,9455
4757,9098560,9098567,True,2,7
4758,9105845,9105982,True,1,137
4759,9107129,9107478,True,1,349
4760,9107273,9115089,True,1,7816
4761,9107773,9154036,False,1,46263
4762,9121640,9125989,False,1,4349
4763,9121640,9125989,True,1,4349
4764,9123360,9123466,True,5,106
4765,9123360,9124371,False,1,1011
4766,9129589,9130256,True,1,667
4767,9129589,9130481,True,1,892
4768,9135561,9135754,True,6,193
4769,9138947,9139090,True,1,143
4770,9149504,9149662,True,2,158
4771,9149737,9150184,True,4,447
4772,9176695,9177142,True,4,447
4773,9177781,9189471,False,1,11690
4774,9183540,9189562,True,2,6022
4775,9185511,9186036,True,1,525
4776,9195965,9196586,True,2,621
4777,9196488,9198030,True,1,1542
4778,9199124,9202492,True,2,3368
4779,9209595,9210042,True,4,447
4780,9211639,9211753,True,3,114
4781,9213400,9228050,True,1,14650
4782,9214872,9215268,True,1,396
4783,9215189,9216016,False,1,827
4784,9215616,9216770,True,3,1154
4785,9221891,9222055,False,1,164
4786,9222397,9222844,True,4,447
4787,9223446,9224988,True,1,1542
4788,9224985,9225287,True,2,302
4789,9225703,9225790,True,1,87
4790,9227827,9232094,True,7,4267
4791,9227827,9233054,True,1,5227
4792,9232578,9232758,True,1,180
4793,9238598,9238712,True,3,114
4794,9240366,9240485,True,3,119
4795,9241832,9242228,True,1,396
4796,9241957,9242156,False,1,199
4797,9241957,9242156,True,1,199
4798,9242559,9242686,True,1,127
4799,9242576,9243730,True,3,1154
4800,9245096,9245600,False,1,504
4801,9246543,9247374,True,1,831
4802,9251949,9252251,True,2,302
4803,9252667,9252754,True,1,87
4804,9254822,9260927,True,1,6105
4805,9256344,9257886,True,1,1542
4806,9259542,9259722,True,1,180
4807,9267346,9267465,True,3,119
4808,9269539,9269666,True,1,127
4809,9269591,9269791,True,1,200
4810,9271495,9271609,True,3,114
4811,9274601,9274703,True,1,102
4812,9274726,9275122,True,1,396
4813,9275470,9276624,True,3,1154
4814,9275750,9276188,True,1,438
4815,9279167,9291403,True,1,12236
4816,9280199,9291905,True,1,11706
4817,9284839,9285141,True,2,302
4818,9285557,9285644,True,1,87
4819,9286654,9287121,True,3,467
4820,9292432,9292612,True,1,180
4821,9296071,9298997,True,4,2926
4822,9300228,9300347,True,3,119
4823,9302421,9302548,True,1,127
4824,9315652,9317497,True,1,1845
4825,9318867,9319375,True,1,508
4826,9319393,9321827,False,1,2434
4827,9322396,9322529,False,1,133
4828,9324464,9324993,True,2,529
4829,9330415,9338871,True,1,8456
4830,9333950,9346651,True,2,12701
4831,9333950,9346656,True,1,12706
4832,9333954,9346651,True,1,12697
4833,9333954,9346656,True,1,12702
4834,9334538,9347011,True,1,12473
4835,9342818,9348488,True,1,5670
4836,9349352,9349485,False,1,133
4837,9349873,9375188,False,1,25315
4838,9349873,9375188,True,4,25315
4839,9350580,9359268,True,1,8688
4840,9351420,9351949,False,1,529
4841,9351911,9355088,True,1,3177
4842,9353787,9358289,False,1,4502
4843,9358594,9358718,True,2,124
4844,9358844,9362104,True,1,3260
4845,9359035,9359144,True,1,109
4846,9359464,9364440,True,1,4976
4847,9360372,9360603,True,1,231
4848,9366842,9367702,True,1,860
4849,9367370,9367874,False,1,504
4850,9367370,9367874,True,1,504
4851,9369361,9374112,False,1,4751
4852,9377533,9377773,True,1,240
4853,9377533,9377809,True,1,276
4854,9377533,9377829,True,1,296
4855,9377533,9378030,True,1,497
4856,9381650,9381771,True,2,121
4857,9382324,9382457,False,1,133
4858,9384392,9384921,True,2,529
4859,9384665,9384772,True,1,107
4860,9385771,9392167,False,1,6396
4861,9395194,9395327,False,1,133
4862,9396859,9400519,False,1,3660
4863,9396870,9397065,False,1,195
4864,9397262,9397791,True,2,529
4865,9398514,9398737,True,1,223
4866,9399029,9399459,True,2,430
4867,9399101,9399819,True,2,718
4868,9402398,9402546,True,1,148
4869,9402406,9402546,True,1,140
4870,9402406,9402551,True,1,145
4871,9402736,9402988,True,1,252
4872,9405170,9407740,True,1,2570
4873,9405391,9420281,True,1,14890
4874,9407148,9407263,True,4,115
4875,9410746,9411366,True,1,620
4876,9412877,9422365,True,1,9488
4877,9418520,9418644,True,2,124
4878,9418961,9419070,True,1,109
4879,9420915,9421460,True,3,545
4880,9422652,9427973,True,5,5321
4881,9423536,9423543,True,2,7
4882,9425658,9432711,False,1,7053
4883,9425658,9432948,False,1,7290
4884,9425658,9433171,False,1,7513
4885,9427290,9427794,False,1,504
4886,9427290,9427794,True,1,504
4887,9428313,9430552,True,1,2239
4888,9428331,9433398,True,2,5067
4889,9430618,9487062,True,2,56444
4890,9430821,9430958,True,1,137
4891,9431384,9431508,True,2,124
4892,9431825,9431934,True,1,109
4893,9432105,9432454,True,1,349
4894,9432249,9440066,True,1,7817
4895,9440154,9440658,False,1,504
4896,9441578,9441699,True,2,121
4897,9444428,9502396,True,2,57968
4898,9449735,9460335,True,2,10600
4899,9454567,9455236,True,1,669
4900,9454567,9455461,True,1,894
4901,9456730,9456925,False,1,195
4902,9460543,9460736,True,6,193
4903,9462258,9462406,True,1,148
4904,9462266,9462406,True,1,140
4905,9462266,9462411,True,1,145
4906,9462596,9462848,True,1,252
4907,9463929,9464072,True,1,143
4908,9467008,9467123,True,4,115
4909,9470606,9471226,True,1,620
4910,9473569,9499140,True,1,25571
4911,9473569,9518244,True,5,44675
4912,9484507,9486689,True,2,2182
4913,9487573,9487670,True,3,97
4914,9490663,9490800,True,1,137
4915,9491947,9492296,True,1,349
4916,9492091,9499917,True,1,7826
4917,9493407,9493526,False,1,119
4918,9493407,9493526,True,6,119
4919,9500889,9501187,True,1,298
4920,9514427,9515094,True,1,667
4921,9514427,9515319,True,1,892
4922,9516604,9521719,True,2,5115
4923,9520398,9520591,True,6,193
4924,9523781,9523924,True,1,143
4925,9525656,9527543,False,1,1887
4926,9525656,9527543,True,2,1887
4927,9527325,9529497,True,1,2172
4928,9536534,9539888,True,1,3354
4929,9538479,9538733,True,1,254
4930,9538479,9538756,False,1,277
4931,9538479,9538756,True,1,277
4932,9547385,9547968,False,1,583
4933,9553720,9668624,True,1,114904
4934,9553720,9712426,True,1,158706
4935,9568987,9570751,True,1,1764
4936,9576503,9576982,True,1,479
4937,9582571,9583505,False,1,934
4938,9583781,9584023,False,1,242
4939,9586060,9616379,True,1,30319
4940,9602473,9603335,True,1,862
4941,9603249,9603357,True,1,108
4942,9603873,9611305,True,2,7432
4943,9606070,9606176,True,2,106
4944,9630648,9636065,False,1,5417
4945,9630648,9636065,True,1,5417
4946,9634463,9647559,True,1,13096
4947,9655613,9655699,False,1,86
4948,9655613,9655699,True,2,86
4949,9656438,9657317,True,1,879
4950,9659805,9665447,True,1,5642
4951,9668857,9670969,False,1,2112
4952,9670851,9672934,True,3,2083
4953,9671251,9671483,True,1,232
4954,9672873,9728276,True,1,55403
4955,9673554,9678790,True,1,5236
4956,9674353,9674391,False,1,38
4957,9675800,9675945,False,1,145
4958,9675800,9675945,True,4,145
4959,9677036,9677184,True,1,148
4960,9677169,9683348,True,1,6179
4961,9677890,9683023,True,1,5133
4962,9677893,9683023,True,2,5130
4963,9679518,9685552,True,2,6034
4964,9679627,9680968,True,1,1341
4965,9681616,9681741,True,4,125
4966,9683197,9683589,True,1,392
4967,9687284,9687409,True,1,125
4968,9688069,9688151,True,2,82
4969,9690828,9691092,True,2,264
4970,9691562,9691650,True,1,88
4971,9693534,9694571,True,1,1037
4972,9694464,9694675,True,3,211
4973,9698236,9698865,True,1,629
4974,9700932,9704813,True,1,3881
4975,9702991,9703786,False,1,795
4976,9704270,9704342,True,1,72
4977,9707352,9707724,False,1,372
4978,9708514,9714372,True,1,5858
4979,9708860,9709504,True,3,644
4980,9708902,9709504,True,1,602
4981,9709833,9715691,True,3,5858
4982,9714146,9715374,True,1,1228
4983,9718260,9719291,False,1,1031
4984,9718260,9719291,True,3,1031
4985,9721354,9744939,False,1,23585
4986,9723486,9725817,True,1,2331
4987,9725458,9725573,True,1,115
4988,9725731,9725835,True,1,104
4989,9729363,9729505,True,5,142
4990,9736446,9739590,True,3,3144
4991,9736837,9741233,False,1,4396
4992,9736912,9738993,True,1,2081
4993,9736912,9767204,True,1,30292
4994,9736912,9768211,True,1,31299
4995,9736923,9741233,False,2,4310
4996,9736923,9741233,True,4,4310
4997,9743400,9743486,True,4,86
4998,9747379,9749073,True,1,1694
4999,9766894,9767496,True,1,602
5000,9772004,9772130,True,1,126
5001,9780585,9782170,True,1,1585
5002,9782033,9787129,True,1,5096
5003,9783273,9783496,True,4,223
5004,9795059,9799543,True,1,4484
5005,9796122,9800789,True,1,4667
5006,9802693,9804385,True,1,1692
5007,9805243,9810065,True,1,4822
5008,9805395,9805648,True,1,253
5009,9819176,9820395,True,1,1219
5010,9819176,9851427,False,1,32251
5011,9820449,9821077,False,1,628
5012,9821615,9839797,True,1,18182
5013,9826462,9864537,False,1,38075
5014,9827988,9832019,False,1,4031
5015,9842285,9878243,True,1,35958
5016,9849630,9890384,True,2,40754
5017,9855384,9857200,False,1,1816
5018,9864089,9878946,False,1,14857
5019,9868555,9869641,True,1,1086
5020,9869815,9885336,True,1,15521
5021,9872360,9872450,True,3,90
5022,9872360,9872668,True,1,308
5023,9878876,9880716,False,1,1840
5024,9880533,9882137,False,1,1604
5025,9880533,9882137,True,1,1604
5026,9892849,9894977,True,1,2128
5027,9892849,9895129,True,2,2280
5028,9938364,9985389,True,2,47025
5029,9963623,9976543,True,1,12920
5030,9970258,10007046,True,1,36788
5031,9970874,9971182,True,1,308
5032,9990789,9991462,True,2,673
5033,10008242,10025662,False,1,17420
5034,10011173,10013557,True,3,2384
5035,10016763,10017589,True,1,826
5036,10018639,10021057,True,1,2418
5037,10018858,10021249,True,1,2391
5038,10018963,10020299,True,1,1336
5039,10025383,10026589,True,1,1206
5040,10025383,10027313,True,1,1930
5041,10027407,10029545,False,4,2138
5042,10032617,10049142,True,1,16525
5043,10033274,10034874,True,1,1600
5044,10038710,10039076,True,1,366
5045,10039767,10041225,True,1,1458
5046,10042579,10042741,True,2,162
5047,10046705,10047840,True,1,1135
5048,10060634,10072943,True,1,12309
5049,10060634,10073025,False,1,12391
5050,10062197,10063988,True,3,1791
5051,10064326,10065338,True,1,1012
5052,10065070,10065346,True,2,276
5053,10069121,10073252,False,2,4131
5054,10084754,10084842,True,1,88
5055,10099123,10135960,True,1,36837
5056,10107168,10195156,True,2,87988
5057,10141698,10148004,True,1,6306
5058,10150530,10151978,False,1,1448
5059,10150530,10151978,True,2,1448
5060,10162060,10167315,True,4,5255
5061,10162913,10164368,True,1,1455
5062,10167764,10175796,False,1,8032
5063,10167764,10175796,True,1,8032
5064,10170401,10177871,True,1,7470
5065,10171040,10171335,True,1,295
5066,10171040,10173113,True,1,2073
5067,10171579,10173214,True,1,1635
5068,10182044,10229557,True,1,47513
5069,10188601,10191999,True,1,3398
5070,10188959,10191999,True,1,3040
5071,10190836,10208421,False,1,17585
5072,10190836,10212721,True,1,21885
5073,10191606,10191691,True,2,85
5074,10193969,10194230,True,1,261
5075,10198203,10198913,True,1,710
5076,10215201,10216200,True,1,999
5077,10215201,10261573,True,1,46372
5078,10215201,10266867,True,1,51666
5079,10218377,10253022,True,1,34645
5080,10218377,10325501,True,1,107124
5081,10218377,10369531,False,1,151154
5082,10223521,10223681,True,1,160
5083,10226465,10230433,True,2,3968
5084,10234437,10234524,True,1,87
5085,10240141,10258572,True,1,18431
5086,10243867,10244759,True,1,892
5087,10244063,10244799,True,1,736
5088,10265393,10265967,False,1,574
5089,10270033,10273406,True,2,3373
5090,10273287,10275167,True,2,1880
5091,10281094,10281217,True,3,123
5092,10285521,10286245,False,1,724
5093,10289425,10340706,True,1,51281
5094,10314138,10316208,True,1,2070
5095,10317620,10332483,True,1,14863
5096,10319064,10322493,True,1,3429
5097,10322794,10327399,True,3,4605
5098,10328127,10349174,True,1,21047
5099,10328202,10376115,True,3,47913
5100,10371372,10397544,True,5,26172
5101,10371372,10420799,True,2,49427
5102,10374047,10403682,True,1,29635
5103,10394606,10396488,False,1,1882
5104,10412371,10413449,True,5,1078
5105,10458699,10459194,True,1,495
5106,10459357,10466250,True,1,6893
5107,10459958,10462581,True,3,2623
5108,10459958,10469039,True,2,9081
5109,10460176,10466925,True,1,6749
5110,10463137,10465070,True,1,1933
5111,10466383,10468710,False,1,2327
5112,10470425,10474388,False,1,3963
5113,10477146,10478282,False,1,1136
5114,10477146,10479794,False,1,2648
5115,10477711,10480939,True,1,3228
5116,10482242,10482684,False,1,442
5117,10493651,10494500,True,1,849
5118,10508234,10510091,True,2,1857
5119,10508380,10509277,True,1,897
5120,10522867,10630057,True,1,107190
5121,10523476,10630364,True,1,106888
5122,10526661,10527518,True,1,857
5123,10529646,10553721,False,1,24075
5124,10539218,10540097,True,1,879
5125,10539218,10545021,True,1,5803
5126,10546411,10546525,True,1,114
5127,10549055,10549940,True,1,885
5128,10551265,10551386,False,1,121
5129,10566067,10577241,True,3,11174
5130,10578934,10579371,True,2,437
5131,10579406,10580261,True,2,855
5132,10579921,10807030,True,1,227109
5133,10581220,10582258,True,4,1038
5134,10581914,10582021,True,1,107
5135,10584116,10586715,True,1,2599
5136,10600309,10603959,True,1,3650
5137,10600309,10604233,True,1,3924
5138,10645273,10649995,False,1,4722
5139,10645273,10649995,True,1,4722
5140,10645273,10649998,True,2,4725
5141,10646571,10647574,False,2,1003
5142,10646571,10647574,True,8,1003
5143,10670528,10674465,True,1,3937
5144,10672582,10672709,True,1,127
5145,10692064,10696358,True,4,4294
5146,10694365,10694926,True,1,561
5147,10694702,10696265,False,1,1563
5148,10716326,10719042,True,2,2716
5149,10724704,10729113,False,1,4409
5150,10728602,10730744,True,1,2142
5151,10755721,10760984,True,1,5263
5152,10779433,10781207,True,1,1774
5153,10779433,10781834,True,1,2401
5154,10779697,10781207,True,1,1510
5155,10779697,10781834,True,1,2137
5156,10780577,10781726,True,1,1149
5157,10782644,10787464,True,1,4820
5158,10785864,10787061,True,8,1197
5159,10785864,10787451,True,1,1587
5160,10806016,10806095,True,1,79
5161,10809910,10825782,True,1,15872
5162,10814168,10822651,True,1,8483
5163,10825886,10827035,False,2,1149
5164,10835830,10836228,True,5,398
5165,10845897,10859314,True,1,13417
5166,10856269,10857416,True,1,1147
5167,10856775,10861777,True,1,5002
5168,10859361,10863171,True,1,3810
5169,10866593,10867014,True,1,421
5170,10868021,10871933,True,1,3912
5171,10871484,10872348,True,2,864
5172,10901098,10906600,False,1,5502
5173,10901098,10906600,True,3,5502
5174,10903980,10906119,True,1,2139
5175,10909296,10923129,True,1,13833
5176,10911521,10924367,True,1,12846
5177,10961726,10964159,True,1,2433
5178,10977334,10982304,True,2,4970
5179,11021347,11033075,True,3,11728
5180,11036989,11046287,True,1,9298
5181,11045133,11057275,True,2,12142
5182,11053575,11063668,True,2,10093
5183,11054105,11054823,True,1,718
5184,11058651,11059668,True,1,1017
5185,11059353,11059631,True,1,278
5186,11082787,11144637,True,1,61850
5187,11107313,11114598,False,1,7285
5188,11118367,11122769,False,1,4402
5189,11119587,11120268,True,1,681
5190,11128987,11131128,True,3,2141
5191,11134300,11134411,True,3,111
5192,11174419,11174719,True,1,300
5193,11224464,11225360,False,1,896
5194,11224464,11225360,True,1,896
5195,11234741,11241804,True,2,7063
5196,11234741,11242166,True,1,7425
5197,11236008,11242338,True,2,6330
5198,11236008,11242700,True,1,6692
5199,11236008,11243626,True,1,7618
5200,11236008,11244429,True,1,8421
5201,11244082,11244996,False,1,914
5202,11246450,11249459,True,8,3009
5203,11253363,11256166,True,1,2803
5204,11258571,11285699,True,3,27128
5205,11265834,11275321,True,1,9487
5206,11282426,11294656,True,1,12230
5207,11285546,11285627,True,1,81
5208,11292496,11299689,True,1,7193
5209,11307468,11308516,True,1,1048
5210,11322481,11323356,True,5,875
5211,11344550,11346538,True,1,1988
5212,11351900,11416052,False,1,64152
5213,11357091,11357786,True,1,695
5214,11362057,11364806,True,1,2749
5215,11362057,11365603,False,1,3546
5216,11362057,11365603,True,7,3546
5217,11362057,11365749,True,3,3692
5218,11363612,11364550,False,2,938
5219,11363612,11364550,True,2,938
5220,11369827,11371308,True,1,1481
5221,11371049,11371308,False,1,259
5222,11371049,11371308,True,1,259
5223,11371336,11371633,True,1,297
5224,11380609,11380786,True,1,177
5225,11380956,11381673,True,1,717
5226,11384063,11385151,True,6,1088
5227,11384184,11417586,False,1,33402
5228,11398993,11399631,True,1,638
5229,11399097,11399735,True,1,638
5230,11404258,11408301,False,1,4043
5231,11421945,11428211,True,4,6266
5232,11426204,11433896,False,1,7692
5233,11426204,11433896,True,1,7692
5234,11426847,11433024,True,1,6177
5235,11441506,11445504,True,1,3998
5236,11441506,11447964,True,1,6458
5237,11453938,11481584,True,1,27646
5238,11458905,11459207,True,2,302
5239,11462167,11484548,True,1,22381
5240,11469446,11486056,False,1,16610
5241,11497780,11511112,False,1,13332
5242,11545689,11561526,True,1,15837
5243,11567034,11567356,True,1,322
5244,11570438,11570544,True,2,106
5245,11571879,11571999,False,2,120
5246,11571879,11571999,True,2,120
5247,11576221,11576400,False,1,179
5248,11615300,11615387,True,3,87
5249,11619789,11629198,True,6,9409
5250,11625771,11636630,True,1,10859
5251,11634415,11636770,False,1,2355
5252,11646068,11649709,True,3,3641
5253,11648162,11651575,True,1,3413
5254,11663226,11663506,True,1,280
5255,11663226,11665595,True,1,2369
5256,11663226,11669322,True,2,6096
5257,11687760,11689333,True,3,1573
5258,11687760,11694297,True,1,6537
5259,11695256,11699990,False,1,4734
5260,11725947,11733600,False,2,7653
5261,11725947,11735946,False,1,9999
5262,11733584,11736310,True,2,2726
5263,11781844,11783356,True,1,1512
5264,11784301,11788943,True,2,4642
5265,11784587,11787748,True,1,3161
5266,11789545,11791142,False,1,1597
5267,11789545,11791142,True,1,1597
5268,11799231,11857943,False,1,58712
5269,11808342,11823746,True,1,15404
5270,11808342,11828655,True,1,20313
5271,11809943,11813684,True,1,3741
5272,11828512,11828586,True,2,74
5273,11833815,11833954,True,7,139
5274,11837857,11840182,True,2,2325
5275,11840299,11842308,True,1,2009
5276,11840299,11845016,True,1,4717
5277,11841009,11842550,True,1,1541
5278,11842316,11843663,True,2,1347
5279,11845930,11846701,True,1,771
5280,11846334,11846817,True,1,483
5281,11846505,11847276,False,1,771
5282,11849388,11849958,True,1,570
5283,11862966,11863952,True,3,986
5284,11863020,11863952,True,2,932
5285,11863238,11876515,True,1,13277
5286,11864474,11865145,True,1,671
5287,11864474,11877146,True,1,12672
5288,11872151,11872457,False,1,306
5289,11872609,11875222,True,1,2613
5290,11872822,11873365,True,1,543
5291,11874510,11877324,False,1,2814
5292,11874510,11877324,True,1,2814
5293,11876890,11878253,True,1,1363
5294,11893586,11893898,False,1,312
5295,11905189,11909867,True,1,4678
5296,11911090,11914795,True,3,3705
5297,11931955,11933601,True,3,1646
5298,11935687,11942311,True,1,6624
5299,11944963,11956125,True,1,11162
5300,11945056,11963733,True,1,18677
5301,11947905,11957622,True,1,9717
5302,11948918,11958116,True,1,9198
5303,11956938,11990542,False,1,33604
5304,11966057,11967647,True,1,1590
5305,11968095,11977329,True,1,9234
5306,11973936,11977157,False,1,3221
5307,11973936,11977157,True,1,3221
5308,11975953,11978316,True,1,2363
5309,11988135,11988784,True,2,649
5310,11989502,11992673,True,6,3171
5311,11997669,12000816,False,1,3147
5312,11997669,12000816,True,1,3147
5313,12025374,12026429,True,1,1055
5314,12025374,12026488,True,1,1114
5315,12026042,12030086,True,6,4044
5316,12034649,12044020,True,1,9371
5317,12044083,12046378,True,1,2295
5318,12055930,12059366,True,3,3436
5319,12062479,12063639,True,1,1160
5320,12080242,12082043,True,1,1801
5321,12098010,12103656,True,1,5646
5322,12105205,12152932,True,1,47727
5323,12107515,12112670,True,2,5155
5324,12111356,12111954,True,1,598
5325,12111356,12113903,True,3,2547
5326,12113484,12115572,True,3,2088
5327,12116408,12116989,True,2,581
5328,12122852,12127595,True,1,4743
5329,12126309,12128234,True,2,1925
5330,12127000,12127593,True,1,593
5331,12136495,12137575,True,1,1080
5332,12139124,12436125,True,3,297001
5333,12139124,12773733,True,1,634609
5334,12139605,12436697,True,1,297092
5335,12142228,12143474,True,1,1246
5336,12145871,12181534,False,1,35663
5337,12153655,12154144,True,1,489
5338,12161372,12163084,True,1,1712
5339,12172577,12186647,True,3,14070
5340,12189201,12194922,True,1,5721
5341,12212223,12217549,True,1,5326
5342,12212223,12238793,True,1,26570
5343,12221281,12221820,False,1,539
5344,12229058,12229658,True,2,600
5345,12244313,12244537,False,1,224
5346,12262104,12269957,True,1,7853
5347,12263242,12270317,True,1,7075
5348,12271324,12271483,True,1,159
5349,12271554,12277201,True,1,5647
5350,12271613,12277206,True,1,5593
5351,12271629,12277231,True,3,5602
5352,12289212,12295303,True,4,6091
5353,12290315,12296354,True,1,6039
5354,12291728,12297897,True,1,6169
5355,12301760,12305707,True,1,3947
5356,12312995,12331895,True,1,18900
5357,12313399,12313539,False,1,140
5358,12327333,12328138,False,1,805
5359,12327333,12328138,True,2,805
5360,12362461,12362716,False,1,255
5361,12373818,12442426,False,1,68608
5362,12373818,12442426,True,1,68608
5363,12376737,12443862,True,1,67125
5364,12381802,12389227,False,1,7425
5365,12405125,12431110,False,1,25985
5366,12405125,12431110,True,1,25985
5367,12406058,12406313,True,2,255
5368,12409198,12423986,True,1,14788
5369,12423572,12423737,True,1,165
5370,12431637,12457467,True,3,25830
5371,12453714,12457875,True,1,4161
5372,12465660,12468202,True,2,2542
5373,12477179,12477627,True,1,448
5374,12483468,12492155,True,1,8687
5375,12490138,12500423,True,2,10285
5376,12491955,12498067,True,1,6112
5377,12491955,12498084,True,1,6129
5378,12512081,12516606,True,1,4525
5379,12512362,12516735,True,1,4373
5380,12513617,12515396,False,1,1779
5381,12517157,12520580,False,1,3423
5382,12520819,12520933,True,1,114
5383,12523717,12524301,False,1,584
5384,12528322,12530910,True,3,2588
5385,12532287,12532578,False,1,291
5386,12532287,12534264,False,2,1977
5387,12532287,12540967,False,1,8680
5388,12532550,12532782,True,2,232
5389,12537762,12537850,True,1,88
5390,12538025,12538412,False,1,387
5391,12543317,12550752,True,1,7435
5392,12543317,12550756,True,1,7439
5393,12549248,12550470,False,1,1222
5394,12562212,12566605,True,1,4393
5395,12562212,12571800,True,3,9588
5396,12566574,12573212,True,2,6638
5397,12581071,12583135,True,1,2064
5398,12584053,12584244,False,1,191
5399,12595778,12596149,False,1,371
5400,12608552,12608660,True,1,108
5401,12613402,12613671,True,1,269
5402,12617468,12617903,True,1,435
5403,12619212,12644071,True,3,24859
5404,12623150,12626486,False,1,3336
5405,12623382,12647814,True,1,24432
5406,12635053,12635993,False,2,940
5407,12639419,12688156,False,1,48737
5408,12643913,12645730,False,1,1817
5409,12647624,12653291,True,5,5667
5410,12649086,12665491,False,1,16405
5411,12649086,12665491,True,4,16405
5412,12656208,12656991,True,6,783
5413,12657310,12658528,True,1,1218
5414,12657310,12659322,True,1,2012
5415,12658716,12658839,True,2,123
5416,12670746,12684859,True,1,14113
5417,12678332,12679923,False,1,1591
5418,12680969,12681496,True,1,527
5419,12694350,12695539,False,1,1189
5420,12695542,12696128,True,2,586
5421,12713545,12715494,True,3,1949
5422,12717956,12723625,True,3,5669
5423,12723245,12723340,True,1,95
5424,12723417,12727409,False,1,3992
5425,12731693,12736307,True,1,4614
5426,12739905,12757241,True,1,17336
5427,12744752,12746473,True,1,1721
5428,12745478,12746655,True,1,1177
5429,12750931,12751015,True,1,84
5430,12760075,12760161,True,3,86
5431,12792913,12808085,True,1,15172
5432,12823789,12824255,False,3,466
5433,12823789,12824255,True,2,466
5434,12823789,12824258,True,1,469
5435,12826793,12834060,False,1,7267
5436,12826793,12834060,True,1,7267
5437,12827249,12828268,True,1,1019
5438,12828526,12829613,True,1,1087
5439,12828526,12840966,True,2,12440
5440,12832863,12833368,True,1,505
5441,12833285,12833368,True,8,83
5442,12834199,12834335,True,1,136
5443,12839282,12840924,True,1,1642
5444,12839917,12841226,True,1,1309
5445,12840358,12841421,True,1,1063
5446,12844168,12844609,True,1,441
5447,12844962,12845105,True,1,143
5448,12845199,12845591,True,2,392
5449,12846750,12847115,True,2,365
5450,12852619,12853159,False,1,540
5451,12852619,12853159,True,1,540
5452,12868086,12894484,True,1,26398
5453,12872906,12874887,False,1,1981
5454,12872906,12875164,False,1,2258
5455,12872906,12880591,False,1,7685
5456,12872910,12880591,False,1,7681
5457,12876710,12876864,True,5,154
5458,12881564,12882638,True,1,1074
5459,12882244,12884234,True,2,1990
5460,12898095,12940064,True,1,41969
5461,12898412,12898505,False,1,93
5462,12898412,12898505,True,8,93
5463,12903480,12903660,True,1,180
5464,12903508,12903567,True,1,59
5465,12903902,12904093,True,1,191
5466,12904967,12905136,False,1,169
5467,12904967,12905136,True,1,169
5468,12905261,12908484,False,1,3223
5469,12913427,12913899,True,4,472
5470,12922354,12922533,True,1,179
5471,12928011,12928404,True,1,393
5472,12928620,12928876,True,2,256
5473,12935346,12935460,True,4,114
5474,12939428,12941874,True,5,2446
5475,12940252,12940376,True,4,124
5476,12941211,12942314,True,1,1103
5477,12945839,12952162,True,1,6323
5478,12954506,12954592,True,1,86
5479,12955785,12956050,True,1,265
5480,12964828,12974741,True,4,9913
5481,12969293,12978285,True,1,8992
5482,12970156,12973131,True,1,2975
5483,12973745,12979121,False,1,5376
5484,12986818,12986950,True,2,132
5485,12990561,12995625,True,1,5064
5486,12994410,12994858,True,4,448
5487,13001667,13001920,True,1,253
5488,13003517,13006411,True,1,2894
5489,13003517,13009936,True,1,6419
5490,13005461,13005661,True,1,200
5491,13005461,13005949,False,1,488
5492,13016279,13016801,True,1,522
5493,13023023,13025050,True,1,2027
5494,13037086,13037338,True,2,252
5495,13043035,13043265,False,3,230
5496,13043035,13043265,True,7,230
5497,13048683,13048780,True,1,97
5498,13053783,13054034,True,12,251
5499,13059755,13059832,True,1,77
5500,13062323,13063804,True,1,1481
5501,13064524,13291419,False,1,226895
5502,13065623,13067169,True,1,1546
5503,13067018,13238075,True,1,171057
5504,13067708,13238395,True,1,170687
5505,13073884,13074101,True,1,217
5506,13088768,13089292,True,1,524
5507,13094611,13099932,True,1,5321
5508,13094611,13100306,False,1,5695
5509,13097008,13100876,False,2,3868
5510,13108447,13108638,True,1,191
5511,13110603,13110604,True,1,1
5512,13114103,13114591,False,2,488
5513,13122139,13122216,True,1,77
5514,13122406,13126442,True,1,4036
5515,13122654,13123407,True,1,753
5516,13123181,13123627,False,1,446
5517,13132285,13148266,True,1,15981
5518,13132285,13178447,True,1,46162
5519,13143411,13145457,True,1,2046
5520,13145055,13145457,True,1,402
5521,13145510,13146409,True,1,899
5522,13153976,13155204,True,3,1228
5523,13157439,13157625,True,1,186
5524,13160467,13160540,False,1,73
5525,13160467,13160540,True,1,73
5526,13164665,13164817,False,1,152
5527,13166623,13169297,True,1,2674
5528,13167323,13169294,False,1,1971
5529,13167469,13168160,False,1,691
5530,13167469,13168160,True,1,691
5531,13170276,13170483,True,1,207
5532,13171596,13172485,True,1,889
5533,13172265,13175961,True,1,3696
5534,13174953,13175145,True,1,192
5535,13175093,13175285,True,1,192
5536,13177695,13178884,True,3,1189
5537,13177695,13182134,True,1,4439
5538,13178036,13214090,True,1,36054
5539,13178757,13178967,True,1,210
5540,13197986,13203047,True,1,5061
5541,13199696,13201923,True,4,2227
5542,13202948,13203341,True,1,393
5543,13206617,13207537,True,3,920
5544,13230961,13246304,True,2,15343
5545,13234193,13234283,True,1,90
5546,13234193,13235194,True,1,1001
5547,13234193,13235259,True,1,1066
5548,13234415,13235259,True,1,844
5549,13242638,13242857,True,1,219
5550,13245275,13246484,False,1,1209
5551,13245275,13248022,False,1,2747
5552,13250015,13250371,True,2,356
5553,13250015,13250417,True,2,402
5554,13250796,13254480,True,1,3684
5555,13260020,13261189,True,1,1169
5556,13260020,13261246,True,1,1226
5557,13262243,13265657,True,1,3414
5558,13264289,13264465,True,1,176
5559,13267481,13278418,False,1,10937
5560,13267481,13285452,True,1,17971
5561,13267481,13289688,True,1,22207
5562,13269913,13270091,True,2,178
5563,13276879,13277075,True,1,196
5564,13280164,13280654,True,1,490
5565,13280198,13280667,True,1,469
5566,13280258,13280661,True,1,403
5567,13284252,13284370,True,1,118
5568,13284703,13284774,True,1,71
5569,13284802,13285272,True,1,470
5570,13287319,13287558,True,1,239
5571,13288178,13288516,True,1,338
5572,13289043,13290066,True,1,1023
5573,13292208,13292624,True,1,416
5574,13295326,13295663,False,1,337
5575,13297880,13298802,False,1,922
5576,13297880,13298802,True,6,922
5577,13298443,13299369,True,1,926
5578,13299757,13304622,False,1,4865
5579,13304501,13306326,True,2,1825
5580,13306395,13309883,True,1,3488
5581,13311343,13312345,True,1,1002
5582,13317763,13318101,True,1,338
5583,13318584,13320561,True,6,1977
5584,13328508,13330269,True,2,1761
5585,13332843,13333215,True,1,372
5586,13332843,13335297,True,4,2454
5587,13335900,13339366,True,2,3466
5588,13345716,13345834,True,1,118
5589,13347920,13350570,True,1,2650
5590,13352253,13352538,False,1,285
5591,13352281,13352635,False,1,354
5592,13355879,13356006,True,1,127
5593,13359106,13359280,True,3,174
5594,13359142,13362657,True,1,3515
5595,13369938,13370132,True,1,194
5596,13370561,13373766,True,2,3205
5597,13375674,13379595,True,1,3921
5598,13380373,13388191,False,1,7818
5599,13386214,13386561,True,1,347
5600,13389987,13390402,True,3,415
5601,13391362,13394183,True,1,2821
5602,13405248,13405591,True,1,343
5603,13406852,13407363,True,2,511
5604,13407278,13408277,False,1,999
5605,13419798,13420384,True,1,586
5606,13429529,13452338,True,2,22809
5607,13433110,13434365,False,2,1255
5608,13441859,13513832,True,1,71973
5609,13450651,13454345,False,1,3694
5610,13456444,13463413,True,1,6969
5611,13458630,13468749,True,1,10119
5612,13458630,13473071,True,1,14441
5613,13458630,13476118,True,1,17488
5614,13460181,13460294,True,1,113
5615,13460319,13460920,True,2,601
5616,13460397,13461349,True,1,952
5617,13460397,13465031,True,1,4634
5618,13468077,13470034,True,1,1957
5619,13472580,13472848,True,1,268
5620,13479502,13480725,False,1,1223
5621,13479502,13480725,True,3,1223
5622,13480637,13505102,True,1,24465
5623,13492640,13494675,True,1,2035
5624,13494811,13495080,False,1,269
5625,13494811,13495359,True,2,548
5626,13498266,13499509,True,1,1243
5627,13499625,13500135,False,1,510
5628,13504936,13505637,True,2,701
5629,13514273,13514425,False,2,152
5630,13515843,13550610,False,1,34767
5631,13515843,13550610,True,5,34767
5632,13520103,13520191,False,2,88
5633,13520103,13520191,True,6,88
5634,13539377,13540971,True,1,1594
5635,13545700,13593389,True,3,47689
5636,13549955,13551640,False,1,1685
5637,13552923,13553837,True,3,914
5638,13557749,13558853,True,4,1104
5639,13564664,13565578,True,1,914
5640,13564987,13568712,True,1,3725
5641,13568380,13604839,True,1,36459
5642,13569026,13590706,True,1,21680
5643,13569026,13610368,True,1,41342
5644,13580161,13613251,True,1,33090
5645,13587007,13587592,True,1,585
5646,13587544,13590725,True,2,3181
5647,13594335,13594735,False,1,400
5648,13601959,13604501,True,1,2542
5649,13607179,13607550,True,2,371
5650,13607773,13608563,True,1,790
5651,13608139,13609340,False,1,1201
5652,13616607,13617195,False,1,588
5653,13633733,13634320,False,1,587
5654,13643408,13644823,False,1,1415
5655,13647823,13925865,True,1,278042
5656,13651431,13652112,False,1,681
5657,13666494,13666927,True,1,433
5658,13666497,13666957,True,1,460
5659,13666660,13667022,True,1,362
5660,13667432,13670538,True,1,3106
5661,13668969,13671625,True,2,2656
5662,13670571,13671150,True,1,579
5663,13677475,13679142,True,2,1667
5664,13689644,13690319,False,1,675
5665,13691018,13725622,True,3,34604
5666,13691018,13730533,False,1,39515
5667,13701664,13701820,True,1,156
5668,13708805,13709384,True,1,579
5669,13714870,13715091,True,2,221
5670,13716083,13716947,True,1,864
5671,13726531,13726621,True,1,90
5672,13727850,13728525,False,1,675
5673,13739093,13740078,False,1,985
5674,13747011,13747586,True,1,575
5675,13751456,13754307,True,1,2851
5676,13756561,13756985,False,1,424
5677,13763745,13764025,True,2,280
5678,13764185,13764541,True,1,356
5679,13772372,13772959,False,1,587
5680,13775209,13778049,True,5,2840
5681,13777300,13801554,False,1,24254
5682,13797465,13804010,False,1,6545
5683,13797465,13807873,True,2,10408
5684,13797465,13821943,False,1,24478
5685,13797465,13821943,True,4,24478
5686,13798954,13799526,True,1,572
5687,13806395,14090938,False,4,284543
5688,13806395,14090938,True,3,284543
5689,13810389,13817563,True,1,7174
5690,13822402,13836268,True,1,13866
5691,13823172,13836592,True,1,13420
5692,13825893,13826874,True,1,981
5693,13825973,13826080,True,1,107
5694,13831811,13832718,True,1,907
5695,13831815,13832371,False,1,556
5696,13831815,13832718,True,1,903
5697,13835660,13835842,True,2,182
5698,13838469,13839522,False,1,1053
5699,13840425,13844756,False,1,4331
5700,13846848,13847142,True,1,294
5701,13851171,13906423,True,1,55252
5702,13851189,13851541,False,1,352
5703,13852786,13853345,True,1,559
5704,13852887,13853398,True,1,511
5705,13853059,13853593,True,1,534
5706,13862028,13863594,True,3,1566
5707,13862028,13865609,True,1,3581
5708,13867539,13868306,True,1,767
5709,13875593,13875594,True,1,1
5710,13877362,13877702,True,1,340
5711,13879293,13879437,True,1,144
5712,13883980,13884919,True,4,939
5713,13890175,13890261,True,1,86
5714,13895569,13896544,True,3,975
5715,13898958,13899405,True,1,447
5716,13899314,13899537,True,1,223
5717,13900229,13900452,True,1,223
5718,13905839,13907123,True,1,1284
5719,13907227,13916124,True,1,8897
5720,13909553,13909909,False,1,356
5721,13910029,13912689,True,1,2660
5722,13916333,13916456,True,1,123
5723,13922738,13925847,True,2,3109
5724,13927476,13934798,False,1,7322
5725,13935473,13962219,True,3,26746
5726,13935473,13990619,True,1,55146
5727,13951490,13970885,True,1,19395
5728,13953428,13954609,True,1,1181
5729,13954950,13955303,True,1,353
5730,13956396,13956532,True,2,136
5731,13957317,13957415,True,1,98
5732,13960582,13961499,True,2,917
5733,13961492,13970701,False,1,9209
5734,13961492,13981996,True,1,20504
5735,13965734,13974147,False,1,8413
5736,13977964,13984797,True,1,6833
5737,13978543,13980018,True,1,1475
5738,13982594,13992093,True,1,9499
5739,13983394,13992893,False,1,9499
5740,14001740,14003681,True,1,1941
5741,14005772,14009363,True,1,3591
5742,14009699,14010047,True,5,348
5743,14020566,14054042,False,1,33476
5744,14022313,14022866,False,1,553
5745,14022313,14022866,True,1,553
5746,14027963,14028643,True,3,680
5747,14027963,14029467,False,1,1504
5748,14028135,14028643,True,1,508
5749,14029671,14029755,True,1,84
5750,14036072,14041295,True,1,5223
5751,14043334,14044486,True,3,1152
5752,14047436,14048593,True,1,1157
5753,14047436,14048596,True,2,1160
5754,14049451,14049949,True,1,498
5755,14061260,14062915,True,1,1655
5756,14067325,14076626,True,1,9301
5757,14068060,14069176,False,1,1116
5758,14075026,14080480,True,1,5454
5759,14076207,14077863,True,1,1656
5760,14083700,14101494,True,1,17794
5761,14086193,14086339,True,1,146
5762,14090615,14101051,True,1,10436
5763,14090731,14100942,True,1,10211
5764,14098779,14100400,True,1,1621
5765,14104547,14104843,True,1,296
5766,14106201,14106728,False,1,527
5767,14106538,14106839,True,1,301
5768,14111641,14116509,True,1,4868
5769,14111641,14116883,True,1,5242
5770,14113129,14114785,True,1,1656
5771,14115275,14138599,True,1,23324
5772,14121116,14121203,True,3,87
5773,14124714,14125889,True,1,1175
5774,14126448,14128041,True,1,1593
5775,14130935,14174211,False,1,43276
5776,14132171,14143986,False,1,11815
5777,14132171,14174966,False,1,42795
5778,14139242,14140041,True,1,799
5779,14139254,14140041,True,2,787
5780,14146548,14154264,False,1,7716
5781,14149389,14149586,True,2,197
5782,14149389,14150099,True,2,710
5783,14153902,14154028,True,2,126
5784,14154022,14154410,True,1,388
5785,14154262,14154331,True,1,69
5786,14160155,14160156,True,1,1
5787,14160196,14163442,False,2,3246
5788,14171399,14171640,True,2,241
5789,14173666,14174260,False,1,594
5790,14173666,14174260,True,1,594
5791,14187342,14187793,False,1,451
5792,14187342,14187793,True,4,451
5793,14192720,14201574,True,1,8854
5794,14200331,14204143,False,1,3812
5795,14212402,14212546,True,1,144
5796,14215830,14284715,True,1,68885
5797,14216378,14284971,True,4,68593
5798,14217799,14285750,True,1,67951
5799,14229686,14231723,True,2,2037
5800,14239154,14243901,False,1,4747
5801,14240935,14241476,True,1,541
5802,14246514,14246588,True,3,74
5803,14246665,14246930,True,1,265
5804,14258292,14258398,True,2,106
5805,14265046,14265148,True,1,102
5806,14266079,14266207,True,1,128
5807,14275198,14308706,True,1,33508
5808,14277505,14277593,True,3,88
5809,14284531,14313988,False,1,29457
5810,14287599,14294695,False,1,7096
5811,14287975,14288396,True,1,421
5812,14289408,14289547,True,1,139
5813,14294469,14294773,True,2,304
5814,14304932,14315035,True,1,10103
5815,14310772,14311114,True,1,342
5816,14311206,14311293,True,2,87
5817,14311465,14311637,True,2,172
5818,14311659,14311831,True,1,172
5819,14318825,14340421,False,1,21596
5820,14327076,14327180,True,2,104
5821,14327076,14327359,True,1,283
5822,14336160,14337033,True,2,873
5823,14336160,14337120,True,1,960
5824,14338363,14338919,False,1,556
5825,14340792,14347633,True,1,6841
5826,14364417,14369767,True,2,5350
5827,14370339,14371615,False,1,1276
5828,14370339,14371615,True,1,1276
5829,14371196,14372010,True,1,814
5830,14376119,14376848,True,1,729
5831,14383532,14383636,True,1,104
5832,14389226,14592386,True,1,203160
5833,14406457,14413473,True,3,7016
5834,14420751,14423249,True,1,2498
5835,14421372,14423576,True,1,2204
5836,14421926,14423787,True,1,1861
5837,14422719,14424219,True,1,1500
5838,14423587,14424625,True,1,1038
5839,14431579,14432636,True,1,1057
5840,14432135,14432323,False,1,188
5841,14432135,14432323,True,3,188
5842,14438596,14439472,True,2,876
5843,14444696,14496177,True,2,51481
5844,14449984,14450060,True,1,76
5845,14479953,14480476,True,1,523
5846,14482532,14482638,True,3,106
5847,14496904,14499425,True,2,2521
5848,14508885,14515047,True,1,6162
5849,14517188,14517399,True,3,211
5850,14520155,14584276,False,1,64121
5851,14521980,14522170,False,1,190
5852,14522709,14524058,False,1,1349
5853,14545003,14546674,True,1,1671
5854,14546742,14597448,False,1,50706
5855,14546742,14597448,True,1,50706
5856,14548058,14551772,True,1,3714
5857,14548103,14551817,True,1,3714
5858,14553049,14553502,True,1,453
5859,14566274,14568584,True,1,2310
5860,14568725,14570445,False,1,1720
5861,14568725,14570445,True,2,1720
5862,14570723,14571148,True,1,425
5863,14571451,14576910,True,1,5459
5864,14573066,14574008,True,1,942
5865,14586806,14586997,False,1,191
5866,14586806,14586997,True,6,191
5867,14599492,14599836,False,1,344
5868,14610846,14613618,True,1,2772
5869,14610846,14625502,True,1,14656
5870,14612820,14612919,True,1,99
5871,14616507,14616729,True,2,222
5872,14616507,14617864,True,1,1357
5873,14616507,14628312,True,1,11805
5874,14618025,14618583,True,1,558
5875,14623532,14626975,True,1,3443
5876,14637842,14639013,True,1,1171
5877,14647525,14647622,True,1,97
5878,14654018,14656966,False,1,2948
5879,14654018,14656966,True,3,2948
5880,14654059,14735752,True,1,81693
5881,14655867,14660360,True,1,4493
5882,14656436,14669379,False,1,12943
5883,14658079,14658244,True,1,165
5884,14658828,14659409,True,1,581
5885,14677776,14677931,True,1,155
5886,14678472,14678579,True,1,107
5887,14680299,14683879,True,1,3580
5888,14680882,14688553,True,1,7671
5889,14683440,14686379,False,1,2939
5890,14683440,14686379,True,1,2939
5891,14683885,14684374,True,1,489
5892,14684627,14685237,True,2,610
5893,14685016,14685396,True,1,380
5894,14685093,14685237,True,1,144
5895,14685820,14687476,True,1,1656
5896,14686077,14686439,True,1,362
5897,14688195,14688828,True,1,633
5898,14690554,14690898,True,1,344
5899,14696909,14696992,True,1,83
5900,14697773,14698226,True,1,453
5901,14699908,14700007,True,1,99
5902,14706892,14719968,True,1,13076
5903,14729893,14731712,True,2,1819
5904,14765839,14950897,True,4,185058
5905,14767343,14781637,True,1,14294
5906,14769558,14770025,True,1,467
5907,14775873,14786955,True,2,11082
5908,14780367,14783391,True,2,3024
5909,14792961,14811026,True,1,18065
5910,14796679,14798262,True,2,1583
5911,14806009,14807051,True,1,1042
5912,14828843,14829507,False,1,664
5913,14895499,14895665,True,1,166
5914,14897381,14897598,False,1,217
5915,14905003,14905163,False,1,160
5916,14905003,14905163,True,2,160
5917,14914055,14916054,True,1,1999
5918,14914820,14916776,True,1,1956
5919,14920131,14965226,True,1,45095
5920,14921817,14930469,False,1,8652
5921,14923300,14923991,True,1,691
5922,14924222,14924547,True,3,325
5923,14924222,14924771,True,1,549
5924,14924222,14924774,True,1,552
5925,14930888,14931689,True,2,801
5926,14935859,14935952,True,1,93
5927,14942126,14942951,True,1,825
5928,14951783,14952317,True,1,534
5929,14951783,14953177,True,1,1394
5930,14965848,14965930,True,1,82
5931,14965848,14966011,True,1,163
5932,14974247,14976012,True,4,1765
5933,14980375,14980528,True,1,153
5934,14983361,14983957,True,2,596
5935,14986973,14987759,True,1,786
5936,14989790,14990117,True,1,327
5937,15009941,15011110,True,1,1169
5938,15013633,15013870,True,1,237
5939,15013834,15015955,True,2,2121
5940,15015282,15017530,True,2,2248
5941,15023982,15027961,True,1,3979
5942,15034810,15051115,True,7,16305
5943,15059487,15059624,False,1,137
5944,15059487,15059624,True,1,137
5945,15062755,15065018,True,6,2263
5946,15067053,15067184,True,7,131
5947,15070347,15105664,True,1,35317
5948,15083894,15084953,True,1,1059
5949,15084077,15084953,True,2,876
5950,15084187,15097818,True,3,13631
5951,15109201,15110943,True,1,1742
5952,15122909,15128371,False,1,5462
5953,15125012,15128134,True,1,3122
5954,15130428,15142593,True,1,12165
5955,15134925,15136623,False,1,1698
5956,15135202,15341458,True,2,206256
5957,15138965,15146254,True,1,7289
5958,15140914,15141250,True,1,336
5959,15144727,15145644,False,1,917
5960,15144727,15145644,True,8,917
5961,15144727,15148570,False,1,3843
5962,15155106,15155673,True,2,567
5963,15155106,15155867,False,1,761
5964,15156139,15156219,True,1,80
5965,15158901,15159009,True,1,108
5966,15162138,15165092,True,1,2954
5967,15175162,15177340,True,3,2178
5968,15178930,15181352,True,1,2422
5969,15181077,15184396,False,1,3319
5970,15181077,15184396,True,1,3319
5971,15181678,15182721,True,1,1043
5972,15183545,15183630,False,1,85
5973,15183545,15183630,True,1,85
5974,15184063,15184206,True,1,143
5975,15184063,15184572,True,1,509
5976,15196664,15212633,True,1,15969
5977,15196866,15212358,False,1,15492
5978,15196866,15212358,True,2,15492
5979,15198162,15198671,True,1,509
5980,15198459,15198761,True,1,302
5981,15199378,15199983,True,1,605
5982,15199423,15199646,True,1,223
5983,15201494,15201663,True,1,169
5984,15205832,15208484,True,1,2652
5985,15206308,15206308,True,2,0
5986,15208205,15208833,True,1,628
5987,15213318,15213851,True,1,533
5988,15214556,15219302,True,1,4746
5989,15217557,15219793,True,1,2236
5990,15221703,15255195,False,1,33492
5991,15227728,15228470,True,1,742
5992,15237020,15237205,True,1,185
5993,15242227,15244115,True,1,1888
5994,15245587,15247849,True,1,2262
5995,15246256,15249982,True,2,3726
5996,15247404,15255865,True,3,8461
5997,15250702,15253393,True,1,2691
5998,15254210,15258484,True,1,4274
5999,15254420,15254877,True,1,457
6000,15304414,15306251,True,1,1837
6001,15308372,15344865,True,1,36493
6002,15321823,15330897,True,2,9074
6003,15338713,15342320,True,1,3607
6004,15346084,15350864,False,1,4780
6005,15353287,15354067,True,1,780
6006,15359183,15360431,True,1,1248
6007,15359727,15359821,True,1,94
6008,15360793,15393279,True,1,32486
6009,15365440,15369018,True,1,3578
6010,15368943,15369041,True,1,98
6011,15373102,15373381,False,1,279
6012,15373102,15374005,True,2,903
6013,15380279,15380568,True,1,289
6014,15388056,15392546,True,1,4490
6015,15389416,15390127,False,1,711
6016,15389416,15390127,True,1,711
6017,15393194,15393777,True,2,583
6018,15404058,15405596,False,1,1538
6019,15404058,15405596,True,3,1538
6020,15410522,15410611,True,1,89
6021,15411030,15411612,True,5,582
6022,15412577,15426041,False,1,13464
6023,15415357,15416141,True,1,784
6024,15419036,15419479,True,1,443
6025,15421501,15421821,True,1,320
6026,15425076,15425576,False,1,500
6027,15454862,15572381,True,1,117519
6028,15464217,15469710,True,1,5493
6029,15467978,15468172,True,1,194
6030,15467978,15468181,True,1,203
6031,15468541,15469314,False,1,773
6032,15477726,15478668,True,1,942
6033,15480422,15532653,True,1,52231
6034,15484003,15484463,True,1,460
6035,15486576,15491451,True,1,4875
6036,15490716,15492304,True,1,1588
6037,15491470,15492832,True,1,1362
6038,15491618,15492832,True,1,1214
6039,15491641,15492832,True,1,1191
6040,15503909,15504000,True,1,91
6041,15504490,15506192,True,1,1702
6042,15507958,15508685,True,3,727
6043,15511702,15529745,False,1,18043
6044,15516985,15517144,True,1,159
6045,15520163,15520333,True,2,170
6046,15522675,15522782,True,1,107
6047,15523059,15523156,True,1,97
6048,15525957,15531008,True,2,5051
6049,15564665,15566761,True,1,2096
6050,15567777,15571665,True,1,3888
6051,15576523,15581102,True,1,4579
6052,15584586,15585148,True,2,562
6053,15588232,15588547,True,2,315
6054,15588486,15588837,False,1,351
6055,15588639,15590859,True,1,2220
6056,15591029,15594775,True,1,3746
6057,15593003,15593392,True,1,389
6058,15595127,15595937,True,1,810
6059,15595127,15595949,True,1,822
6060,15595127,15596035,True,1,908
6061,15603186,15605651,True,1,2465
6062,15604287,15605612,True,2,1325
6063,15609976,15610839,True,1,863
6064,15613006,15613871,True,11,865
6065,15613006,15614705,True,1,1699
6066,15614451,15614587,True,1,136
6067,15620677,15621399,True,1,722
6068,15625614,15631287,False,1,5673
6069,15626727,15626981,True,1,254
6070,15635534,15635634,True,1,100
6071,15651673,15651948,True,2,275
6072,15656232,15656311,True,6,79
6073,15656232,15656314,True,1,82
6074,15656232,15658103,True,2,1871
6075,15656232,15658556,True,1,2324
6076,15660318,15668174,True,4,7856
6077,15660318,15669100,True,1,8782
6078,15662632,15665983,True,1,3351
6079,15662773,15664828,True,1,2055
6080,15667714,15667989,True,4,275
6081,15671293,15671298,True,2,5
6082,15674995,15675236,True,1,241
6083,15681061,15683310,True,1,2249
6084,15685680,15690435,True,1,4755
6085,15688815,15689091,True,1,276
6086,15688967,15689151,True,1,184
6087,15689778,15690212,True,4,434
6088,15696078,15702920,True,1,6842
6089,15704814,15705123,False,2,309
6090,15704883,15705151,False,1,268
6091,15706757,15706943,False,1,186
6092,15718923,15720531,False,2,1608
6093,15718923,15720531,True,2,1608
6094,15721304,15726745,True,1,5441
6095,15727940,15729796,True,1,1856
6096,15728336,15731865,True,1,3529
6097,15732257,15732371,True,1,114
6098,15735661,15736831,True,3,1170
6099,15738518,15740097,False,1,1579
6100,15738518,15740097,True,1,1579
6101,15738544,15740097,False,3,1553
6102,15738544,15740097,True,1,1553
6103,15746168,15748725,False,1,2557
6104,15764346,15765401,True,3,1055
6105,15764981,15766072,True,3,1091
6106,15778018,15778663,True,1,645
6107,15790427,15806540,True,1,16113
6108,15807152,15809892,True,1,2740
6109,15812039,15812342,True,1,303
6110,15815613,15817369,True,2,1756
6111,15822946,15823997,True,1,1051
6112,15832782,15832884,True,1,102
6113,15835794,15840388,True,1,4594
6114,15868034,15868203,True,1,169
6115,15884355,15887538,True,1,3183
6116,15884977,15885059,True,5,82
6117,15893903,15896105,True,1,2202
6118,15906874,15911989,True,1,5115
6119,15906874,15913871,True,1,6997
6120,15906874,15916933,True,1,10059
6121,15924983,15926154,True,1,1171
6122,15933526,15936821,True,6,3295
6123,15935866,15952025,False,1,16159
6124,15935866,15952025,True,8,16159
6125,15937717,15938098,True,1,381
6126,15937717,15939455,False,1,1738
6127,15937717,15943402,True,4,5685
6128,15952221,15952417,True,1,196
6129,15956913,15969150,True,1,12237
6130,15962459,15962536,True,1,77
6131,15964024,15965907,True,1,1883
6132,15965641,15965920,False,1,279
6133,15970627,15971499,True,1,872
6134,15971870,15972172,False,1,302
6135,15979823,15980230,True,1,407
6136,15983793,15984142,True,1,349
6137,15986012,15988982,False,1,2970
6138,15991000,15991486,False,1,486
6139,15999341,16005856,True,3,6515
6140,16001299,16001584,False,1,285
6141,16017707,16021770,True,1,4063
6142,16017707,16022073,True,1,4366
6143,16017811,16051909,True,1,34098
6144,16018674,16019522,True,1,848
6145,16026553,16026641,False,1,88
6146,16029860,16040397,False,2,10537
6147,16029860,16040397,True,3,10537
6148,16043508,16044534,True,2,1026
6149,16043566,16044534,True,1,968
6150,16049247,16049566,True,1,319
6151,16049262,16049566,True,1,304
6152,16051126,16073604,True,1,22478
6153,16052147,16055903,True,1,3756
6154,16062885,16069256,True,1,6371
6155,16066639,16067943,False,1,1304
6156,16081695,16151945,True,1,70250
6157,16088445,16088908,False,1,463
6158,16088445,16088908,True,2,463
6159,16095684,16096647,True,1,963
6160,16105574,16105664,True,1,90
6161,16120754,16121369,True,1,615
6162,16126653,16127253,True,1,600
6163,16127034,16128323,False,1,1289
6164,16127034,16170829,True,1,43795
6165,16146050,16147238,True,1,1188
6166,16146234,16147144,True,1,910
6167,16147335,16164009,True,1,16674
6168,16148930,16149039,True,1,109
6169,16153886,16154132,True,2,246
6170,16153886,16154153,True,1,267
6171,16153886,16155812,False,1,1926
6172,16156234,16156334,True,1,100
6173,16159890,16170044,True,1,10154
6174,16163209,16165202,False,1,1993
6175,16172313,16174454,False,1,2141
6176,16172410,16174454,False,2,2044
6177,16185099,16185622,False,2,523
6178,16185099,16185647,False,1,548
6179,16185953,16186773,False,1,820
6180,16188903,16189289,False,1,386
6181,16190319,16226038,True,1,35719
6182,16193520,16193914,True,2,394
6183,16206003,16214063,True,1,8060
6184,16216410,16216580,False,1,170
6185,16216410,16216580,True,5,170
6186,16226308,16243850,True,4,17542
6187,16235351,16235527,True,2,176
6188,16235889,16238917,True,1,3028
6189,16248774,16249556,False,1,782
6190,16259775,16259957,False,1,182
6191,16259775,16259957,True,1,182
6192,16260280,16275800,True,6,15520
6193,16260280,16287413,True,1,27133
6194,16260280,16318007,True,1,57727
6195,16261430,16267216,True,2,5786
6196,16276374,16276565,True,1,191
6197,16296789,16348376,False,1,51587
6198,16305252,16309770,True,2,4518
6199,16306488,16320315,False,1,13827
6200,16306488,16320315,True,6,13827
6201,16322947,16351618,True,1,28671
6202,16332548,16332662,True,1,114
6203,16338514,16338729,True,1,215
6204,16352075,16360481,True,1,8406
6205,16371787,16377771,True,2,5984
6206,16382830,16383970,True,1,1140
6207,16384042,16384251,True,1,209
6208,16384151,16384240,True,4,89
6209,16384892,16385067,False,1,175
6210,16387374,16387536,True,1,162
6211,16393429,16394740,True,1,1311
6212,16402191,16407951,False,1,5760
6213,16402191,16407951,True,2,5760
6214,16423709,16429790,True,1,6081
6215,16427216,16428862,True,2,1646
6216,16428320,16429446,True,1,1126
6217,16431266,16432125,True,1,859
6218,16461860,16464578,False,1,2718
6219,16469785,16477336,True,2,7551
6220,16472695,16772300,False,1,299605
6221,16486665,16491846,True,1,5181
6222,16487010,16491846,True,1,4836
6223,16492118,16494249,False,1,2131
6224,16492118,16494370,True,2,2252
6225,16527239,16799198,False,1,271959
6226,16543568,16555650,True,2,12082
6227,16545676,16546597,True,1,921
6228,16545676,16551188,True,1,5512
6229,16548594,16549804,True,3,1210
6230,16552783,16554382,True,3,1599
6231,16552783,16558085,True,1,5302
6232,16552783,16564406,True,1,11623
6233,16561843,16563945,True,1,2102
6234,16590826,16591516,True,1,690
6235,16602927,16603901,False,1,974
6236,16632187,16634074,True,6,1887
6237,16650382,16652069,True,1,1687
6238,16666152,16673130,False,2,6978
6239,16666152,16673870,False,2,7718
6240,16668160,16668284,False,1,124
6241,16678532,16686745,True,2,8213
6242,16695442,16730965,False,1,35523
6243,16721906,16725722,False,1,3816
6244,16734499,16734669,False,1,170
6245,16734499,16734669,True,2,170
6246,16736815,16740641,True,3,3826
6247,16749235,16749898,True,2,663
6248,16752662,16757561,True,1,4899
6249,16756788,16757714,True,3,926
6250,16768847,16770514,False,1,1667
6251,16769175,16769745,True,1,570
6252,16772836,16772921,True,1,85
6253,16775273,16776798,True,1,1525
6254,16781193,16785692,True,1,4499
6255,16795773,16796265,True,1,492
6256,16827232,16828439,False,2,1207
6257,16827232,16828439,True,3,1207
6258,16827643,16827940,True,3,297
6259,16827674,16848457,True,5,20783
6260,16841721,16841992,True,1,271
6261,16858474,16858543,True,1,69
6262,16858533,16859846,True,2,1313
6263,16859552,16863778,True,1,4226
6264,16859552,16864832,True,1,5280
6265,16865901,16866214,True,1,313
6266,16866938,16867129,True,1,191
6267,16872266,16874026,False,1,1760
6268,16872266,16874049,False,1,1783
6269,16878751,16881103,False,1,2352
6270,16881372,16888804,True,1,7432
6271,16885699,16890732,True,1,5033
6272,16904066,16907323,False,1,3257
6273,16910544,16919949,True,1,9405
6274,16911196,16912445,True,1,1249
6275,16912439,16912609,True,1,170
6276,16915678,16917843,False,1,2165
6277,16947969,16948816,True,2,847
6278,16950613,16952739,False,1,2126
6279,16956490,16961605,True,1,5115
6280,16956490,16964857,True,2,8367
6281,16998008,16999272,True,1,1264
6282,17019296,17052423,True,1,33127
6283,17019797,17030089,True,4,10292
6284,17051112,17080150,True,1,29038
6285,17056643,17056740,True,1,97
6286,17057046,17058682,True,1,1636
6287,17073717,17074438,False,1,721
6288,17087158,17117913,True,3,30755
6289,17087158,17122361,True,1,35203
6290,17102883,17103170,False,1,287
6291,17110049,17110159,True,1,110
6292,17145112,17145654,False,1,542
6293,17151109,17151194,True,1,85
6294,17152635,17152714,True,2,79
6295,17162808,17190319,True,1,27511
6296,17164394,17166219,False,1,1825
6297,17165593,17166472,False,1,879
6298,17165593,17166472,True,1,879
6299,17172161,17172932,True,1,771
6300,17189034,17195564,True,2,6530
6301,17189034,17197234,True,1,8200
6302,17217328,17219082,True,1,1754
6303,17219393,17234376,True,1,14983
6304,17233597,17234570,True,1,973
6305,17239508,17241588,True,1,2080
6306,17266770,17271657,True,2,4887
6307,17273133,17273878,True,1,745
6308,17285563,17296871,True,1,11308
6309,17291011,17294902,True,2,3891
6310,17299716,17299792,True,1,76
6311,17302805,17303285,False,1,480
6312,17305064,17306217,True,1,1153
6313,17312938,17313060,True,1,122
6314,17322785,17326318,False,1,3533
6315,17322785,17326318,True,6,3533
6316,17331852,17333162,True,1,1310
6317,17332491,17333965,True,1,1474
6318,17373305,17374584,True,1,1279
6319,17386777,17386925,True,1,148
6320,17393503,17394824,True,1,1321
6321,17408357,17408741,True,1,384
6322,17412801,17413032,False,1,231
6323,17412801,17413411,False,1,610
6324,17412801,17413411,True,1,610
6325,17414971,17425828,True,1,10857
6326,17430575,17431906,True,5,1331
6327,17431158,17434877,False,1,3719
6328,17431158,17434877,True,1,3719
6329,17434792,17435268,True,1,476
6330,17443071,17445629,False,1,2558
6331,17457403,17457953,False,1,550
6332,17504252,17523662,True,1,19410
6333,17511694,17512162,True,2,468
6334,17511694,17512570,True,1,876
6335,17511694,17514220,False,1,2526
6336,17518049,17518155,True,2,106
6337,17537011,17597997,True,1,60986
6338,17551161,17562695,True,2,11534
6339,17566335,17566452,True,6,117
6340,17568368,17569459,True,1,1091
6341,17579391,17585899,True,1,6508
6342,17587004,17601044,True,1,14040
6343,17599338,17600634,True,3,1296
6344,17614547,17636379,True,2,21832
6345,17629363,17644126,True,1,14763
6346,17644755,17645083,True,1,328
6347,17668700,17700691,False,1,31991
6348,17679946,17708953,False,1,29007
6349,17701410,17702896,True,2,1486
6350,17701410,17716922,True,1,15512
6351,17716456,17718087,False,1,1631
6352,17720994,17725791,True,1,4797
6353,17731418,17732704,True,1,1286
6354,17738843,17741717,True,1,2874
6355,17741098,17742558,True,3,1460
6356,17749667,17751780,True,1,2113
6357,17774747,17776116,True,1,1369
6358,17779483,17780503,True,1,1020
6359,17783474,17787323,False,2,3849
6360,17783474,17787323,True,5,3849
6361,17842022,17850950,True,1,8928
6362,17842546,17844002,True,2,1456
6363,17843120,17843616,True,3,496
6364,17846574,17847120,True,1,546
6365,17849760,17850484,True,1,724
6366,17863050,17865886,False,1,2836
6367,17864961,17867132,False,1,2171
6368,17865115,17865576,False,1,461
6369,17865470,17865689,True,4,219
6370,17865956,17866736,True,2,780
6371,17865956,17869109,True,2,3153
6372,17877912,17878515,False,1,603
6373,17883619,17884461,True,1,842
6374,17883619,17888630,True,1,5011
6375,17895981,17899003,True,9,3022
6376,17918838,17923649,True,1,4811
6377,17919225,17921469,False,2,2244
6378,17919225,17921469,True,2,2244
6379,17938861,17943587,False,1,4726
6380,17938861,17943587,True,2,4726
6381,17950458,17950925,True,1,467
6382,17972916,17973670,False,1,754
6383,17973911,17974355,True,3,444
6384,17977894,17978384,True,1,490
6385,17986454,17986559,True,2,105
6386,17991686,17993765,True,1,2079
6387,17991982,17992174,False,1,192
6388,17992941,18001834,True,1,8893
6389,17992941,18002618,True,1,9677
6390,17995369,17995635,True,1,266
6391,17995734,17997441,True,1,1707
6392,18001636,18003141,True,1,1505
6393,18007229,18007542,True,1,313
6394,18010641,18010742,True,1,101
6395,18011916,18015212,False,1,3296
6396,18011916,18015212,True,2,3296
6397,18011916,18023086,True,1,11170
6398,18011916,18024859,True,1,12943
6399,18041090,18041261,False,1,171
6400,18049891,18054469,True,2,4578
6401,18078265,18079620,True,1,1355
6402,18083790,18084467,True,3,677
6403,18093064,18093364,False,1,300
6404,18099553,18247735,True,2,148182
6405,18112950,18113704,False,1,754
6406,18126935,18128167,True,1,1232
6407,18134738,18135970,True,1,1232
6408,18134738,18137539,True,3,2801
6409,18154888,18164187,True,1,9299
6410,18187492,18187966,True,1,474
6411,18187492,18189351,True,1,1859
6412,18194852,18194958,True,4,106
6413,18202462,18206497,True,1,4035
6414,18203422,18209093,True,1,5671
6415,18203422,18218931,True,1,15509
6416,18205422,18220461,True,1,15039
6417,18235173,18235715,False,1,542
6418,18273713,18319128,True,3,45415
6419,18274469,18300927,False,1,26458
6420,18275431,18319938,True,1,44507
6421,18284533,18287020,True,2,2487
6422,18307749,18435654,True,2,127905
6423,18309369,18311268,False,1,1899
6424,18321775,18323859,True,2,2084
6425,18321775,18323893,True,1,2118
6426,18329168,18330018,True,1,850
6427,18329168,18335808,True,1,6640
6428,18334578,18335791,False,1,1213
6429,18335153,18339846,False,1,4693
6430,18340705,18357859,True,1,17154
6431,18350409,18350426,True,2,17
6432,18350740,18351346,True,1,606
6433,18365483,18365970,False,1,487
6434,18371663,18372312,True,1,649
6435,18374436,18377985,False,1,3549
6436,18391139,18411399,False,1,20260
6437,18391388,18391994,True,2,606
6438,18396135,18486481,True,1,90346
6439,18414990,18418538,False,1,3548
6440,18416518,18418398,False,1,1880
6441,18420239,18450409,True,1,30170
6442,18431697,18451758,True,1,20061
6443,18432164,18432770,False,2,606
6444,18433653,18438603,True,1,4950
6445,18435596,18436192,False,1,596
6446,18440738,18441080,True,2,342
6447,18453589,18457143,False,1,3554
6448,18468897,18469626,False,1,729
6449,18472387,18601562,True,1,129175
6450,18472590,18473196,True,1,606
6451,18473838,18474107,True,1,269
6452,18502323,18517654,True,3,15331
6453,18502323,18518341,True,1,16018
6454,18517251,18517622,False,1,371
6455,18533317,18533886,True,2,569
6456,18576991,18606217,True,1,29226
6457,18589987,18599844,True,1,9857
6458,18592762,18596316,False,1,3554
6459,18603025,18603590,True,2,565
6460,18604788,18607116,True,1,2328
6461,18607340,18610200,True,1,2860
6462,18609658,18610264,True,2,606
6463,18609658,18650876,True,1,41218
6464,18625995,18626536,False,1,541
6465,18627340,18631361,True,1,4021
6466,18633382,18636932,False,1,3550
6467,18633572,18637767,True,1,4195
6468,18650015,18650032,True,2,17
6469,18669682,18671953,True,2,2271
6470,18690600,18690617,False,2,17
6471,18694252,18766337,True,2,72085
6472,18703522,18704528,True,1,1006
6473,18706070,18768740,True,1,62670
6474,18714608,18718157,False,1,3549
6475,18731508,18732114,True,1,606
6476,18762422,18763094,False,1,672
6477,18783122,18823344,False,1,40222
6478,18785733,18786310,False,1,577
6479,18809527,18811414,True,1,1887
6480,18809732,18811414,True,1,1682
6481,18811827,18812815,False,1,988
6482,18812562,18831003,True,1,18441
6483,18813594,18813955,True,1,361
6484,18827566,18851111,True,2,23545
6485,18832409,18843270,True,1,10861
6486,18862717,18863897,True,1,1180
6487,18862836,18901152,True,3,38316
6488,18865466,18870224,True,1,4758
6489,18866687,18903018,True,1,36331
6490,18869351,18869816,True,11,465
6491,18869981,18870270,True,3,289
6492,18870826,18910906,True,1,40080
6493,18872658,18877157,True,1,4499
6494,18872744,18877048,False,1,4304
6495,18879063,18905551,True,2,26488
6496,18892576,18898343,True,1,5767
6497,18892763,18893283,True,1,520
6498,18894141,18894438,True,1,297
6499,18896809,18898357,False,1,1548
6500,18896809,18900718,False,1,3909
6501,18907531,18908511,False,1,980
6502,18943245,18947037,True,1,3792
6503,18947455,18949231,True,1,1776
6504,18950180,18987993,True,1,37813
6505,18951218,18988516,True,1,37298
6506,18951845,18952182,True,1,337
6507,18960025,18967440,True,1,7415
6508,18960025,18969031,True,1,9006
6509,18960025,18969960,True,1,9935
6510,18965134,18975358,True,3,10224
6511,18967740,18968801,True,1,1061
6512,18969674,18971303,True,2,1629
6513,18974090,18975924,True,1,1834
6514,18990567,18991102,True,2,535
6515,19038300,19041267,True,3,2967
6516,19038300,19056289,True,1,17989
6517,19048497,19049429,True,4,932
6518,19057552,19058028,False,1,476
6519,19084039,19087693,True,1,3654
6520,19089110,19089355,False,1,245
6521,19089110,19090584,False,2,1474
6522,19092848,19093390,False,1,542
6523,19092848,19093390,True,2,542
6524,19092848,19094054,False,1,1206
6525,19092848,19094054,True,1,1206
6526,19092953,19095411,False,1,2458
6527,19094516,19095029,True,1,513
6528,19094738,19095981,False,1,1243
6529,19094738,19095981,True,3,1243
6530,19097238,19108297,True,1,11059
6531,19098306,19108571,True,2,10265
6532,19110627,19113963,False,1,3336
6533,19119570,19137925,True,1,18355
6534,19127617,19132557,True,2,4940
6535,19129101,19132904,True,1,3803
6536,19141581,19141655,False,1,74
6537,19142092,19142389,True,1,297
6538,19145619,19145877,False,1,258
6539,19147993,19153825,False,1,5832
6540,19155938,19157789,False,1,1851
6541,19156040,19156809,True,2,769
6542,19170664,19170914,True,1,250
6543,19181786,19189366,False,1,7580
6544,19184968,19185259,False,1,291
6545,19191283,19192660,True,1,1377
6546,19193155,19193666,True,1,511
6547,19194727,19194862,True,1,135
6548,19199333,19213209,True,1,13876
6549,19209452,19217706,True,1,8254
6550,19229445,19230783,True,1,1338
6551,19229445,19233018,False,1,3573
6552,19229445,19233018,True,1,3573
6553,19229445,19233050,True,1,3605
6554,19260057,19260638,True,1,581
6555,19260057,19262435,True,1,2378
6556,19260057,19312758,True,1,52701
6557,19277677,19281142,False,1,3465
6558,19278992,19280339,True,2,1347
6559,19283043,19283408,False,2,365
6560,19298032,19304877,True,2,6845
6561,19299082,19299218,False,1,136
6562,19299082,19299488,False,1,406
6563,19303658,19307485,True,1,3827
6564,19314027,19315421,True,1,1394
6565,19324291,19325100,False,1,809
6566,19332667,19334187,True,1,1520
6567,19335713,19343591,True,1,7878
6568,19349763,19350832,True,2,1069
6569,19354076,19354613,True,2,537
6570,19354076,19355060,True,1,984
6571,19371452,19401318,True,3,29866
6572,19382542,19386419,False,1,3877
6573,19382542,19386419,True,3,3877
6574,19382542,19415976,True,1,33434
6575,19387332,19400975,True,1,13643
6576,19416194,19477151,False,1,60957
6577,19416194,19477151,True,2,60957
6578,19416668,19483500,True,1,66832
6579,19420085,19420872,False,1,787
6580,19420880,19421516,False,1,636
6581,19423649,19463312,True,1,39663
6582,19423649,19481950,True,1,58301
6583,19423972,19458053,False,1,34081
6584,19426768,19426921,True,1,153
6585,19440013,19442696,True,2,2683
6586,19440013,19445720,True,1,5707
6587,19449579,19451646,True,1,2067
6588,19453818,19456390,True,1,2572
6589,19458949,19466502,False,1,7553
6590,19458949,19466502,True,1,7553
6591,19464478,19469615,True,1,5137
6592,19464478,19475059,False,1,10581
6593,19464697,19482645,False,1,17948
6594,19482095,19488293,False,1,6198
6595,19491257,19491778,True,2,521
6596,19495886,19498509,True,1,2623
6597,19496869,19496981,False,1,112
6598,19501074,19519645,True,1,18571
6599,19503153,19522004,True,2,18851
6600,19509245,19596185,True,1,86940
6601,19515369,19515636,False,1,267
6602,19523894,19526558,True,5,2664
6603,19527942,19530609,True,2,2667
6604,19539826,19576156,False,1,36330
6605,19540500,19540642,True,1,142
6606,19547255,19549246,True,4,1991
6607,19554761,19555628,False,1,867
6608,19559889,19609232,False,1,49343
6609,19561316,19581906,False,1,20590
6610,19572131,19592291,False,1,20160
6611,19579841,19580256,True,1,415
6612,19579841,19580340,True,3,499
6613,19583734,19584254,True,8,520
6614,19587086,19589839,True,1,2753
6615,19587086,19591606,True,2,4520
6616,19587086,19591902,True,1,4816
6617,19591166,19601744,False,1,10578
6618,19598333,19598439,True,1,106
6619,19598560,19600200,True,1,1640
6620,19601099,19606791,False,1,5692
6621,19601566,19606919,False,3,5353
6622,19601669,19606974,False,1,5305
6623,19602171,19606919,False,2,4748
6624,19602276,19603265,True,3,989
6625,19602544,19607367,True,1,4823
6626,19602547,19605330,True,1,2783
6627,19602750,19605181,True,1,2431
6628,19604047,19614339,False,1,10292
6629,19620005,19629375,False,1,9370
6630,19634583,19635241,True,7,658
6631,19643880,19647357,True,4,3477
6632,19644694,19655820,False,3,11126
6633,19644694,19655820,True,3,11126
6634,19644694,19662799,True,2,18105
6635,19650708,19651809,True,1,1101
6636,19656071,19664350,True,2,8279
6637,19668422,19673519,True,1,5097
6638,19668567,19673519,True,1,4952
6639,19669039,19673572,True,3,4533
6640,19669665,19674141,True,1,4476
6641,19681216,19683216,False,1,2000
6642,19684420,19684911,False,1,491
6643,19685617,19688496,False,1,2879
6644,19703721,19703946,True,1,225
6645,19704036,19706268,True,1,2232
6646,19706069,19709970,True,2,3901
6647,19709960,19712687,True,1,2727
6648,19709960,19714258,True,1,4298
6649,19713816,19714158,True,2,342
6650,19715643,19717084,True,1,1441
6651,19720846,19723773,True,1,2927
6652,19721511,19797839,False,1,76328
6653,19721753,19726810,True,2,5057
6654,19725398,19725732,False,1,334
6655,19726181,19731798,True,1,5617
6656,19734881,19735928,True,1,1047
6657,19737590,19738684,True,1,1094
6658,19737590,19740906,True,1,3316
6659,19737827,19739690,True,1,1863
6660,19737827,19743693,True,1,5866
6661,19750496,19760630,True,1,10134
6662,19759423,19760246,True,2,823
6663,19761038,19780624,True,2,19586
6664,19761989,19780935,True,1,18946
6665,19763559,19763639,True,1,80
6666,19765350,19765465,True,1,115
6667,19771799,19772306,True,1,507
6668,19772002,19772306,True,1,304
6669,19794179,19797500,True,1,3321
6670,19794339,19797660,True,2,3321
6671,19801280,19809307,True,1,8027
6672,19811266,19812262,True,1,996
6673,19814020,19814390,True,1,370
6674,19814680,19816233,True,1,1553
6675,19815020,19816054,True,1,1034
6676,19815620,19816233,True,1,613
6677,19817373,19819957,True,6,2584
6678,19817373,19827141,True,1,9768
6679,19817373,19973635,False,1,156262
6680,19819167,19839576,True,2,20409
6681,19823997,19977170,True,2,153173
6682,19828286,19845759,True,2,17473
6683,19831796,19881569,False,1,49773
6684,19843335,19844847,True,1,1512
6685,19843335,19850161,True,3,6826
6686,19864765,19866867,True,1,2102
6687,19877215,19877556,True,1,341
6688,19877307,19877568,True,1,261
6689,19879103,19882881,False,1,3778
6690,19879103,20099146,False,1,220043
6691,19888671,19888867,True,1,196
6692,19889259,19889590,True,3,331
6693,19889259,19890225,False,1,966
6694,19889259,19892557,True,1,3298
6695,19889259,19892899,False,1,3640
6696,19891960,19893379,False,1,1419
6697,19891960,19894992,True,2,3032
6698,19892809,19893150,False,1,341
6699,19906618,19906817,True,1,199
6700,19906618,20018406,True,2,111788
6701,19917861,19918152,False,2,291
6702,19917861,19918152,True,10,291
6703,19918098,19918176,True,1,78
6704,19929932,19931874,True,1,1942
6705,19942292,19942421,True,1,129
6706,19951128,19951626,True,2,498
6707,19951819,19952040,True,1,221
6708,19960301,19964986,False,4,4685
6709,19960301,19964986,True,3,4685
6710,19961778,19963443,True,1,1665
6711,19967258,19968917,True,5,1659
6712,19967692,20015277,True,2,47585
6713,19974620,19974992,False,1,372
6714,19976910,19977665,True,1,755
6715,19978375,19978836,False,1,461
6716,19980290,19981722,True,4,1432
6717,19980861,19981047,True,1,186
6718,20007058,20035559,True,1,28501
6719,20010974,20011945,True,1,971
6720,20011273,20011649,False,1,376
6721,20011516,20017036,True,1,5520
6722,20021829,20022608,True,1,779
6723,20031677,20031921,True,1,244
6724,20031677,20034600,True,2,2923
6725,20057542,20058091,True,1,549
6726,20057542,20072993,True,1,15451
6727,20068351,20071618,True,1,3267
6728,20073612,20077600,False,1,3988
6729,20095608,20106573,False,1,10965
6730,20097408,20098187,True,1,779
6731,20102846,20120568,True,1,17722
6732,20113133,20121165,False,1,8032
6733,20114643,20121403,False,1,6760
6734,20114643,20124880,True,1,10237
6735,20118991,20124478,False,1,5487
6736,20132104,20135122,True,1,3018
6737,20136269,20138419,True,3,2150
6738,20136492,20138489,True,1,1997
6739,20141469,20141561,True,1,92
6740,20153070,20153273,False,1,203
6741,20153070,20154888,True,2,1818
6742,20172220,20175395,False,1,3175
6743,20172220,20175395,True,1,3175
6744,20182246,20185126,False,1,2880
6745,20183773,20184825,True,1,1052
6746,20183773,20186833,False,1,3060
6747,20183773,20186833,True,2,3060
6748,20186792,20225124,False,1,38332
6749,20186792,20225124,True,4,38332
6750,20201445,20201936,False,1,491
6751,20207869,20228088,True,1,20219
6752,20246218,20268883,True,1,22665
6753,20248200,20251655,True,1,3455
6754,20248293,20255570,True,1,7277
6755,20248293,20255940,True,1,7647
6756,20248461,20255738,True,1,7277
6757,20250124,20251311,True,2,1187
6758,20291547,20293398,True,2,1851
6759,20292284,20295515,True,1,3231
6760,20304186,20304435,False,1,249
6761,20314835,20324640,True,1,9805
6762,20326679,20328612,False,1,1933
6763,20326679,20328612,True,3,1933
6764,20366846,20377338,True,1,10492
6765,20367189,20371514,True,1,4325
6766,20367189,20374787,True,1,7598
6767,20367566,20369956,True,1,2390
6768,20367969,20370230,True,1,2261
6769,20368949,20370646,True,1,1697
6770,20393929,20394408,True,3,479
6771,20395255,20395452,True,1,197
6772,20396010,20402954,True,1,6944
6773,20399101,20406800,True,1,7699
6774,20399101,20455551,True,3,56450
6775,20406467,20407035,True,2,568
6776,20408464,20409066,True,1,602
6777,20413294,20426082,True,1,12788
6778,20433986,20434073,True,3,87
6779,20444612,20446503,True,1,1891
6780,20446902,20448189,True,1,1287
6781,20447191,20448969,True,3,1778
6782,20451494,20451842,True,1,348
6783,20453378,20460940,False,2,7562
6784,20453378,20460940,True,2,7562
6785,20453378,20462207,False,1,8829
6786,20453378,20462207,True,1,8829
6787,20458104,20458243,True,1,139
6788,20459938,20460076,True,1,138
6789,20462400,20469713,True,1,7313
6790,20488398,20488912,True,5,514
6791,20490563,20491799,False,1,1236
6792,20494542,20495633,True,1,1091
6793,20500838,20504536,True,2,3698
6794,20500838,20508502,True,1,7664
6795,20501655,20504905,True,2,3250
6796,20525718,20525802,True,1,84
6797,20539223,20540126,False,1,903
6798,20540564,20545217,True,3,4653
6799,20540564,20547269,True,2,6705
6800,20541358,20541677,False,1,319
6801,20541699,20563069,False,1,21370
6802,20541699,20563069,True,2,21370
6803,20541941,20546594,False,2,4653
6804,20543469,20563979,True,1,20510
6805,20547633,20549079,True,1,1446
6806,20555898,20558195,True,2,2297
6807,20558450,20560013,True,1,1563
6808,20559962,20560265,True,1,303
6809,20564061,20564360,True,1,299
6810,20572984,20595923,False,1,22939
6811,20576010,20578522,False,1,2512
6812,20580927,20581053,True,3,126
6813,20582176,20592697,False,1,10521
6814,20582176,20592746,False,1,10570
6815,20584799,20608610,True,4,23811
6816,20587561,20588838,True,1,1277
6817,20623518,20623842,True,3,324
6818,20623518,20624281,True,1,763
6819,20642515,20642699,False,1,184
6820,20642515,20646107,False,1,3592
6821,20645321,20646456,False,3,1135
6822,20645321,20647838,False,4,2517
6823,20645321,20650065,False,6,4744
6824,20653417,20653866,True,1,449
6825,20654968,20661181,False,1,6213
6826,20655011,20655819,False,3,808
6827,20655011,20655819,True,7,808
6828,20655011,20658877,True,1,3866
6829,20655011,20661957,False,1,6946
6830,20657721,20660155,True,1,2434
6831,20658262,20658781,False,1,519
6832,20663783,20666703,True,1,2920
6833,20663783,20669483,True,1,5700
6834,20667731,20673986,True,1,6255
6835,20681128,20681982,False,1,854
6836,20685672,20688322,True,5,2650
6837,20691093,20691952,True,1,859
6838,20693451,20694526,True,1,1075
6839,20704372,20765943,False,1,61571
6840,20707038,20707517,True,1,479
6841,20707779,20731658,True,3,23879
6842,20707779,20740854,True,1,33075
6843,20725324,20725459,True,1,135
6844,20725625,20725710,True,2,85
6845,20731306,20731921,False,1,615
6846,20731306,20736148,True,2,4842
6847,20736515,20739371,False,1,2856
6848,20736515,20745564,True,4,9049
6849,20763418,20766955,True,1,3537
6850,20763418,20776319,True,1,12901
6851,20766304,20770070,True,2,3766
6852,20771762,20773689,False,1,1927
6853,20771762,20773689,True,2,1927
6854,20774130,20775724,False,1,1594
6855,20791511,20793295,True,1,1784
6856,20795724,20795852,True,2,128
6857,20795724,20795929,True,1,205
6858,20795853,20797594,False,1,1741
6859,20795853,20797594,True,3,1741
6860,20795853,20799638,True,1,3785
6861,20801455,20802400,True,1,945
6862,20804633,20804857,True,1,224
6863,20805281,20807177,True,1,1896
6864,20819886,20828967,True,1,9081
6865,20825150,20827462,False,1,2312
6866,20829583,20829817,False,2,234
6867,20831105,20836257,True,11,5152
6868,20831362,20831542,True,1,180
6869,20832051,20854772,True,1,22721
6870,20832224,20832585,False,1,361
6871,20842208,20842417,True,1,209
6872,20846026,20850593,False,1,4567
6873,20849213,20850869,True,2,1656
6874,20849213,20864309,True,1,15096
6875,20855164,20855252,True,1,88
6876,20855337,20855791,True,1,454
6877,20858563,20862496,False,1,3933
6878,20859653,20872202,True,1,12549
6879,20875184,20879965,True,4,4781
6880,20882331,20882644,False,1,313
6881,20884088,20884210,True,1,122
6882,20884383,20890343,True,1,5960
6883,20885452,20893180,True,6,7728
6884,20885452,20906284,False,1,20832
6885,20886332,20979988,True,1,93656
6886,20886433,20893718,False,1,7285
6887,20886433,20893718,True,5,7285
6888,20887893,20980784,True,1,92891
6889,20889186,20889285,True,2,99
6890,20889666,20897930,True,1,8264
6891,20892393,20895097,True,1,2704
6892,20901341,20903704,False,1,2363
6893,20907156,20908726,False,1,1570
6894,20909660,20923088,True,1,13428
6895,20914195,20917624,True,1,3429
6896,20918266,20918768,True,2,502
6897,20921099,20922401,True,3,1302
6898,20921099,20922639,True,1,1540
6899,20921259,20922561,True,1,1302
6900,20922847,20922929,True,2,82
6901,20928994,20958812,False,1,29818
6902,20934715,20937813,True,1,3098
6903,20936654,20936737,True,1,83
6904,20939045,21002514,False,1,63469
6905,20940624,21007247,True,1,66623
6906,20943929,20954927,True,1,10998
6907,20944557,20949131,True,1,4574
6908,20944813,20955283,False,1,10470
6909,20944813,20955283,True,1,10470
6910,20947905,20964510,True,1,16605
6911,20948980,20965585,False,2,16605
6912,20948980,20965585,True,1,16605
6913,20953660,20959725,True,1,6065
6914,20953881,20959946,False,1,6065
6915,20955429,20960540,True,1,5111
6916,20959890,20993347,True,1,33457
6917,20959890,21002634,False,1,42744
6918,20959890,21002634,True,1,42744
6919,20959890,21045876,True,1,85986
6920,20965648,20965737,True,1,89
6921,20980783,20984055,True,4,3272
6922,20982261,20985515,True,1,3254
6923,20982261,20991205,False,1,8944
6924,20984074,20994715,True,1,10641
6925,20985082,20985506,False,1,424
6926,20985082,20985506,True,1,424
6927,21004190,21005568,True,1,1378
6928,21017666,21045762,True,1,28096
6929,21018232,21045848,True,1,27616
6930,21020154,21021207,True,1,1053
6931,21032999,21042999,False,1,10000
6932,21042361,21043715,True,1,1354
6933,21043217,21049272,False,1,6055
6934,21043217,21049272,True,1,6055
6935,21043479,21143234,False,1,99755
6936,21043868,21044088,True,1,220
6937,21045597,21047190,False,1,1593
6938,21050781,21055680,False,1,4899
6939,21050781,21055680,True,4,4899
6940,21052027,21056637,True,1,4610
6941,21052027,21058578,True,1,6551
6942,21054921,21055006,True,1,85
6943,21058657,21150170,True,1,91513
6944,21060369,21062300,False,1,1931
6945,21060369,21062300,True,1,1931
6946,21063092,21088224,True,1,25132
6947,21063838,21064754,True,1,916
6948,21066372,21068033,True,1,1661
6949,21066372,21068147,True,1,1775
6950,21066420,21066916,True,1,496
6951,21066609,21068033,True,1,1424
6952,21066609,21068147,True,1,1538
6953,21069837,21073803,False,1,3966
6954,21069837,21073803,True,1,3966
6955,21070061,21090331,False,2,20270
6956,21070061,21090331,True,5,20270
6957,21070684,21092666,True,1,21982
6958,21078988,21079103,True,1,115
6959,21083282,21098412,True,1,15130
6960,21086357,21100002,True,1,13645
6961,21113523,21177530,True,1,64007
6962,21120370,21120908,True,1,538
6963,21125871,21170354,False,1,44483
6964,21125871,21173339,False,1,47468
6965,21125871,21178444,False,2,52573
6966,21127637,21129135,True,1,1498
6967,21129379,21182877,True,1,53498
6968,21130128,21133214,True,3,3086
6969,21136575,21137446,True,2,871
6970,21139818,21139913,True,1,95
6971,21158668,21162923,True,1,4255
6972,21160256,21160773,True,2,517
6973,21161501,21162140,True,3,639
6974,21165453,21168981,True,1,3528
6975,21165453,21264937,True,1,99484
6976,21167032,21167908,True,1,876
6977,21168218,21173690,True,1,5472
6978,21170670,21173032,False,1,2362
6979,21173139,21207574,True,1,34435
6980,21173963,21198533,False,1,24570
6981,21176727,21184579,True,1,7852
6982,21189761,21194027,True,1,4266
6983,21192759,21196637,True,6,3878
6984,21194289,21196661,True,2,2372
6985,21194289,21197117,True,1,2828
6986,21197898,21198766,True,4,868
6987,21201910,21209151,False,2,7241
6988,21201910,21209151,True,1,7241
6989,21206946,21216506,False,1,9560
6990,21217048,21217957,True,1,909
6991,21235543,21243223,True,2,7680
6992,21238934,21239760,True,1,826
6993,21244448,21244536,True,1,88
6994,21246309,21300584,True,1,54275
6995,21246309,21306543,True,1,60234
6996,21249122,21251489,True,1,2367
6997,21249122,21251915,True,1,2793
6998,21249227,21254061,True,1,4834
6999,21266310,21290637,False,1,24327
7000,21266310,21338807,True,1,72497
7001,21309588,21309975,True,1,387
7002,21309647,21310029,True,1,382
7003,21309647,21310103,False,2,456
7004,21309647,21310103,True,1,456
7005,21311438,21318203,True,1,6765
7006,21328717,21329521,True,3,804
7007,21342019,21342928,True,2,909
7008,21343481,21344428,False,1,947
7009,21343481,21355068,False,2,11587
7010,21343481,21355068,True,1,11587
7011,21355230,21356324,True,2,1094
7012,21360622,21362980,True,1,2358
7013,21360622,21427626,True,1,67004
7014,21367110,21368437,True,2,1327
7015,21390489,21392742,True,1,2253
7016,21396781,21399579,True,1,2798
7017,21397494,21405150,False,1,7656
7018,21415458,21416387,True,1,929
7019,21423207,21428651,True,4,5444
7020,21426357,21450047,True,1,23690
7021,21427315,21427514,True,1,199
7022,21436696,21437820,True,1,1124
7023,21443016,21450979,True,1,7963
7024,21446621,21447934,True,1,1313
7025,21446621,21447948,True,2,1327
7026,21454891,21467051,True,1,12160
7027,21472516,21473097,True,1,581
7028,21478760,21480150,True,1,1390
7029,21483220,21483688,False,1,468
7030,21483220,21485953,False,3,2733
7031,21490994,21491079,True,1,85
7032,21493740,21493815,True,1,75
7033,21496108,21497427,False,2,1319
7034,21496108,21497427,True,2,1319
7035,21497136,21497228,True,1,92
7036,21510082,21535798,True,1,25716
7037,21515336,21516814,False,1,1478
7038,21515336,21516814,True,1,1478
7039,21516098,21517444,True,1,1346
7040,21527794,21533297,False,2,5503
7041,21527794,21533297,True,2,5503
7042,21527794,21538514,True,1,10720
7043,21530099,21546126,True,6,16027
7044,21544484,21546010,True,1,1526
7045,21545814,21547027,True,1,1213
7046,21548943,21558703,False,1,9760
7047,21575824,21577125,True,1,1301
7048,21583987,21588136,False,1,4149
7049,21592772,21598353,False,1,5581
7050,21594891,21597704,True,1,2813
7051,21594987,21595827,True,1,840
7052,21604775,21606051,False,1,1276
7053,21624490,21624735,True,1,245
7054,21638020,21639129,True,4,1109
7055,21645142,21646102,True,1,960
7056,21647666,21647836,False,1,170
7057,21653033,21655007,False,1,1974
7058,21657807,21699140,True,5,41333
7059,21670289,21678269,False,2,7980
7060,21675436,21675513,True,3,77
7061,21703928,21705526,True,2,1598
7062,21710507,21712495,False,6,1988
7063,21716122,21719064,True,2,2942
7064,21723490,21724659,False,1,1169
7065,21723490,21724659,True,1,1169
7066,21723631,21724722,True,2,1091
7067,21723867,21724659,True,1,792
7068,21748621,21749577,True,1,956
7069,21750883,21751939,True,2,1056
7070,21750915,21751939,True,1,1024
7071,21752808,21753869,False,1,1061
7072,21759676,21766569,False,1,6893
7073,21759707,21766615,False,1,6908
7074,21774431,21778807,True,1,4376
7075,21787431,21790873,True,1,3442
7076,21796591,21797298,True,2,707
7077,21812376,21826382,False,1,14006
7078,21813782,21815565,False,1,1783
7079,21813782,21815565,True,4,1783
7080,21842936,21850537,True,2,7601
7081,21847968,21848574,True,5,606
7082,21868474,21869630,True,1,1156
7083,21887002,21888721,True,1,1719
7084,21918320,21920038,True,1,1718
7085,21942293,21960191,True,6,17898
7086,21944898,21949294,True,1,4396
7087,21945776,21953834,False,1,8058
7088,21945776,21953834,True,5,8058
7089,21954278,21963046,False,3,8768
7090,21963553,22055544,False,1,91991
7091,21964850,21997877,False,1,33027
7092,21964850,21997877,True,1,33027
7093,21965131,21970926,True,1,5795
7094,21976668,22062064,False,1,85396
7095,21996996,21998089,False,2,1093
7096,21996996,21998089,True,2,1093
7097,22002656,22002934,False,1,278
7098,22013327,22014227,True,3,900
7099,22027449,22027958,True,3,509
7100,22041729,22041920,True,2,191
7101,22045829,22047410,True,1,1581
7102,22046163,22058171,True,1,12008
7103,22067214,22068373,False,1,1159
7104,22067214,22068373,True,2,1159
7105,22067214,22494712,True,1,427498
7106,22067293,22067389,True,2,96
7107,22069034,22091775,True,1,22741
7108,22076998,22089981,True,3,12983
7109,22079015,22079111,True,1,96
7110,22088048,22092130,False,2,4082
7111,22090122,22093063,False,1,2941
7112,22094661,22254705,True,3,160044
7113,22095857,22096659,False,1,802
7114,22116118,22117519,True,1,1401
7115,22116520,22117884,False,1,1364
7116,22117746,22119083,True,1,1337
7117,22119605,22157333,False,1,37728
7118,22120018,22267339,True,2,147321
7119,22143447,22163048,True,1,19601
7120,22143447,22166392,True,2,22945
7121,22143447,22166395,True,1,22948
7122,22145478,22146449,True,2,971
7123,22163769,22164699,True,3,930
7124,22174284,22176810,True,1,2526
7125,22181182,22216258,True,1,35076
7126,22188887,22228899,True,1,40012
7127,22189848,22190746,True,5,898
7128,22208584,22214629,True,1,6045
7129,22209864,22210317,True,1,453
7130,22210751,22211766,True,1,1015
7131,22211644,22211800,True,1,156
7132,22227162,22227276,False,1,114
7133,22229590,22229665,True,1,75
7134,22247225,22253068,True,1,5843
7135,22253480,22254738,True,2,1258
7136,22258948,22259542,True,1,594
7137,22258985,22259542,True,1,557
7138,22259043,22259542,True,1,499
7139,22260066,22262088,True,1,2022
7140,22263899,22265448,True,1,1549
7141,22280736,22280904,True,1,168
7142,22284578,22294700,True,2,10122
7143,22285479,22295355,True,1,9876
7144,22290116,22311420,True,3,21304
7145,22298691,22299488,False,1,797
7146,22313312,22316013,False,1,2701
7147,22313312,22316013,True,3,2701
7148,22323884,22336163,True,2,12279
7149,22324467,22328847,True,1,4380
7150,22334144,22334823,True,2,679
7151,22356634,22360348,False,1,3714
7152,22357863,22479465,True,1,121602
7153,22369434,22371979,True,4,2545
7154,22392453,22496900,True,1,104447
7155,22394373,22410757,False,1,16384
7156,22400328,22410934,True,7,10606
7157,22401884,22414117,True,1,12233
7158,22402869,22412171,True,1,9302
7159,22407585,22408240,False,1,655
7160,22407998,22408676,False,1,678
7161,22410367,22417729,False,1,7362
7162,22414272,22414439,False,1,167
7163,22414272,22414439,True,4,167
7164,22415093,22498562,True,3,83469
7165,22427413,22429256,False,1,1843
7166,22439838,22480078,True,1,40240
7167,22451871,22467230,False,1,15359
7168,22477444,22478808,True,1,1364
7169,22478908,22479043,False,1,135
7170,22480165,22485417,False,1,5252
7171,22491230,22506329,True,1,15099
7172,22496836,22501286,True,1,4450
7173,22499357,22501670,True,1,2313
7174,22503476,22510205,False,1,6729
7175,22515795,22516322,True,1,527
7176,22535413,22568355,True,1,32942
7177,22546895,22553812,True,2,6917
7178,22552229,22555493,True,3,3264
7179,22560993,22561073,True,1,80
7180,22561117,22580510,True,2,19393
7181,22585257,22606994,True,1,21737
7182,22585591,22711651,False,1,126060
7183,22588838,22589201,True,1,363
7184,22591354,22596129,True,2,4775
7185,22607844,22608275,True,1,431
7186,22620183,22620950,True,3,767
7187,22623120,22624427,True,3,1307
7188,22628125,22654167,True,3,26042
7189,22645343,22654049,True,1,8706
7190,22667371,22678953,True,1,11582
7191,22687140,22732576,False,1,45436
7192,22696375,22696856,False,1,481
7193,22696375,22698934,True,1,2559
7194,22697658,22698207,True,1,549
7195,22700904,22701103,True,1,199
7196,22703620,22718177,False,1,14557
7197,22703620,22752251,True,1,48631
7198,22723582,22724431,True,1,849
7199,22739286,22739447,True,1,161
7200,22749584,22749674,True,1,90
7201,22801724,22830308,True,1,28584
7202,22813865,22815639,False,1,1774
7203,22813865,22815639,True,1,1774
7204,22823456,22828897,True,1,5441
7205,22825566,22826256,True,3,690
7206,22835397,22879101,False,1,43704
7207,22836802,22838327,True,1,1525
7208,22837818,22838963,True,1,1145
7209,22868869,22869920,False,1,1051
7210,22868982,22878842,True,1,9860
7211,22878933,22883807,True,1,4874
7212,22907247,22909377,True,3,2130
7213,22914483,22917508,True,3,3025
7214,22914516,22917534,True,2,3018
7215,22918248,22920108,True,1,1860
7216,22918969,22919065,True,1,96
7217,22920147,22921167,True,2,1020
7218,22932309,22933537,True,2,1228
7219,22941128,22942387,True,1,1259
7220,22970987,22971569,True,1,582
7221,22975038,22975258,False,1,220
7222,22977151,22977245,False,1,94
7223,22977151,22977245,True,3,94
7224,22989092,23001690,True,2,12598
7225,23003979,23013191,True,2,9212
7226,23008356,23026275,True,2,17919
7227,23009619,23010762,True,3,1143
7228,23009927,23012649,True,2,2722
7229,23054871,23056483,True,1,1612
7230,23062886,23063065,True,3,179
7231,23068403,23074602,False,1,6199
7232,23069039,23092485,True,2,23446
7233,23072423,23073284,False,1,861
7234,23077066,23104356,True,1,27290
7235,23078723,23080607,False,1,1884
7236,23078723,23100339,True,1,21616
7237,23089055,23090199,True,1,1144
7238,23092795,23093128,True,3,333
7239,23092986,23093315,True,1,329
7240,23093582,23093773,True,1,191
7241,23109026,23110461,True,1,1435
7242,23123191,23123779,True,1,588
7243,23123529,23125137,True,1,1608
7244,23123529,23127079,True,1,3550
7245,23127813,23130065,True,1,2252
7246,23127834,23130065,True,1,2231
7247,23131801,23171787,True,1,39986
7248,23171149,23172251,False,1,1102
7249,23171149,23172251,True,6,1102
7250,23188915,23189096,True,1,181
7251,23197844,23198347,True,6,503
7252,23213762,23245753,False,1,31991
7253,23233973,23235000,True,4,1027
7254,23254471,23254852,True,1,381
7255,23254471,23256124,True,1,1653
7256,23254471,23264276,True,1,9805
7257,23255015,23256124,True,1,1109
7258,23285178,23287138,True,1,1960
7259,23285178,23288964,True,3,3786
7260,23299383,23299686,True,2,303
7261,23299383,23301467,True,1,2084
7262,23300730,23330879,True,1,30149
7263,23306601,23319382,True,1,12781
7264,23320629,23321018,True,1,389
7265,23320629,23326490,True,2,5861
7266,23320629,23327363,True,1,6734
7267,23320677,23343844,True,1,23167
7268,23321366,23326933,True,1,5567
7269,23321547,23326821,True,1,5274
7270,23321857,23327131,False,1,5274
7271,23328482,23328681,True,2,199
7272,23331277,23331752,True,1,475
7273,23332624,23333398,True,1,774
7274,23333651,23333826,True,1,175
7275,23340706,23343214,False,1,2508
7276,23348621,23370819,True,1,22198
7277,23360313,23376657,True,1,16344
7278,23365768,23385402,True,1,19634
7279,23365793,23379431,True,1,13638
7280,23371541,23372530,True,4,989
7281,23375546,23375820,True,1,274
7282,23378951,23441863,True,1,62912
7283,23402257,23403485,False,1,1228
7284,23402764,23403201,True,8,437
7285,23406503,23407012,True,1,509
7286,23416679,23433574,True,1,16895
7287,23417302,23417559,True,2,257
7288,23418425,23418977,False,1,552
7289,23428632,23431427,False,1,2795
7290,23428632,23437467,False,1,8835
7291,23428632,23437467,True,2,8835
7292,23429069,23430292,True,1,1223
7293,23429922,23430296,True,1,374
7294,23429922,23430774,True,4,852
7295,23429922,23430908,True,1,986
7296,23448461,23452860,True,1,4399
7297,23457438,23461281,True,1,3843
7298,23469409,23469673,True,3,264
7299,23501301,23505642,False,1,4341
7300,23502977,23503799,True,1,822
7301,23503175,23503799,True,1,624
7302,23503690,23518084,True,1,14394
7303,23504762,23505035,True,1,273
7304,23504886,23505003,True,1,117
7305,23524684,23532117,True,1,7433
7306,23546635,23550961,True,2,4326
7307,23552761,23554187,True,3,1426
7308,23553600,23554618,True,1,1018
7309,23555728,23556254,True,1,526
7310,23556768,23556860,True,1,92
7311,23569100,23573701,False,1,4601
7312,23569100,23573701,True,1,4601
7313,23569803,23578171,True,1,8368
7314,23572707,23573119,True,1,412
7315,23575552,23577790,True,1,2238
7316,23592433,23601999,True,4,9566
7317,23592433,23603636,True,1,11203
7318,23597151,23598470,True,1,1319
7319,23605881,23708169,True,1,102288
7320,23635558,23671584,True,1,36026
7321,23648988,23650373,False,1,1385
7322,23663072,23663497,True,1,425
7323,23663973,23681223,False,1,17250
7324,23663973,23682907,True,1,18934
7325,23664454,23667628,True,1,3174
7326,23666236,23667086,True,2,850
7327,23666236,23668093,True,1,1857
7328,23679722,23681757,True,1,2035
7329,23679925,23682107,True,1,2182
7330,23689803,23690964,False,1,1161
7331,23689803,23690964,True,3,1161
7332,23696741,23697048,True,3,307
7333,23698136,23699756,True,1,1620
7334,23700318,23702377,True,1,2059
7335,23703119,23705189,True,1,2070
7336,23715220,23719828,True,1,4608
7337,23726123,23726397,False,1,274
7338,23726123,23726791,False,1,668
7339,23726740,23758314,True,1,31574
7340,23726740,23764691,True,1,37951
7341,23726740,23768981,True,1,42241
7342,23729124,23745932,True,1,16808
7343,23729227,23745932,True,1,16705
7344,23730865,23759390,True,1,28525
7345,23732558,23733338,True,7,780
7346,23742525,23743381,False,1,856
7347,23743078,23770456,True,1,27378
7348,23749101,23755170,False,1,6069
7349,23755825,23766238,True,2,10413
7350,23762822,23767373,True,3,4551
7351,23763028,23763613,False,1,585
7352,23768097,23768347,False,3,250
7353,23768097,23769144,True,3,1047
7354,23772733,23772823,True,1,90
7355,23773518,23792378,True,1,18860
7356,23785361,23790868,False,1,5507
7357,23797195,23797516,True,2,321
7358,23797813,23798296,True,1,483
7359,23800088,23800381,True,1,293
7360,23800182,23800288,True,1,106
7361,23800803,23801459,False,1,656
7362,23800803,23801485,False,4,682
7363,23800953,23801485,False,1,532
7364,23811837,23812934,True,1,1097
7365,23818932,23824745,True,1,5813
7366,23827845,23829180,True,1,1335
7367,23827845,23835868,True,1,8023
7368,23835248,23835789,True,1,541
7369,23843976,23851094,True,1,7118
7370,23848452,23859715,True,1,11263
7371,23848452,23882338,True,1,33886
7372,23850371,23866202,True,1,15831
7373,23854492,23855710,True,1,1218
7374,23860024,23861604,True,3,1580
7375,23867393,23869101,False,1,1708
7376,23893998,23908742,True,1,14744
7377,23919323,23936928,True,1,17605
7378,23919722,23921777,True,1,2055
7379,23925326,23933882,True,3,8556
7380,23929012,23931600,True,3,2588
7381,23943939,23945152,True,1,1213
7382,23946268,23957773,True,1,11505
7383,23946268,23971992,True,1,25724
7384,23947124,23952784,False,1,5660
7385,23947124,23976436,False,1,29312
7386,23953989,23954193,True,1,204
7387,23960033,23962335,True,1,2302
7388,23963190,23980477,True,2,17287
7389,23963190,23980485,True,1,17295
7390,23965777,23967491,True,1,1714
7391,23970775,23971896,True,4,1121
7392,23972212,23973291,True,1,1079
7393,23988143,23991124,True,1,2981
7394,23989635,23999300,True,1,9665
7395,23989635,24002754,True,1,13119
7396,23997470,24013097,True,1,15627
7397,24025522,24028480,True,1,2958
7398,24045260,24290584,True,1,245324
7399,24062194,24062857,True,1,663
7400,24071970,24073269,True,1,1299
7401,24071970,24093867,True,1,21897
7402,24071970,24093876,True,1,21906
7403,24071970,24123733,True,1,51763
7404,24080778,24082262,True,1,1484
7405,24080778,24089457,True,1,8679
7406,24080827,24082353,True,2,1526
7407,24080827,24082495,False,4,1668
7408,24080827,24082495,True,3,1668
7409,24092027,24092029,True,2,2
7410,24118274,24119013,True,2,739
7411,24118274,24120388,True,1,2114
7412,24141271,24163753,True,2,22482
7413,24151894,24163710,True,1,11816
7414,24151894,24163719,True,1,11825
7415,24151894,24164797,True,1,12903
7416,24158907,24160998,True,1,2091
7417,24188081,24189015,True,1,934
7418,24197069,24211018,False,1,13949
7419,24222101,24234384,True,1,12283
7420,24231313,24275477,True,1,44164
7421,24246225,24251120,False,1,4895
7422,24247151,24267952,True,1,20801
7423,24247151,24280589,True,1,33438
7424,24253012,24254220,True,2,1208
7425,24264410,24292072,True,3,27662
7426,24294606,24295124,False,1,518
7427,24309363,24310030,True,1,667
7428,24310643,24311800,True,1,1157
7429,24313715,24516242,True,1,202527
7430,24313715,24673381,True,1,359666
7431,24319947,24343560,True,1,23613
7432,24337122,24344236,True,1,7114
7433,24343432,24346877,False,2,3445
7434,24343432,24346877,True,3,3445
7435,24351236,24360389,True,2,9153
7436,24367591,24409420,True,2,41829
7437,24372066,24372195,True,2,129
7438,24380247,24382791,True,1,2544
7439,24389779,24390392,True,1,613
7440,24401950,24402728,False,1,778
7441,24405685,24407525,False,1,1840
7442,24406362,24407726,True,1,1364
7443,24406362,24424195,True,1,17833
7444,24416325,24420010,True,1,3685
7445,24419382,24422286,True,1,2904
7446,24439598,24445273,False,1,5675
7447,24447948,24456108,True,1,8160
7448,24448990,24456632,True,2,7642
7449,24450357,24469779,False,1,19422
7450,24454285,24475910,False,1,21625
7451,24454285,24475910,True,1,21625
7452,24454285,24478071,True,1,23786
7453,24458957,24460313,True,1,1356
7454,24464904,24472377,False,1,7473
7455,24476278,24478662,True,2,2384
7456,24486967,24488480,True,4,1513
7457,24488453,24489119,True,1,666
7458,24490621,24490712,False,1,91
7459,24501715,24508607,False,1,6892
7460,24501898,24504672,True,1,2774
7461,24501898,24505280,True,1,3382
7462,24502134,24504448,False,1,2314
7463,24508737,24517139,True,1,8402
7464,24509314,24517181,False,1,7867
7465,24509314,24517181,True,1,7867
7466,24512747,24513916,True,2,1169
7467,24522114,24523567,False,1,1453
7468,24543314,24546457,True,1,3143
7469,24545580,24546243,True,1,663
7470,24547892,24570469,True,1,22577
7471,24547892,24570798,True,1,22906
7472,24548373,24551516,True,1,3143
7473,24566621,24568145,False,1,1524
7474,24566621,24568145,True,1,1524
7475,24566621,24568287,False,4,1666
7476,24566621,24568287,True,3,1666
7477,24580289,24584358,True,2,4069
7478,24581454,24583100,True,3,1646
7479,24581454,24583103,True,1,1649
7480,24589740,24590192,False,3,452
7481,24611787,24623974,False,1,12187
7482,24611787,24653732,False,1,41945
7483,24616604,24616940,False,1,336
7484,24616604,24616940,True,2,336
7485,24617033,24619179,True,1,2146
7486,24617157,24622134,True,1,4977
7487,24658157,24682860,True,1,24703
7488,24658724,24666280,True,1,7556
7489,24658867,24683225,True,1,24358
7490,24658867,24750549,True,1,91682
7491,24661068,24684312,True,2,23244
7492,24661068,24751636,False,1,90568
7493,24671594,24672685,False,1,1091
7494,24673976,24675435,True,1,1459
7495,24676781,24693427,False,1,16646
7496,24707830,24775079,True,1,67249
7497,24717950,24719248,False,2,1298
7498,24741331,24743597,False,1,2266
7499,24741331,24743597,True,2,2266
7500,24743192,24743378,True,1,186
7501,24767502,24768410,True,2,908
7502,24783491,24986804,True,2,203313
7503,24786173,24814201,True,2,28028
7504,24791161,24832922,False,1,41761
7505,24798355,24894315,True,2,95960
7506,24803630,24805610,True,1,1980
7507,24815900,24828216,True,2,12316
7508,24839687,24915077,True,1,75390
7509,24840679,24841724,True,1,1045
7510,24842632,24844021,False,1,1389
7511,24855480,24856245,False,1,765
7512,24858950,24860387,True,1,1437
7513,24860129,24860246,True,1,117
7514,24896405,24898762,False,1,2357
7515,24896405,24898762,True,4,2357
7516,24905283,24906003,True,1,720
7517,24906678,24941159,False,1,34481
7518,24906678,24947040,False,1,40362
7519,24922316,24923006,True,2,690
7520,24939830,24945021,True,1,5191
7521,24966109,24973569,True,3,7460
7522,24982202,24983385,True,1,1183
7523,25003847,25004242,True,1,395
7524,25018080,25018201,False,1,121
7525,25020462,25024157,True,1,3695
7526,25020462,25098579,True,1,78117
7527,25051946,25057211,True,2,5265
7528,25052136,25057290,True,1,5154
7529,25052388,25057290,True,3,4902
7530,25083313,25083708,True,1,395
7531,25138766,25177649,True,2,38883
7532,25148544,25149271,True,3,727
7533,25150132,25170775,False,1,20643
7534,25150132,25286276,False,1,136144
7535,25160168,25162639,True,3,2471
7536,25163211,25164636,True,1,1425
7537,25192542,25206275,True,1,13733
7538,25197187,25208884,True,1,11697
7539,25197187,25210080,True,1,12893
7540,25220813,25227889,False,1,7076
7541,25220813,25227889,True,1,7076
7542,25247383,25249767,True,1,2384
7543,25247674,25248807,False,1,1133
7544,25247674,25259331,False,1,11657
7545,25251255,25251443,True,3,188
7546,25256391,25260692,True,2,4301
7547,25257164,25259370,True,2,2206
7548,25258345,25273284,True,1,14939
7549,25274913,25275299,True,1,386
7550,25278423,25279532,True,1,1109
7551,25280824,25317287,True,1,36463
7552,25281244,25296547,False,1,15303
7553,25295252,25296733,True,1,1481
7554,25303677,25327221,False,1,23544
7555,25316533,25316762,False,1,229
7556,25317509,25365284,True,1,47775
7557,25324122,25335339,True,1,11217
7558,25346127,25347158,True,2,1031
7559,25361487,25366919,True,1,5432
7560,25379457,25380581,True,1,1124
7561,25386036,25491083,False,1,105047
7562,25386036,25491083,True,5,105047
7563,25386863,25387295,True,1,432
7564,25392349,25392922,True,1,573
7565,25397955,25398618,True,1,663
7566,25406149,25409533,True,2,3384
7567,25409298,25415705,True,1,6407
7568,25434164,25434775,True,3,611
7569,25435715,25436669,True,1,954
7570,25437213,25437470,True,1,257
7571,25443627,25444769,True,1,1142
7572,25443627,25456243,True,2,12616
7573,25443627,25457193,True,1,13566
7574,25453119,25454240,True,1,1121
7575,25453119,25454243,True,1,1124
7576,25454263,25454699,True,1,436
7577,25454263,25454702,True,1,439
7578,25512627,25552134,True,1,39507
7579,25512627,25628695,True,1,116068
7580,25514867,25515366,True,2,499
7581,25529951,25553539,True,1,23588
7582,25551037,25596394,True,1,45357
7583,25551683,25552443,True,3,760
7584,25552464,25555592,True,1,3128
7585,25552464,25557000,True,1,4536
7586,25555423,25556937,False,1,1514
7587,25555423,25556937,True,1,1514
7588,25558119,25558212,True,1,93
7589,25561223,25561305,True,1,82
7590,25571319,25579857,True,2,8538
7591,25571319,25587443,True,1,16124
7592,25573277,25573359,False,1,82
7593,25573277,25573359,True,3,82
7594,25575946,25576024,False,1,78
7595,25581144,25585422,False,1,4278
7596,25586784,25594267,True,1,7483
7597,25598272,25599015,False,1,743
7598,25599833,25599913,True,1,80
7599,25600000,25600080,True,1,80
7600,25606320,25606514,True,1,194
7601,25606657,25651523,True,1,44866
7602,25612651,25621810,True,2,9159
7603,25619211,25626797,True,2,7586
7604,25622064,25622145,True,4,81
7605,25629398,25651277,True,2,21879
7606,25634843,25644676,True,1,9833
7607,25670280,25670667,True,1,387
7608,25676457,25683155,True,2,6698
7609,25682067,25688592,False,1,6525
7610,25683335,25683609,True,1,274
7611,25694898,25699840,True,1,4942
7612,25696785,25697628,True,1,843
7613,25699549,25733462,False,1,33913
7614,25703168,25704895,True,1,1727
7615,25714133,25720381,True,1,6248
7616,25715700,25720381,True,1,4681
7617,25726964,25727478,True,1,514
7618,25739887,25748036,True,1,8149
7619,25740074,25748287,True,1,8213
7620,25741549,25742058,True,1,509
7621,25748061,25748156,True,2,95
7622,25754165,25757289,True,3,3124
7623,25757880,25758079,True,1,199
7624,25757880,25818691,True,1,60811
7625,25769828,25771573,True,1,1745
7626,25770443,25770799,True,1,356
7627,25791290,25791930,True,7,640
7628,25802378,25803539,True,1,1161
7629,25802643,25803804,True,1,1161
7630,25815583,25815792,True,1,209
7631,25815613,25818304,True,1,2691
7632,25833942,25835778,True,1,1836
7633,25835041,25835247,True,1,206
7634,25843039,25845242,False,1,2203
7635,25849566,25853161,True,1,3595
7636,25849566,25861899,True,1,12333
7637,25873037,25873877,True,7,840
7638,25873770,25873877,True,1,107
7639,25877168,25878381,True,1,1213
7640,25878958,25880705,True,1,1747
7641,25879303,25978960,False,1,99657
7642,25879303,25978960,True,1,99657
7643,25879303,26029308,False,1,150005
7644,25879303,26078828,False,1,199525
7645,25879474,25882812,True,1,3338
7646,25881391,25881391,True,1,0
7647,25881563,25888388,True,1,6825
7648,25884311,25884668,True,4,357
7649,25896213,25899834,True,2,3621
7650,25898727,25900516,True,1,1789
7651,25902607,25903062,True,1,455
7652,25906031,25907141,True,1,1110
7653,25932528,25933203,True,4,675
7654,25952956,25953935,True,1,979
7655,25973201,25975218,True,2,2017
7656,25979658,26019217,True,2,39559
7657,25982796,25990778,True,2,7982
7658,25986512,25987588,True,1,1076
7659,25991110,25991365,True,1,255
7660,25991960,25997810,True,1,5850
7661,25991960,26006019,True,1,14059
7662,25997367,25999113,True,1,1746
7663,25997367,26109445,True,1,112078
7664,26003626,26012081,False,1,8455
7665,26003958,26004025,True,5,67
7666,26020092,26020709,True,1,617
7667,26059662,26060123,False,2,461
7668,26059662,26060123,True,1,461
7669,26066983,26068246,True,2,1263
7670,26071377,26071762,True,1,385
7671,26088553,26105130,True,1,16577
7672,26096271,26097139,False,1,868
7673,26098997,26099359,True,1,362
7674,26107872,26110268,True,1,2396
7675,26110357,26111660,True,1,1303
7676,26112475,26113360,True,1,885
7677,26113461,26115287,True,4,1826
7678,26130309,26132644,True,1,2335
7679,26144363,26234856,True,1,90493
7680,26146191,26160021,True,1,13830
7681,26151979,26156294,True,1,4315
7682,26161121,26164524,True,1,3403
7683,26179018,26181828,False,1,2810
7684,26187491,26188901,True,1,1410
7685,26212812,26214635,True,9,1823
7686,26213261,26242416,True,1,29155
7687,26215066,26228068,False,1,13002
7688,26217912,26219657,True,1,1745
7689,26230579,26234745,True,1,4166
7690,26256211,26267882,True,1,11671
7691,26265592,26265702,False,1,110
7692,26269632,26270617,True,1,985
7693,26270887,26271226,True,1,339
7694,26270892,26271227,True,1,335
7695,26272142,26319635,True,1,47493
7696,26284383,26292217,True,4,7834
7697,26284383,26293191,True,2,8808
7698,26306795,26314407,False,1,7612
7699,26324926,26413175,True,1,88249
7700,26367012,26367222,True,1,210
7701,26392344,26393036,False,1,692
7702,26394688,26405797,True,1,11109
7703,26404978,26453566,True,1,48588
7704,26407159,26409679,True,3,2520
7705,26409140,26419881,False,1,10741
7706,26420389,26421310,True,1,921
7707,26431598,26436925,False,1,5327
7708,26431608,26431792,True,4,184
7709,26432500,26434466,True,1,1966
7710,26436822,26437695,False,1,873
7711,26437715,26496830,True,1,59115
7712,26458369,26475113,True,1,16744
7713,26474647,26476554,True,7,1907
7714,26475772,26475852,True,1,80
7715,26493537,26543323,False,1,49786
7716,26510171,26510260,True,3,89
7717,26510356,26510447,True,1,91
7718,26522647,26525037,True,1,2390
7719,26527966,26535375,True,1,7409
7720,26534840,26572065,True,1,37225
7721,26550860,26556739,False,1,5879
7722,26556290,26665441,True,1,109151
7723,26560914,26561185,True,1,271
7724,26598794,26630856,True,6,32062
7725,26610602,26611811,True,5,1209
7726,26636117,26636823,True,4,706
7727,26636122,26636823,True,5,701
7728,26640149,26642769,True,2,2620
7729,26640272,26645962,True,1,5690
7730,26657601,26658607,True,1,1006
7731,26657631,26657743,False,1,112
7732,26699407,26714002,True,2,14595
7733,26699407,26716214,True,1,16807
7734,26706790,26706958,False,1,168
7735,26713134,26727934,True,1,14800
7736,26717017,26718306,True,1,1289
7737,26719714,26724685,True,1,4971
7738,26720793,26723438,True,1,2645
7739,26720793,26724270,True,4,3477
7740,26720793,26729786,True,1,8993
7741,26729480,26771726,True,1,42246
7742,26729480,26849827,True,1,120347
7743,26729480,26850454,True,1,120974
7744,26739620,26740839,True,1,1219
7745,26739620,26742763,True,1,3143
7746,26739620,26747513,False,1,7893
7747,26739620,26747513,True,1,7893
7748,26741134,26768128,True,1,26994
7749,26742666,26746693,True,1,4027
7750,26743108,26747337,True,1,4229
7751,26751842,26752618,True,1,776
7752,26757067,26758403,True,1,1336
7753,26774189,26775102,True,2,913
7754,26775100,26825580,True,1,50480
7755,26786655,26786753,True,2,98
7756,26794467,26795248,True,1,781
7757,26799140,26902851,True,1,103711
7758,26814810,26822774,True,1,7964
7759,26820243,26834268,False,1,14025
7760,26820243,26834268,True,3,14025
7761,26840704,26843069,True,1,2365
7762,26842428,26845160,True,1,2732
7763,26854278,26861950,True,2,7672
7764,26896021,26896971,True,1,950
7765,26927857,26972964,False,1,45107
7766,26940363,26941712,False,1,1349
7767,26940363,26955742,False,1,15379
7768,26940363,26956369,True,1,16006
7769,26949314,26950321,True,1,1007
7770,26961980,26969747,False,1,7767
7771,26961980,26969747,True,1,7767
7772,26966837,26972351,True,1,5514
7773,26972403,26977624,True,1,5221
7774,26990823,26991218,True,1,395
7775,27027813,27027915,True,1,102
7776,27032225,27038032,True,1,5807
7777,27042839,27043967,True,1,1128
7778,27043563,27044458,True,2,895
7779,27043789,27044587,True,1,798
7780,27049976,27052760,True,1,2784
7781,27057459,27057715,False,1,256
7782,27058435,27058688,False,1,253
7783,27086605,27088024,True,1,1419
7784,27142117,27148825,True,1,6708
7785,27147830,27185636,True,1,37806
7786,27149616,27154441,True,3,4825
7787,27149834,27154539,True,1,4705
7788,27175747,27195366,True,2,19619
7789,27175793,27195524,True,1,19731
7790,27181332,27202437,True,2,21105
7791,27195020,27201341,True,1,6321
7792,27207277,27209308,True,1,2031
7793,27215758,27216671,True,1,913
7794,27220819,27222052,True,1,1233
7795,27223825,27232876,True,1,9051
7796,27224235,27232576,True,2,8341
7797,27225281,27227691,False,1,2410
7798,27231414,27231500,True,1,86
7799,27242136,27264222,True,1,22086
7800,27242136,27265990,True,1,23854
7801,27244453,27247612,True,2,3159
7802,27258090,27268394,True,1,10304
7803,27258154,27285075,False,1,26921
7804,27259916,27262258,False,1,2342
7805,27260105,27260766,False,1,661
7806,27284022,27286754,True,1,2732
7807,27284512,27285112,True,1,600
7808,27313777,27316171,False,1,2394
7809,27330057,27335204,True,3,5147
7810,27330057,27344947,True,1,14890
7811,27330057,27389671,False,1,59614
7812,27342531,27344630,True,2,2099
7813,27342737,27344712,True,1,1975
7814,27358260,27359637,True,1,1377
7815,27360814,27373732,False,1,12918
7816,27362541,27365296,False,1,2755
7817,27374740,27379606,True,1,4866
7818,27380558,27406509,True,2,25951
7819,27382680,27391183,True,2,8503
7820,27384553,27421830,False,1,37277
7821,27387866,27390306,True,1,2440
7822,27390782,27392981,True,2,2199
7823,27390986,27391993,True,1,1007
7824,27414646,27429170,True,1,14524
7825,27414646,27434077,True,1,19431
7826,27416421,27420500,True,1,4079
7827,27431982,27434366,True,1,2384
7828,27432491,27432886,True,1,395
7829,27453431,27457327,True,2,3896
7830,27453431,27458176,True,2,4745
7831,27453431,27461164,False,1,7733
7832,27462984,27464481,True,3,1497
7833,27468452,27471643,True,1,3191
7834,27470207,27477506,True,1,7299
7835,27473907,27479712,True,1,5805
7836,27506033,27506196,False,1,163
7837,27506033,27506196,True,7,163
7838,27529011,27529334,True,1,323
7839,27531607,27533627,False,1,2020
7840,27531607,27533627,True,2,2020
7841,27577876,27578888,False,1,1012
7842,27577876,27578888,True,1,1012
7843,27580210,27583416,True,3,3206
7844,27584835,27586447,True,4,1612
7845,27604011,27640900,True,1,36889
7846,27660293,27660878,False,1,585
7847,27660293,27660878,True,2,585
7848,27685318,27685560,True,1,242
7849,27717520,27721172,True,1,3652
7850,27721001,27756108,True,1,35107
7851,27750870,27751019,True,2,149
7852,27767687,27797527,True,1,29840
7853,27770644,27770720,True,1,76
7854,27812888,27816805,True,1,3917
7855,27820846,27843917,True,2,23071
7856,27821597,27833081,True,1,11484
7857,27821597,27844427,True,1,22830
7858,27823067,27825315,False,1,2248
7859,27824100,27845632,True,2,21532
7860,27831567,27835253,True,1,3686
7861,27849479,27899115,True,1,49636
7862,27850351,27886806,True,1,36455
7863,27850351,27899536,True,1,49185
7864,27850351,27902235,True,1,51884
7865,27851020,27902561,True,1,51541
7866,27856029,27872341,False,1,16312
7867,27866496,27869863,False,1,3367
7868,27866567,27871216,False,1,4649
7869,27866567,27871216,True,12,4649
7870,27892046,27895077,True,1,3031
7871,27895518,27907255,True,2,11737
7872,27945683,27950356,True,3,4673
7873,27949672,27950186,False,1,514
7874,27952600,27959077,False,1,6477
7875,27952600,27959077,True,2,6477
7876,27957785,28083683,True,1,125898
7877,27968872,27988575,True,1,19703
7878,27976641,27979316,True,1,2675
7879,27986932,27987286,True,1,354
7880,27986932,27989939,True,1,3007
7881,28028242,28029899,True,2,1657
7882,28034269,28037589,True,3,3320
7883,28048095,28048195,True,1,100
7884,28052132,28063039,True,3,10907
7885,28052143,28053929,True,1,1786
7886,28053529,28068768,True,1,15239
7887,28058705,28058873,True,1,168
7888,28063489,28073383,True,2,9894
7889,28086267,28086688,True,4,421
7890,28118065,28157536,True,1,39471
7891,28118065,28163777,True,1,45712
7892,28126774,28128468,True,1,1694
7893,28141267,28141354,False,1,87
7894,28146017,28146145,True,1,128
7895,28151837,28171466,False,1,19629
7896,28151837,28171466,True,1,19629
7897,28151837,28175426,False,1,23589
7898,28151837,28175426,True,1,23589
7899,28153513,28154185,False,2,672
7900,28161438,28164004,True,1,2566
7901,28170166,28184260,True,2,14094
7902,28170166,28194837,True,1,24671
7903,28170166,28202278,True,2,32112
7904,28204929,28222857,True,1,17928
7905,28206349,28224288,True,1,17939
7906,28226058,28226925,False,1,867
7907,28227392,28241416,False,1,14024
7908,28227392,28242290,False,1,14898
7909,28227392,28253674,False,1,26282
7910,28235016,28235665,True,1,649
7911,28235943,28236043,True,2,100
7912,28250757,28263952,False,1,13195
7913,28278222,28280071,True,1,1849
7914,28278222,28280536,True,1,2314
7915,28278500,28278769,True,1,269
7916,28285335,28285747,True,1,412
7917,28287819,28414760,False,1,126941
7918,28287819,28414760,True,1,126941
7919,28308270,28311500,True,2,3230
7920,28330216,28330368,True,1,152
7921,28330417,28338340,True,2,7923
7922,28333144,28337349,True,1,4205
7923,28344777,28345399,True,1,622
7924,28358691,28362744,False,1,4053
7925,28358691,28362744,True,1,4053
7926,28367974,28454838,True,1,86864
7927,28368028,28370334,True,1,2306
7928,28368509,28369020,True,1,511
7929,28373536,28401135,True,2,27599
7930,28374306,28375435,True,3,1129
7931,28380761,28384146,True,2,3385
7932,28385263,28385722,True,1,459
7933,28398615,28398709,True,1,94
7934,28406555,28406944,True,2,389
7935,28409894,28452848,True,1,42954
7936,28416077,28416171,True,1,94
7937,28416545,28416633,True,1,88
7938,28432129,28433259,True,2,1130
7939,28440608,28443285,True,1,2677
7940,28461797,28462662,True,1,865
7941,28495998,28513925,False,1,17927
7942,28520975,28521491,True,2,516
7943,28561465,28584671,True,1,23206
7944,28586363,28590299,True,1,3936
7945,28588531,28598284,True,1,9753
7946,28600435,28602611,True,5,2176
7947,28605495,28606968,False,1,1473
7948,28612842,28614416,True,1,1574
7949,28612842,28622686,True,1,9844
7950,28676316,28676930,False,1,614
7951,28684205,28686984,True,1,2779
7952,28737155,28740228,False,1,3073
7953,28741185,28745009,False,1,3824
7954,28821231,28825307,False,2,4076
7955,28888430,28901993,False,2,13563
7956,28888430,28901993,True,4,13563
7957,28889385,28898790,False,1,9405
7958,28949864,28952646,False,2,2782
7959,28957345,28968475,False,1,11130
7960,28958477,28959124,True,3,647
7961,28984312,28991215,True,3,6903
7962,29008136,29169523,False,1,161387
7963,29023728,29025395,False,1,1667
7964,29023728,29025395,True,1,1667
7965,29030544,29030941,False,1,397
7966,29036213,29036507,True,1,294
7967,29037371,29095451,True,5,58080
7968,29039373,29039456,False,1,83
7969,29039373,29039456,True,2,83
7970,29041514,29041747,True,1,233
7971,29053215,29055621,True,2,2406
7972,29060185,29070299,True,4,10114
7973,29065952,29066967,False,1,1015
7974,29065952,29066967,True,1,1015
7975,29071548,29074697,True,1,3149
7976,29076580,29115087,True,2,38507
7977,29088519,29096118,True,1,7599
7978,29095060,29095487,True,2,427
7979,29095666,29097778,True,2,2112
7980,29098281,29099340,True,1,1059
7981,29102226,29103038,True,1,812
7982,29111214,29245813,True,1,134599
7983,29123863,29124424,False,1,561
7984,29123863,29124424,True,5,561
7985,29127403,29128096,True,1,693
7986,29128243,29129140,True,1,897
7987,29144458,29149004,True,1,4546
7988,29155101,29163963,True,1,8862
7989,29163957,29182962,True,1,19005
7990,29166915,29167466,True,1,551
7991,29177949,29178064,True,5,115
7992,29230164,29230703,True,1,539
7993,29252563,29252857,True,2,294
7994,29280901,29296302,True,1,15401
7995,29280901,29313713,True,3,32812
7996,29313484,29315690,True,1,2206
7997,29329868,29338531,True,1,8663
7998,29331867,29458749,True,3,126882
7999,29351260,29351349,True,1,89
8000,29353966,29354464,True,1,498
8001,29386637,29389183,True,2,2546
8002,29387577,29391761,False,1,4184
8003,29387910,29388062,False,1,152
8004,29387910,29388062,True,3,152
8005,29400813,29403412,True,1,2599
8006,29416327,29417889,True,1,1562
8007,29428095,29429331,False,1,1236
8008,29433364,29440280,True,2,6916
8009,29433364,29440385,True,2,7021
8010,29440115,29441893,True,1,1778
8011,29449856,29458567,True,1,8711
8012,29453542,29464796,True,1,11254
8013,29460333,29466352,True,3,6019
8014,29472256,29474808,False,2,2552
8015,29472256,29474808,True,2,2552
8016,29476596,29481789,True,1,5193
8017,29496877,29500801,False,1,3924
8018,29496877,29500801,True,2,3924
8019,29511179,29512307,True,1,1128
8020,29531792,29533366,True,1,1574
8021,29533010,29548424,True,1,15414
8022,29545870,29546875,True,1,1005
8023,29548934,29550866,False,1,1932
8024,29550982,29564652,True,1,13670
8025,29598049,29600264,True,1,2215
8026,29601344,29604873,True,2,3529
8027,29601831,29605130,False,1,3299
8028,29601831,29605130,True,2,3299
8029,29611153,29615468,True,1,4315
8030,29627143,29633724,True,1,6581
8031,29627143,29634478,False,1,7335
8032,29642796,29653840,False,1,11044
8033,29654919,29657011,True,1,2092
8034,29674435,29674759,True,1,324
8035,29689401,29693716,True,1,4315
8036,29690564,29697738,True,5,7174
8037,29705202,29706534,True,1,1332
8038,29709023,29711469,True,1,2446
8039,29723407,29728726,True,2,5319
8040,29723407,29728741,True,1,5334
8041,29723571,29766101,True,2,42530
8042,29723631,29724151,True,2,520
8043,29724730,29725386,False,1,656
8044,29730138,29733638,False,1,3500
8045,29760616,29762060,True,4,1444
8046,29772261,29795605,False,1,23344
8047,29783185,29783335,True,1,150
8048,29799398,29800213,False,1,815
8049,29799398,29800213,True,2,815
8050,29803995,29809001,True,1,5006
8051,29806991,29814255,True,1,7264
8052,29823976,29898427,False,1,74451
8053,29833213,29834777,True,1,1564
8054,29841699,29844278,True,2,2579
8055,29841699,29859624,True,1,17925
8056,29841823,29844361,True,2,2538
8057,29842024,29859741,True,1,17717
8058,29843329,29844543,False,1,1214
8059,29847672,29862825,True,1,15153
8060,29850931,30212390,True,2,361459
8061,29855179,29855492,False,1,313
8062,29855515,29859904,True,1,4389
8063,29868709,29868822,False,1,113
8064,29877159,29883977,True,1,6818
8065,29879843,29881294,True,1,1451
8066,29881538,29901962,True,1,20424
8067,29900199,29902057,False,1,1858
8068,29900199,29910605,True,10,10406
8069,29913190,29932349,True,1,19159
8070,29917213,29924641,True,1,7428
8071,29923846,29924670,True,1,824
8072,29930047,29934992,False,1,4945
8073,29957155,29957529,False,1,374
8074,29964640,29975621,True,1,10981
8075,29964640,29976258,True,1,11618
8076,29964640,29978146,False,1,13506
8077,29965567,29969939,True,1,4372
8078,29971946,29972877,False,1,931
8079,29971946,29972900,False,1,954
8080,29971946,29972904,False,1,958
8081,29971946,29973529,False,1,1583
8082,29971946,29973803,False,1,1857
8083,29975253,29976595,False,1,1342
8084,29976861,29977432,False,1,571
8085,29976861,29977432,True,1,571
8086,29978648,30034616,True,2,55968
8087,29979762,29980698,True,2,936
8088,29986899,29990484,False,1,3585
8089,29987380,29989195,True,1,1815
8090,30002993,30009874,True,1,6881
8091,30010256,30013224,True,6,2968
8092,30032343,30032862,True,1,519
8093,30033590,30036144,True,4,2554
8094,30035341,30037061,True,1,1720
8095,30040000,30040092,True,1,92
8096,30042279,30043299,False,1,1020
8097,30062661,30066966,True,1,4305
8098,30069328,30070018,True,2,690
8099,30114540,30115971,True,1,1431
8100,30122046,30124582,True,3,2536
8101,30134691,30135396,True,1,705
8102,30137259,30160206,True,1,22947
8103,30137504,30147048,True,1,9544
8104,30137909,30160440,True,6,22531
8105,30145281,30147253,True,2,1972
8106,30149993,30153933,True,1,3940
8107,30171879,30175017,True,2,3138
8108,30182160,30185603,True,1,3443
8109,30184158,30184903,True,1,745
8110,30184158,30190892,True,1,6734
8111,30190354,30191399,True,2,1045
8112,30190604,30192657,True,1,2053
8113,30228016,30228690,True,2,674
8114,30238075,30238161,True,1,86
8115,30243745,30246020,True,1,2275
8116,30244547,30248478,True,1,3931
8117,30251975,30256859,True,1,4884
8118,30263776,30264138,True,3,362
8119,30267492,30275881,True,3,8389
8120,30268080,30304643,True,1,36563
8121,30273032,30307157,True,1,34125
8122,30276247,30276467,True,1,220
8123,30278586,30283393,True,1,4807
8124,30278586,30284480,True,1,5894
8125,30278943,30283393,True,1,4450
8126,30278943,30284480,True,1,5537
8127,30298984,30299469,True,3,485
8128,30309640,30310929,True,3,1289
8129,30320746,30323305,True,1,2559
8130,30340803,30344149,True,1,3346
8131,30341423,30367932,True,4,26509
8132,30342948,30345856,True,7,2908
8133,30355181,30388087,True,1,32906
8134,30373617,30374551,True,1,934
8135,30376098,30377538,True,2,1440
8136,30381211,30381737,False,1,526
8137,30396984,30397773,False,1,789
8138,30396984,30397773,True,1,789
8139,30413914,30418321,False,1,4407
8140,30414597,30419107,True,1,4510
8141,30431206,30431794,False,1,588
8142,30433127,30435359,True,1,2232
8143,30436545,30438078,True,1,1533
8144,30436545,30438279,True,1,1734
8145,30441189,30441765,True,1,576
8146,30441978,30442067,True,2,89
8147,30452025,30452159,True,1,134
8148,30453540,30453696,False,1,156
8149,30467543,30467627,True,1,84
8150,30480926,30645079,True,1,164153
8151,30491571,30620079,True,1,128508
8152,30493020,30620551,True,1,127531
8153,30495836,30501341,True,1,5505
8154,30496422,30496786,False,1,364
8155,30498280,30623431,True,1,125151
8156,30501692,30537802,True,1,36110
8157,30510243,30511636,True,1,1393
8158,30512835,30543473,True,1,30638
8159,30523166,30524991,True,3,1825
8160,30524860,30528911,True,3,4051
8161,30524860,30528972,True,1,4112
8162,30533861,30535354,True,1,1493
8163,30542968,30543717,True,1,749
8164,30545083,30559592,True,1,14509
8165,30574550,30648422,True,1,73872
8166,30577236,30577967,True,1,731
8167,30593672,30594220,True,3,548
8168,30594803,30595829,False,1,1026
8169,30601581,30605831,False,1,4250
8170,30601581,30605831,True,3,4250
8171,30614478,30626141,False,1,11663
8172,30614478,30626141,True,3,11663
8173,30627669,30629050,False,1,1381
8174,30632278,30633453,False,1,1175
8175,30676202,30676309,True,2,107
8176,30677466,30680357,True,5,2891
8177,30677466,30680712,True,1,3246
8178,30680848,30682854,True,3,2006
8179,30680848,30745741,True,1,64893
8180,30683390,30778917,True,1,95527
8181,30693167,30709355,True,1,16188
8182,30697556,30697852,True,1,296
8183,30699945,30701088,False,1,1143
8184,30717947,30722807,True,1,4860
8185,30722020,30723138,True,7,1118
8186,30722020,30723153,False,5,1133
8187,30722020,30723153,True,28,1133
8188,30722020,30732414,True,6,10394
8189,30728093,30728996,False,1,903
8190,30728093,30728996,True,1,903
8191,30728399,30728766,True,1,367
8192,30733948,30734647,True,1,699
8193,30752567,30813532,True,1,60965
8194,30795672,30878182,True,2,82510
8195,30799659,30856010,False,2,56351
8196,30802336,30811541,True,1,9205
8197,30806161,30811228,True,2,5067
8198,30812123,30854674,True,1,42551
8199,30819116,30820223,True,24,1107
8200,30845972,30846686,False,1,714
8201,30845972,30846686,True,2,714
8202,30855973,30857556,True,1,1583
8203,30859358,30866986,True,1,7628
8204,30870161,30870346,False,5,185
8205,30870161,30870346,True,28,185
8206,30870217,30870380,True,12,163
8207,30870229,30870414,True,5,185
8208,30871074,30871913,False,1,839
8209,30882613,30883131,False,2,518
8210,30884168,30889390,True,1,5222
8211,30895657,30914323,True,1,18666
8212,30904320,30906902,True,2,2582
8213,30912301,30912883,True,1,582
8214,30915353,30915408,True,1,55
8215,30915406,30916764,True,1,1358
8216,30929642,30930808,True,2,1166
8217,30930512,30934107,True,2,3595
8218,30938452,30940481,True,2,2029
8219,30941870,30943269,True,2,1399
8220,30941950,30943269,True,1,1319
8221,30943169,30946332,True,2,3163
8222,30943169,30949025,True,3,5856
8223,30943447,30944196,False,1,749
8224,30944916,30945202,True,1,286
8225,30950925,31112096,True,3,161171
8226,30952301,30972864,True,1,20563
8227,30958307,31016011,True,1,57704
8228,30958307,31020416,True,1,62109
8229,30960678,31017212,True,2,56534
8230,30960678,31021617,True,1,60939
8231,30961798,30963172,True,1,1374
8232,30962535,30998076,False,1,35541
8233,30962535,30998076,True,6,35541
8234,30962535,31016872,True,1,54337
8235,30964915,31008834,True,1,43919
8236,30979674,30984252,True,1,4578
8237,30979674,30991289,True,1,11615
8238,30982099,30982184,False,1,85
8239,30982099,30982184,True,2,85
8240,30984517,30988625,True,2,4108
8241,30984517,30991802,True,1,7285
8242,30984859,30986973,True,3,2114
8243,30985209,30987323,False,1,2114
8244,30985209,30987323,True,1,2114
8245,30993459,30994710,True,1,1251
8246,31001126,31116394,True,1,115268
8247,31021914,31022348,True,1,434
8248,31022893,31022974,True,1,81
8249,31037962,31045365,True,1,7403
8250,31046481,31047786,True,4,1305
8251,31048700,31057269,True,2,8569
8252,31050962,31051896,True,1,934
8253,31056940,31137484,True,1,80544
8254,31059526,31060742,False,1,1216
8255,31063791,31066210,True,3,2419
8256,31066363,31067309,True,3,946
8257,31077241,31078062,False,1,821
8258,31079281,31081979,False,1,2698
8259,31105829,31116845,True,2,11016
8260,31106396,31117070,True,2,10674
8261,31118330,31120374,True,2,2044
8262,31125186,31125291,True,1,105
8263,31126061,31126351,True,1,290
8264,31128102,31135595,True,1,7493
8265,31147658,31152032,True,2,4374
8266,31159019,31159897,True,1,878
8267,31159291,31161300,True,2,2009
8268,31160837,31162796,True,1,1959
8269,31177068,31180337,True,1,3269
8270,31177068,31180347,True,1,3279
8271,31177068,31181881,True,1,4813
8272,31192355,31205282,True,1,12927
8273,31202167,31222756,False,1,20589
8274,31204643,31207102,True,6,2459
8275,31205981,31206250,True,2,269
8276,31205981,31206337,True,1,356
8277,31207008,31207792,True,1,784
8278,31213428,31219893,True,5,6465
8279,31227672,31240508,True,1,12836
8280,31238729,31253837,True,1,15108
8281,31271288,31273832,False,1,2544
8282,31271288,31273832,True,2,2544
8283,31286416,31320068,True,1,33652
8284,31286655,31314761,True,1,28106
8285,31286655,31320183,True,1,33528
8286,31287292,31320404,True,1,33112
8287,31291690,31303123,True,1,11433
8288,31292597,31298034,False,1,5437
8289,31292597,31298034,True,2,5437
8290,31292597,31305988,True,1,13391
8291,31303072,31317205,True,1,14133
8292,31309354,31323445,False,1,14091
8293,31336297,31336436,False,1,139
8294,31336615,31339808,True,1,3193
8295,31343264,31343488,True,1,224
8296,31343930,31351282,True,1,7352
8297,31361136,31523888,True,1,162752
8298,31366875,31371208,True,1,4333
8299,31369065,31371258,True,1,2193
8300,31375943,31376411,False,1,468
8301,31379019,31380934,True,4,1915
8302,31386117,31386849,True,1,732
8303,31398919,31401303,True,4,2384
8304,31409527,31411708,True,1,2181
8305,31414488,31414921,False,1,433
8306,31415492,31423214,False,1,7722
8307,31418557,31420360,False,1,1803
8308,31420806,31426146,True,4,5340
8309,31438055,31438700,False,1,645
8310,31452119,31452453,True,3,334
8311,31453684,31454239,True,2,555
8312,31458812,31461558,True,1,2746
8313,31463817,31467011,True,1,3194
8314,31463817,31469241,True,1,5424
8315,31463817,31471535,True,1,7718
8316,31473165,31488755,True,1,15590
8317,31474907,31480326,True,1,5419
8318,31488233,31502673,True,1,14440
8319,31489045,31489781,True,1,736
8320,31490041,31491407,True,2,1366
8321,31503445,31503929,True,1,484
8322,31503461,31503929,True,3,468
8323,31504618,31506910,True,1,2292
8324,31512886,31524503,True,1,11617
8325,31517310,31519733,True,1,2423
8326,31521889,31524166,True,1,2277
8327,31529937,31531731,True,2,1794
8328,31547438,31549164,True,4,1726
8329,31560200,31598062,False,1,37862
8330,31560200,31598062,True,1,37862
8331,31561983,31565614,True,1,3631
8332,31563496,31581386,False,1,17890
8333,31566510,31566801,True,1,291
8334,31567772,31568164,True,3,392
8335,31580163,31581939,False,1,1776
8336,31594971,31599649,True,3,4678
8337,31594971,31605755,True,2,10784
8338,31605255,31605545,True,1,290
8339,31615688,31615769,True,1,81
8340,31617232,31617628,True,1,396
8341,31631761,31632549,True,1,788
8342,31637425,31638280,True,5,855
8343,31637819,31639089,True,1,1270
8344,31641314,31644326,True,2,3012
8345,31661896,31661971,False,1,75
8346,31687212,31690273,True,1,3061
8347,31689423,31690241,True,1,818
8348,31689423,31702546,True,1,13123
8349,31689423,31707428,True,1,18005
8350,31697127,31726221,True,1,29094
8351,31699015,31712824,True,1,13809
8352,31701316,31713686,True,1,12370
8353,31702746,31714599,True,1,11853
8354,31706804,31708932,True,2,2128
8355,31706804,31714081,True,1,7277
8356,31715983,31728309,True,3,12326
8357,31741373,31741766,False,1,393
8358,31747900,31776853,True,1,28953
8359,31759469,31771395,True,1,11926
8360,31760284,31760769,False,1,485
8361,31761101,31761230,True,1,129
8362,31761351,31764226,True,1,2875
8363,31761814,31762619,True,1,805
8364,31772171,31772644,False,1,473
8365,31776120,31777013,False,1,893
8366,31798412,31799443,True,1,1031
8367,31806039,31806123,True,2,84
8368,31856095,31857462,True,2,1367
8369,31869204,31871484,True,6,2280
8370,31871360,31916583,True,1,45223
8371,31875467,31877064,True,1,1597
8372,31879904,31881819,False,1,1915
8373,31888255,31897114,True,2,8859
8374,31900620,31902370,True,1,1750
8375,31909134,31912203,False,1,3069
8376,31913875,31916751,True,1,2876
8377,31920949,31926922,True,1,5973
8378,31920949,31937439,False,1,16490
8379,31924096,31925921,True,1,1825
8380,31929443,31930815,True,1,1372
8381,31933039,31933802,True,1,763
8382,31933113,31943311,True,2,10198
8383,31933113,31966451,True,1,33338
8384,31940839,31942512,True,7,1673
8385,31947317,31948199,True,1,882
8386,31978579,31978987,True,2,408
8387,31979351,31980079,True,1,728
8388,31982652,31995742,True,4,13090
8389,31990255,31996562,True,1,6307
8390,31993596,31996964,True,1,3368
8391,31995379,31997890,True,2,2511
8392,32009861,32013048,True,1,3187
8393,32021939,32053556,True,1,31617
8394,32047898,32048292,True,3,394
8395,32058915,32070018,True,2,11103
8396,32058918,32070018,True,2,11100
8397,32071040,32071302,True,1,262
8398,32071040,32071760,True,1,720
8399,32071040,32078147,True,1,7107
8400,32087089,32145104,True,1,58015
8401,32126166,32127230,True,1,1064
8402,32128533,32174053,True,2,45520
8403,32135375,32158469,True,2,23094
8404,32136658,32143298,True,1,6640
8405,32138128,32138314,True,1,186
8406,32160492,32161113,True,1,621
8407,32161547,32162750,True,1,1203
8408,32165021,32167658,True,1,2637
8409,32166380,32167820,True,1,1440
8410,32170597,32176243,True,1,5646
8411,32182071,32182486,True,1,415
8412,32182170,32182447,True,1,277
8413,32183186,32188360,True,1,5174
8414,32195677,32195868,True,1,191
8415,32207390,32211978,True,1,4588
8416,32216832,32218698,True,1,1866
8417,32241283,32257791,True,2,16508
8418,32253042,32255792,False,1,2750
8419,32255725,32257063,False,1,1338
8420,32258575,32382840,True,2,124265
8421,32258956,32260102,True,1,1146
8422,32258956,32271170,True,1,12214
8423,32265571,32266133,False,2,562
8424,32266949,32267555,False,1,606
8425,32283912,32309849,True,1,25937
8426,32288046,32289305,False,1,1259
8427,32289160,32289810,False,1,650
8428,32289945,32290478,False,1,533
8429,32293253,32296527,True,1,3274
8430,32300100,32315445,True,1,15345
8431,32302080,32312654,False,1,10574
8432,32324110,32335310,False,1,11200
8433,32324453,32326545,False,1,2092
8434,32327287,32330381,False,1,3094
8435,32327287,32330381,True,2,3094
8436,32336368,32336559,True,1,191
8437,32349003,32373667,True,1,24664
8438,32356864,32365171,True,1,8307
8439,32360898,32364179,False,1,3281
8440,32371509,32374058,True,1,2549
8441,32374466,32376194,False,1,1728
8442,32374641,32379855,True,1,5214
8443,32383707,32384543,True,1,836
8444,32385116,32419850,True,1,34734
8445,32401499,32403304,True,1,1805
8446,32407968,32419144,True,2,11176
8447,32417555,32424452,False,1,6897
8448,32417555,32424452,True,1,6897
8449,32433380,32453448,True,1,20068
8450,32445324,32451523,True,3,6199
8451,32457085,32468677,True,2,11592
8452,32471769,32485013,False,1,13244
8453,32477661,32479122,True,1,1461
8454,32477821,32485881,True,1,8060
8455,32487519,32487854,False,1,335
8456,32487519,32487854,True,1,335
8457,32489882,32497586,True,1,7704
8458,32492102,32493756,True,1,1654
8459,32500338,32525635,False,1,25297
8460,32500338,32527042,False,1,26704
8461,32506804,32545726,True,4,38922
8462,32509025,32513973,False,1,4948
8463,32509025,32513973,True,1,4948
8464,32513008,32514514,False,1,1506
8465,32513008,32514514,True,2,1506
8466,32516690,32519190,True,1,2500
8467,32534023,32535063,True,1,1040
8468,32537110,32537187,True,4,77
8469,32541416,32541511,True,1,95
8470,32541698,32541794,True,1,96
8471,32543128,32543639,True,1,511
8472,32544475,32547705,False,1,3230
8473,32544475,32547705,True,3,3230
8474,32545045,32545684,True,1,639
8475,32549229,32576713,True,1,27484
8476,32549560,32551036,False,1,1476
8477,32557706,32559794,True,1,2088
8478,32568864,32569580,True,2,716
8479,32572386,32577482,False,1,5096
8480,32592561,32592667,True,1,106
8481,32600903,32604227,False,1,3324
8482,32600903,32604227,True,1,3324
8483,32600903,32604841,True,1,3938
8484,32604112,32608569,False,1,4457
8485,32606432,32625965,True,2,19533
8486,32610765,32612884,False,1,2119
8487,32613678,32617297,False,1,3619
8488,32613678,32617297,True,2,3619
8489,32617543,32622932,True,3,5389
8490,32621414,32623066,True,1,1652
8491,32630731,32632297,True,1,1566
8492,32638002,32639729,False,1,1727
8493,32638002,32639729,True,1,1727
8494,32653076,32657144,True,3,4068
8495,32661610,32663142,True,1,1532
8496,32672354,32672796,True,1,442
8497,32674402,32720218,True,2,45816
8498,32674402,32749369,True,1,74967
8499,32679778,32702135,True,1,22357
8500,32682776,32684089,True,4,1313
8501,32682776,32684104,True,1,1328
8502,32684167,32688695,True,1,4528
8503,32684643,32684939,False,2,296
8504,32684674,32684939,False,20,265
8505,32684674,32685797,False,1,1123
8506,32685028,32685272,True,3,244
8507,32690838,32691898,False,1,1060
8508,32692763,32695510,True,1,2747
8509,32692763,32696475,True,1,3712
8510,32692763,32710888,True,1,18125
8511,32695958,32698716,True,1,2758
8512,32697043,32697591,True,3,548
8513,32710346,32710625,True,2,279
8514,32711414,32733591,True,1,22177
8515,32716090,32722232,True,2,6142
8516,32720257,32721786,True,1,1529
8517,32740605,32741209,True,1,604
8518,32750996,32751367,True,1,371
8519,32769475,32770250,True,1,775
8520,32829147,32830758,False,1,1611
8521,32829147,32830758,True,2,1611
8522,32829147,32844530,True,1,15383
8523,32829147,32845051,True,2,15904
8524,32829772,32830669,False,1,897
8525,32837302,32837394,True,1,92
8526,32838181,32853574,True,1,15393
8527,32842552,32856289,True,1,13737
8528,32845171,32845350,False,1,179
8529,32846638,32848134,False,1,1496
8530,32851547,32853212,True,1,1665
8531,32855244,32857219,True,1,1975
8532,32865758,32865969,False,1,211
8533,32871459,32871675,True,1,216
8534,32873074,32988078,True,5,115004
8535,32902646,32906758,True,1,4112
8536,32903520,32904747,True,1,1227
8537,32910370,32920088,True,2,9718
8538,32924348,32926429,True,1,2081
8539,32930511,32930801,True,1,290
8540,32932716,32938642,False,1,5926
8541,32932716,32938642,True,1,5926
8542,32945183,32960319,True,2,15136
8543,32945183,32968326,True,2,23143
8544,32945384,32968527,True,1,23143
8545,32948489,32950915,True,2,2426
8546,32957987,32958295,True,2,308
8547,32957987,32988070,True,1,30083
8548,32957987,33005275,True,1,47288
8549,32957987,33007290,True,1,49303
8550,32963260,32966219,True,1,2959
8551,33000193,33007238,True,1,7045
8552,33001220,33007739,False,1,6519
8553,33001220,33007739,True,3,6519
8554,33001220,33007746,True,1,6526
8555,33001220,33011113,False,1,9893
8556,33001543,33007874,False,1,6331
8557,33001543,33007874,True,1,6331
8558,33003693,33005044,True,1,1351
8559,33003693,33006192,True,1,2499
8560,33007660,33010625,True,1,2965
8561,33007660,33013320,True,2,5660
8562,33007660,33013326,True,1,5666
8563,33007922,33013324,True,2,5402
8564,33012751,33013513,True,1,762
8565,33024737,33025983,True,2,1246
8566,33049837,33050241,False,1,404
8567,33049837,33050241,True,1,404
8568,33051870,33061221,True,1,9351
8569,33112447,33118216,True,1,5769
8570,33116973,33117184,True,1,211
8571,33133171,33138622,True,1,5451
8572,33154838,33155339,True,2,501
8573,33155827,33158707,False,1,2880
8574,33166063,33248041,False,2,81978
8575,33166063,33283818,False,1,117755
8576,33166063,33287729,False,1,121666
8577,33166063,33310773,False,2,144710
8578,33166063,33450335,False,1,284272
8579,33179952,33181290,False,1,1338
8580,33179952,33181290,True,1,1338
8581,33187696,33189929,True,1,2233
8582,33191992,33219616,False,1,27624
8583,33214019,33214994,True,3,975
8584,33214480,33218805,False,1,4325
8585,33214480,33218805,True,3,4325
8586,33221638,33225773,True,1,4135
8587,33230121,33238502,False,1,8381
8588,33240231,33251115,True,1,10884
8589,33258520,33261855,True,2,3335
8590,33258862,33259129,True,2,267
8591,33268111,33369636,True,3,101525
8592,33269308,33465824,True,1,196516
8593,33270836,33369271,True,1,98435
8594,33271403,33369524,True,2,98121
8595,33273269,33370340,True,1,97071
8596,33279970,33281403,False,1,1433
8597,33279970,33281403,True,1,1433
8598,33286350,33286610,True,1,260
8599,33325367,33326608,True,1,1241
8600,33328917,33330399,True,6,1482
8601,33336606,33337400,True,1,794
8602,33353506,33354879,True,1,1373
8603,33371671,33390818,True,2,19147
8604,33371687,33390818,True,2,19131
8605,33374210,33374861,True,1,651
8606,33380641,33381452,False,1,811
8607,33382521,33390427,False,1,7906
8608,33382697,33386387,False,1,3690
8609,33387327,33411392,True,2,24065
8610,33387327,33413245,True,1,25918
8611,33387327,33413248,True,2,25921
8612,33401715,33405898,True,2,4183
8613,33405566,33414650,False,5,9084
8614,33405566,33414650,True,7,9084
8615,33421317,33422919,True,1,1602
8616,33421417,33422919,True,1,1502
8617,33444982,33445226,False,1,244
8618,33450454,33450974,True,2,520
8619,33458163,33458512,True,1,349
8620,33464996,33467064,True,2,2068
8621,33468153,33468241,True,1,88
8622,33468371,33565237,True,1,96866
8623,33475728,33491054,True,1,15326
8624,33475728,33491092,True,1,15364
8625,33478851,33492164,False,1,13313
8626,33478851,33500229,False,1,21378
8627,33515030,33520372,False,1,5342
8628,33515030,33521802,True,1,6772
8629,33515030,33527162,False,1,12132
8630,33520535,33526293,True,1,5758
8631,33534436,33537291,True,1,2855
8632,33534514,33537291,True,2,2777
8633,33544089,33562730,True,1,18641
8634,33563751,33565255,True,1,1504
8635,33564677,33567624,False,1,2947
8636,33587005,33609184,True,1,22179
8637,33587527,33587790,True,1,263
8638,33590552,33596248,False,1,5696
8639,33601114,33604846,True,1,3732
8640,33609266,33641249,True,1,31983
8641,33609266,33650769,True,1,41503
8642,33609681,33614529,False,1,4848
8643,33620049,33620526,True,4,477
8644,33630202,33632746,True,1,2544
8645,33653923,33654870,False,1,947
8646,33661890,33662990,True,1,1100
8647,33661890,33665961,True,1,4071
8648,33664844,33666821,True,1,1977
8649,33665162,33665362,False,1,200
8650,33665842,33665988,False,1,146
8651,33681903,33685033,True,1,3130
8652,33684091,33689445,True,1,5354
8653,33685508,33686035,True,2,527
8654,33688754,33895322,True,1,206568
8655,33701159,33703495,True,1,2336
8656,33701159,33709587,True,1,8428
8657,33721053,33721268,False,1,215
8658,33726000,33726723,True,2,723
8659,33733045,33736766,True,1,3721
8660,33742639,33746389,True,1,3750
8661,33769915,33806337,True,1,36422
8662,33779602,33780221,True,1,619
8663,33785856,33786574,True,2,718
8664,33786675,33804866,False,1,18191
8665,33787519,33788145,True,1,626
8666,33798284,33799151,True,1,867
8667,33811388,33816021,False,1,4633
8668,33823486,33828005,True,1,4519
8669,33852998,33853012,True,1,14
8670,33854433,33861096,False,1,6663
8671,33866098,33866913,False,2,815
8672,33880559,33880808,True,3,249
8673,33890348,33891088,False,3,740
8674,33891275,33897024,False,1,5749
8675,33892358,33925095,True,2,32737
8676,33904372,33904718,False,1,346
8677,33913768,33914187,False,1,419
8678,33919430,33921109,False,1,1679
8679,33930070,33989155,True,2,59085
8680,33944241,33944930,False,3,689
8681,33945873,33945953,False,2,80
8682,33947983,33948184,False,2,201
8683,33948752,33950364,True,1,1612
8684,33949364,34025745,True,1,76381
8685,33976118,33976326,True,1,208
8686,33993390,34021008,True,1,27618
8687,33999934,34000207,True,1,273
8688,34007911,34010746,True,1,2835
8689,34009016,34010753,True,1,1737
8690,34028197,34056131,True,1,27934
8691,34035501,34040636,True,1,5135
8692,34079296,34080760,True,1,1464
8693,34133659,34323546,True,1,189887
8694,34139202,34143003,True,2,3801
8695,34152140,34153239,True,2,1099
8696,34165016,34165139,True,2,123
8697,34165905,34175346,False,3,9441
8698,34165905,34202267,False,1,36362
8699,34175096,34176673,True,2,1577
8700,34179067,34181244,True,1,2177
8701,34191951,34192580,True,1,629
8702,34198745,34212155,True,1,13410
8703,34199496,34201345,True,1,1849
8704,34201116,34201446,False,1,330
8705,34205057,34217679,True,1,12622
8706,34205252,34237703,True,4,32451
8707,34209278,34227814,True,1,18536
8708,34209278,34230165,True,1,20887
8709,34210720,34212013,False,1,1293
8710,34210720,34213480,True,1,2760
8711,34219590,34221002,True,2,1412
8712,34219750,34279629,False,1,59879
8713,34232696,34233823,True,1,1127
8714,34249426,34250297,True,1,871
8715,34257502,34259067,True,1,1565
8716,34262145,34292712,False,1,30567
8717,34264751,34266188,True,1,1437
8718,34269564,34274983,False,1,5419
8719,34270460,34278321,True,4,7861
8720,34300402,34300729,True,3,327
8721,34312038,34313966,True,3,1928
8722,34312941,34313021,True,1,80
8723,34318951,34321048,True,1,2097
8724,34321556,34324203,True,2,2647
8725,34334819,34336392,True,1,1573
8726,34339974,34351841,False,1,11867
8727,34346805,34347133,False,1,328
8728,34373274,34399058,True,2,25784
8729,34376120,34380485,True,3,4365
8730,34387679,34389085,True,1,1406
8731,34390568,34391607,True,1,1039
8732,34397041,34397655,False,1,614
8733,34399054,34407681,True,1,8627
8734,34401401,34406910,True,4,5509
8735,34402372,34403446,False,3,1074
8736,34402372,34403446,True,1,1074
8737,34413775,34414724,True,1,949
8738,34413810,34416534,True,2,2724
8739,34415723,34448479,True,1,32756
8740,34415723,34546566,True,1,130843
8741,34425836,34468674,True,1,42838
8742,34430320,34431081,False,1,761
8743,34433937,34492246,True,1,58309
8744,34435588,34492984,True,1,57396
8745,34452768,34481765,True,1,28997
8746,34456387,34456922,False,1,535
8747,34472992,34510135,True,1,37143
8748,34497017,34497600,True,1,583
8749,34498450,34505496,True,1,7046
8750,34514557,34515358,False,1,801
8751,34529604,34544964,True,2,15360
8752,34532976,34536981,True,1,4005
8753,34540780,34541530,True,1,750
8754,34563788,34564842,True,2,1054
8755,34563934,34571019,True,1,7085
8756,34563934,34572616,True,1,8682
8757,34564744,34565328,True,1,584
8758,34565095,34571696,False,1,6601
8759,34566090,34567817,True,1,1727
8760,34580498,34581277,True,1,779
8761,34580498,34582184,True,1,1686
8762,34581609,34595065,False,1,13456
8763,34590532,34590975,True,1,443
8764,34595304,34601888,True,1,6584
8765,34596660,34602619,False,1,5959
8766,34596660,34602619,True,1,5959
8767,34596680,34602619,True,1,5939
8768,34602516,34602760,True,4,244
8769,34617313,34617793,False,1,480
8770,34618043,34620026,True,1,1983
8771,34625305,34625408,True,2,103
8772,34625305,34625750,True,1,445
8773,34633884,34634519,True,1,635
8774,34635080,34635407,True,1,327
8775,34644640,34644728,True,2,88
8776,34645363,34647972,True,1,2609
8777,34652470,34652763,True,3,293
8778,34673954,34688604,False,1,14650
8779,34673954,34688604,True,1,14650
8780,34674179,34674554,True,1,375
8781,34677228,34687833,True,1,10605
8782,34686128,34688999,True,1,2871
8783,34690677,34694325,True,1,3648
8784,34709342,34755421,True,1,46079
8785,34709615,34712481,False,1,2866
8786,34722071,34723237,False,1,1166
8787,34722071,34723237,True,3,1166
8788,34726020,34727737,False,1,1717
8789,34726020,34727737,True,1,1717
8790,34738804,34739390,True,1,586
8791,34746894,34751504,True,1,4610
8792,34756567,34757794,True,1,1227
8793,34756567,34757832,False,1,1265
8794,34756567,34757832,True,2,1265
8795,34756591,34757867,True,1,1276
8796,34759633,34763964,False,1,4331
8797,34760878,34774890,True,1,14012
8798,34785244,34785317,False,1,73
8799,34785244,34785317,True,2,73
8800,34785244,34785322,True,1,78
8801,34785443,34785549,True,2,106
8802,34787712,34815519,False,1,27807
8803,34787712,34815519,True,5,27807
8804,34787987,35099402,True,2,311415
8805,34789027,34789836,True,2,809
8806,34792716,34797110,True,2,4394
8807,34796676,34796960,True,1,284
8808,34796750,34796960,True,1,210
8809,34806579,34808034,True,1,1455
8810,34811435,34814563,True,1,3128
8811,34816188,34817514,True,1,1326
8812,34818038,34818415,True,5,377
8813,34829106,34829673,True,1,567
8814,34833242,34833449,True,1,207
8815,34840802,34845166,True,1,4364
8816,34858008,34870036,False,2,12028
8817,34868210,34868584,True,1,374
8818,34868724,34869555,False,1,831
8819,34868724,34869555,True,1,831
8820,34885709,34886273,False,1,564
8821,34886592,34887439,True,1,847
8822,34887151,34997342,False,1,110191
8823,34891721,34894605,True,1,2884
8824,34895362,34896177,True,1,815
8825,34895502,34896217,False,1,715
8826,34896798,34897006,False,1,208
8827,34896798,34897140,True,3,342
8828,34904700,34905943,True,1,1243
8829,34924341,34950683,False,1,26342
8830,34925440,34933598,True,1,8158
8831,34950223,34952130,True,4,1907
8832,34976874,34980298,True,2,3424
8833,34983416,34989821,False,1,6405
8834,35004950,35005791,False,1,841
8835,35004950,35005791,True,5,841
8836,35027889,35028241,True,1,352
8837,35031364,35032555,True,1,1191
8838,35031364,35033744,False,1,2380
8839,35031364,35033744,True,3,2380
8840,35033131,35033435,False,1,304
8841,35033306,35033386,False,1,80
8842,35033929,35041272,True,1,7343
8843,35035693,35043220,False,1,7527
8844,35061945,35062031,True,2,86
8845,35063424,35080403,True,1,16979
8846,35094053,35102323,True,1,8270
8847,35101454,35123173,True,1,21719
8848,35101454,35131979,True,1,30525
8849,35111725,35114582,True,1,2857
8850,35119708,35123582,True,2,3874
8851,35119708,35124884,True,1,5176
8852,35131967,35143798,True,2,11831
8853,35132467,35136692,True,1,4225
8854,35133001,35137584,True,1,4583
8855,35133651,35170072,False,1,36421
8856,35138012,35138599,True,1,587
8857,35151316,35161663,True,1,10347
8858,35154777,35158723,True,1,3946
8859,35158116,35160371,True,2,2255
8860,35158237,35326014,True,1,167777
8861,35162091,35181860,True,1,19769
8862,35162815,35175988,True,1,13173
8863,35162815,35178669,True,1,15854
8864,35162815,35179566,True,1,16751
8865,35169893,35212126,True,1,42233
8866,35189187,35189702,True,5,515
8867,35189187,35189705,True,1,518
8868,35198221,35199328,True,1,1107
8869,35199883,35207829,True,1,7946
8870,35201869,35203336,True,1,1467
8871,35202334,35202983,True,1,649
8872,35205413,35208027,False,1,2614
8873,35214496,35217308,True,1,2812
8874,35231677,35232021,True,3,344
8875,35232708,35237794,False,1,5086
8876,35232708,35237794,True,1,5086
8877,35237656,35237847,True,2,191
8878,35245200,35249411,True,1,4211
8879,35264402,35268159,True,1,3757
8880,35267956,35269018,True,1,1062
8881,35268377,35272185,True,2,3808
8882,35269498,35292151,True,2,22653
8883,35276268,35279626,True,1,3358
8884,35276281,35281147,False,1,4866
8885,35280719,35286435,False,1,5716
8886,35281005,35286435,False,1,5430
8887,35281153,35300622,True,1,19469
8888,35281153,35302651,True,1,21498
8889,35290950,35303984,True,1,13034
8890,35300032,35300112,False,1,80
8891,35300032,35300112,True,3,80
8892,35302352,35303904,True,1,1552
8893,35307132,35359272,True,2,52140
8894,35315438,35316555,True,1,1117
8895,35322657,35322899,True,4,242
8896,35333292,35336628,True,1,3336
8897,35343531,35355282,True,1,11751
8898,35348670,35379985,True,1,31315
8899,35358839,35367319,True,1,8480
8900,35361292,35383951,True,1,22659
8901,35361292,35386258,True,1,24966
8902,35370974,35381690,True,1,10716
8903,35372501,35388584,True,2,16083
8904,35384207,35387262,True,2,3055
8905,35397596,35398289,True,1,693
8906,35410921,35415360,True,1,4439
8907,35429299,35432883,True,2,3584
8908,35429760,35429947,False,1,187
8909,35430827,35431342,True,6,515
8910,35441766,35441869,True,2,103
8911,35443991,35495141,True,1,51150
8912,35444159,35447954,True,5,3795
8913,35468940,35469718,True,2,778
8914,35471509,35482762,True,2,11253
8915,35474287,35475819,True,1,1532
8916,35476945,35479427,False,1,2482
8917,35483068,35483556,True,1,488
8918,35497918,35498956,True,6,1038
8919,35511391,35517780,True,2,6389
8920,35511391,35519724,True,1,8333
8921,35511391,35519727,True,1,8336
8922,35515613,35550704,True,2,35091
8923,35520521,35523797,True,2,3276
8924,35529100,35535266,True,1,6166
8925,35529100,35536060,True,2,6960
8926,35545066,35555218,True,1,10152
8927,35561062,35562585,True,4,1523
8928,35561062,35573461,True,1,12399
8929,35564510,35575317,True,1,10807
8930,35586312,35587738,True,1,1426
8931,35588810,35607565,True,1,18755
8932,35601909,35603933,True,1,2024
8933,35608671,35609005,True,1,334
8934,35619556,35709349,False,1,89793
8935,35619556,35709349,True,2,89793
8936,35623218,35661850,False,1,38632
8937,35625246,35626277,True,2,1031
8938,35626652,35631298,True,1,4646
8939,35631024,35632405,True,1,1381
8940,35638013,35638162,True,1,149
8941,35638322,35673823,True,3,35501
8942,35638322,35696795,True,1,58473
8943,35638322,35697384,True,1,59062
8944,35654342,35656921,True,1,2579
8945,35660033,35667935,True,1,7902
8946,35660033,35672791,True,1,12758
8947,35660731,35662045,True,1,1314
8948,35660731,35662095,True,1,1364
8949,35662332,35662836,True,1,504
8950,35664300,35666832,True,3,2532
8951,35669027,35670776,True,1,1749
8952,35681539,35683695,True,1,2156
8953,35681751,35797466,True,1,115715
8954,35691958,35692763,True,3,805
8955,35692362,35732527,True,2,40165
8956,35692362,35755553,True,1,63191
8957,35693780,35753872,True,1,60092
8958,35702866,35716412,True,2,13546
8959,35717149,35723650,True,2,6501
8960,35724671,35727409,True,2,2738
8961,35732774,35773375,True,2,40601
8962,35736416,35767861,True,1,31445
8963,35747173,35748693,True,1,1520
8964,35752414,35753103,True,2,689
8965,35752414,35753290,True,2,876
8966,35755248,35759028,True,1,3780
8967,35768592,35769906,True,1,1314
8968,35768982,35772907,True,1,3925
8969,35796179,35796360,True,1,181
8970,35811933,35824464,True,1,12531
8971,35811933,35824483,True,1,12550
8972,35811933,35824486,True,1,12553
8973,35814174,35821000,True,2,6826
8974,35816017,35821053,True,1,5036
8975,35829056,35830266,True,4,1210
8976,35829884,35843530,True,1,13646
8977,35837946,35842807,False,1,4861
8978,35841618,35849036,True,1,7418
8979,35843333,35845768,True,1,2435
8980,35845294,35845995,False,1,701
8981,35845294,35845995,True,3,701
8982,35855189,35858524,True,1,3335
8983,35855189,35859445,True,1,4256
8984,35856100,35857343,True,1,1243
8985,35862351,35862587,True,1,236
8986,35870410,35876370,True,1,5960
8987,35871025,35876607,True,1,5582
8988,35871025,35876610,True,1,5585
8989,35871709,35883124,False,1,11415
8990,35873311,35876507,True,1,3196
8991,35881623,35881906,True,1,283
8992,35884279,35887414,True,1,3135
8993,35885826,35891069,True,1,5243
8994,35889827,35890642,True,2,815
8995,35898270,35899058,True,1,788
8996,35899545,35900203,True,1,658
8997,35901409,35906961,False,1,5552
8998,35901456,35919250,False,1,17794
8999,35902296,35937919,True,1,35623
9000,35904993,35906273,False,1,1280
9001,35907224,35907430,True,1,206
9002,35913353,35933062,True,2,19709
9003,35941469,35942786,True,1,1317
9004,35957022,35958102,True,1,1080
9005,35966266,35967726,True,1,1460
9006,35982581,35988305,True,2,5724
9007,36008249,36059208,True,1,50959
9008,36010391,36026971,True,1,16580
9009,36024157,36033913,True,1,9756
9010,36033712,36034998,True,1,1286
9011,36042316,36043882,True,1,1566
9012,36047618,36049690,True,1,2072
9013,36055986,36056156,True,1,170
9014,36057094,36057766,False,1,672
9015,36082744,36101516,True,1,18772
9016,36084795,36086426,False,1,1631
9017,36084795,36086426,True,1,1631
9018,36086595,36093169,True,1,6574
9019,36086595,36105691,True,2,19096
9020,36087680,36091040,True,1,3360
9021,36091904,36093121,True,1,1217
9022,36114298,36114531,True,1,233
9023,36114871,36115789,True,1,918
9024,36114871,36118401,True,1,3530
9025,36118426,36158058,True,1,39632
9026,36120017,36158889,True,1,38872
9027,36120620,36125272,True,1,4652
9028,36122249,36122870,True,1,621
9029,36123338,36123896,True,1,558
9030,36124328,36127478,True,1,3150
9031,36125912,36126166,True,1,254
9032,36126240,36128461,True,1,2221
9033,36128821,36129957,True,1,1136
9034,36129391,36130527,False,1,1136
9035,36135306,36136317,True,4,1011
9036,36135306,36137515,True,1,2209
9037,36135306,36142001,True,1,6695
9038,36135306,36144535,True,1,9229
9039,36150404,36152195,True,3,1791
9040,36161554,36167584,False,1,6030
9041,36163806,36231285,True,1,67479
9042,36175193,36185133,True,1,9940
9043,36196969,36210496,True,1,13527
9044,36203927,36204845,True,2,918
9045,36223452,36232547,True,1,9095
9046,36224325,36231461,True,1,7136
9047,36237193,36241348,True,1,4155
9048,36238369,36238494,True,1,125
9049,36243001,36259775,True,7,16774
9050,36243001,36287327,True,3,44326
9051,36246430,36248742,True,1,2312
9052,36251737,36257205,True,1,5468
9053,36253407,36328421,True,1,75014
9054,36258012,36262188,True,1,4176
9055,36259555,36260906,True,1,1351
9056,36263050,36271190,True,1,8140
9057,36267256,36272328,True,1,5072
9058,36268320,36268640,False,1,320
9059,36277025,36284090,True,1,7065
9060,36277025,36304405,True,1,27380
9061,36285212,36296660,True,1,11448
9062,36296716,36296796,True,5,80
9063,36300049,36300132,True,1,83
9064,36311420,36311730,True,1,310
9065,36327898,36329873,True,2,1975
9066,36328898,36330449,True,1,1551
9067,36340793,36341072,True,2,279
9068,36340793,36341085,True,1,292
9069,36355528,36358221,True,5,2693
9070,36363514,36364291,True,1,777
9071,36364393,36370169,True,1,5776
9072,36372043,36374023,True,1,1980
9073,36378380,36381204,True,1,2824
9074,36379014,36398864,True,1,19850
9075,36405819,36408069,False,1,2250
9076,36417243,36426997,True,1,9754
9077,36424560,36425610,True,2,1050
9078,36435262,36437686,False,1,2424
9079,36435262,36437686,True,8,2424
9080,36440056,36444522,True,1,4466
9081,36450360,36450802,True,2,442
9082,36450570,36451095,False,1,525
9083,36461424,36461715,False,1,291
9084,36461424,36461715,True,1,291
9085,36463419,36463776,True,4,357
9086,36468209,36471251,True,1,3042
9087,36473081,36475350,True,1,2269
9088,36481721,36482885,True,3,1164
9089,36481721,36491275,True,1,9554
9090,36487845,36494526,True,1,6681
9091,36497609,36506260,True,1,8651
9092,36506112,36506841,True,2,729
9093,36515505,36516563,False,1,1058
9094,36516931,36517989,True,1,1058
9095,36518631,36523827,True,3,5196
9096,36521295,36527234,True,1,5939
9097,36528091,36530252,False,2,2161
9098,36528091,36530252,True,1,2161
9099,36533836,36534229,True,1,393
9100,36538368,36547747,True,2,9379
9101,36538368,36554770,True,1,16402
9102,36538368,36555430,True,2,17062
9103,36538368,36555443,True,1,17075
9104,36538368,36556081,True,1,17713
9105,36538368,36564834,True,1,26466
9106,36544097,36544177,False,1,80
9107,36544097,36544177,True,3,80
9108,36557334,36564938,True,1,7604
9109,36562375,36565292,True,1,2917
9110,36569361,36570426,True,1,1065
9111,36575650,36575735,True,1,85
9112,36575650,36576236,True,1,586
9113,36575797,36576236,True,1,439
9114,36583039,36583952,False,1,913
9115,36601705,36603711,True,3,2006
9116,36606818,36607481,False,1,663
9117,36608317,36608711,True,1,394
9118,36608903,36609825,True,1,922
9119,36616080,36617143,True,1,1063
9120,36630584,36631934,False,1,1350
9121,36634415,36641686,True,1,7271
9122,36640856,36641337,True,9,481
9123,36646778,36646926,False,1,148
9124,36647807,36670687,True,3,22880
9125,36660182,36865927,True,1,205745
9126,36660849,36661904,False,1,1055
9127,36662164,36662246,False,1,82
9128,36662537,36663125,True,1,588
9129,36666776,36672501,True,1,5725
9130,36687052,36687487,False,1,435
9131,36688102,36691307,True,1,3205
9132,36688102,36698420,True,2,10318
9133,36690672,36691608,True,2,936
9134,36719405,36721113,True,1,1708
9135,36721746,36721879,False,1,133
9136,36729218,36729668,False,1,450
9137,36729218,36729668,True,5,450
9138,36736821,36743076,True,1,6255
9139,36736821,36743637,True,2,6816
9140,36760305,36767285,True,1,6980
9141,36760305,36769344,True,1,9039
9142,36764164,36765456,True,1,1292
9143,36775441,36787308,True,1,11867
9144,36778280,36798529,True,4,20249
9145,36780306,36781935,True,1,1629
9146,36780306,36782614,True,2,2308
9147,36790147,36790960,False,2,813
9148,36824089,36825447,True,1,1358
9149,36824089,36865600,True,1,41511
9150,36828984,36849409,False,1,20425
9151,36828984,36849409,True,1,20425
9152,36831347,36832476,False,3,1129
9153,36832118,36834299,True,5,2181
9154,36835404,36837525,True,2,2121
9155,36835969,36836176,True,1,207
9156,36859390,36869415,True,4,10025
9157,36859885,36869551,False,1,9666
9158,36859885,36869551,True,3,9666
9159,36860541,36860630,True,1,89
9160,36867807,36868106,False,1,299
9161,36867807,36868106,True,5,299
9162,36867861,36868106,True,2,245
9163,36868645,36870984,True,1,2339
9164,36868931,36988629,True,1,119698
9165,36870630,36874716,True,1,4086
9166,36870630,36874723,True,1,4093
9167,36875589,36875715,True,1,126
9168,36886615,36888099,False,1,1484
9169,36887539,36968777,True,1,81238
9170,36896244,36897618,False,1,1374
9171,36896244,36897618,True,1,1374
9172,36896347,36897618,True,1,1271
9173,36902932,36905074,False,1,2142
9174,36902932,36905074,True,2,2142
9175,36902932,36918110,True,1,15178
9176,36904395,36905187,True,1,792
9177,36904395,36905753,True,1,1358
9178,36916311,36916473,False,1,162
9179,36920724,36920836,True,1,112
9180,36937821,36938224,True,1,403
9181,36948371,36978903,True,3,30532
9182,36954998,36955590,True,1,592
9183,36955726,36962879,True,1,7153
9184,36973491,36977632,False,1,4141
9185,36976500,36979651,True,1,3151
9186,36976803,36979651,True,1,2848
9187,36976821,36979651,True,2,2830
9188,36977547,36980070,True,1,2523
9189,36994243,36996061,True,1,1818
9190,37004039,37005032,True,1,993
9191,37004888,37008946,True,2,4058
9192,37013654,37015692,True,1,2038
9193,37022547,37022877,True,2,330
9194,37023006,37023428,True,1,422
9195,37024470,37030674,False,1,6204
9196,37046043,37059054,False,1,13011
9197,37048156,37052434,False,1,4278
9198,37048156,37052434,True,1,4278
9199,37050334,37053992,True,1,3658
9200,37060662,37068304,True,3,7642
9201,37061050,37063239,True,1,2189
9202,37070845,37071251,True,3,406
9203,37071014,37071251,False,1,237
9204,37071014,37071251,True,1,237
9205,37071764,37160719,True,1,88955
9206,37071831,37160786,True,5,88955
9207,37078751,37080016,True,1,1265
9208,37091124,37091271,True,6,147
9209,37096312,37097950,True,1,1638
9210,37096312,37097953,True,1,1641
9211,37097968,37173801,True,2,75833
9212,37099829,37240434,True,2,140605
9213,37106983,37108824,True,4,1841
9214,37106983,37110900,True,3,3917
9215,37106983,37119117,True,1,12134
9216,37109150,37109504,True,3,354
9217,37121498,37121745,True,2,247
9218,37122131,37123397,True,1,1266
9219,37128342,37138017,True,1,9675
9220,37137314,37142928,True,1,5614
9221,37165202,37166766,True,2,1564
9222,37170740,37171629,True,1,889
9223,37187057,37197696,True,1,10639
9224,37187086,37197696,True,1,10610
9225,37202737,37203775,False,1,1038
9226,37202737,37203775,True,1,1038
9227,37205054,37205137,True,1,83
9228,37205054,37207134,True,2,2080
9229,37208341,37210794,True,1,2453
9230,37242894,37243987,False,1,1093
9231,37249275,37249850,False,1,575
9232,37251046,37252482,True,1,1436
9233,37251046,37256237,True,2,5191
9234,37259448,37260969,True,1,1521
9235,37259519,37320464,True,4,60945
9236,37260076,37261104,True,1,1028
9237,37265746,37273080,True,1,7334
9238,37267746,37269819,True,1,2073
9239,37285632,37286039,True,4,407
9240,37295387,37298577,True,3,3190
9241,37296033,37298577,True,1,2544
9242,37318083,37320355,True,1,2272
9243,37322036,37326679,False,1,4643
9244,37337295,37339799,True,1,2504
9245,37337295,37341415,True,1,4120
9246,37337330,37341415,True,1,4085
9247,37345298,37348008,True,1,2710
9248,37365310,37366714,True,1,1404
9249,37365332,37366714,True,1,1382
9250,37369199,37377245,True,1,8046
9251,37376584,37379575,True,1,2991
9252,37379541,37380363,True,3,822
9253,37399204,37399297,True,3,93
9254,37408423,37408907,True,1,484
9255,37418257,37425006,True,3,6749
9256,37440804,37442828,True,1,2024
9257,37442963,37444939,True,1,1976
9258,37447620,37448361,True,2,741
9259,37451704,37474056,True,1,22352
9260,37451722,37477641,True,1,25919
9261,37451936,37453213,False,1,1277
9262,37451936,37453213,True,1,1277
9263,37473062,37477432,True,1,4370
9264,37473062,37481097,True,1,8035
9265,37473062,37493436,True,1,20374
9266,37489521,37501584,True,6,12063
9267,37495784,37522906,True,1,27122
9268,37496707,37500145,True,1,3438
9269,37500048,37500472,True,7,424
9270,37519353,37528391,True,2,9038
9271,37522682,37522985,False,4,303
9272,37522954,37530160,True,1,7206
9273,37522954,37530493,True,1,7539
9274,37530530,37530787,True,1,257
9275,37537658,37537894,True,1,236
9276,37538095,37538830,False,2,735
9277,37538156,37538830,False,1,674
9278,37581130,37596279,True,1,15149
9279,37588700,37590334,False,1,1634
9280,37588700,37590334,True,2,1634
9281,37589062,37648142,True,2,59080
9282,37590434,37591849,True,1,1415
9283,37604634,37630166,False,1,25532
9284,37607682,37608909,False,1,1227
9285,37607682,37608909,True,2,1227
9286,37617370,37618151,True,1,781
9287,37622522,37625197,False,2,2675
9288,37637142,37639255,True,3,2113
9289,37644556,37768188,True,3,123632
9290,37652596,37655974,True,1,3378
9291,37663850,37665431,True,1,1581
9292,37665856,37701563,True,1,35707
9293,37669337,37671302,True,1,1965
9294,37670162,37673471,True,1,3309
9295,37672367,37673171,False,1,804
9296,37672367,37673171,True,4,804
9297,37676986,37677360,False,1,374
9298,37680846,37681552,False,1,706
9299,37699795,37700802,True,1,1007
9300,37708159,37715981,True,1,7822
9301,37710773,37711808,False,1,1035
9302,37711106,37717470,True,4,6364
9303,37715786,37718451,True,1,2665
9304,37749441,37755275,True,1,5834
9305,37770713,37804566,True,6,33853
9306,37787167,37787616,False,1,449
9307,37787353,37787444,True,3,91
9308,37787732,37787811,False,1,79
9309,37787732,37787811,True,1,79
9310,37801161,37801235,True,3,74
9311,37811377,37812176,True,1,799
9312,37817159,37819734,False,1,2575
9313,37822188,37822735,True,1,547
9314,37824843,37825575,False,1,732
9315,37824843,37825575,True,1,732
9316,37849446,37851515,True,1,2069
9317,37856943,37869523,True,1,12580
9318,37856943,37878644,True,1,21701
9319,37876468,37880321,False,1,3853
9320,37885992,37899530,True,2,13538
9321,37896924,37903814,True,1,6890
9322,37915681,37918294,True,3,2613
9323,37916181,37933278,False,2,17097
9324,37916181,37936241,False,1,20060
9325,37919439,37921472,False,1,2033
9326,37919439,37922840,True,1,3401
9327,37932617,37936900,True,2,4283
9328,37941437,37941823,True,1,386
9329,37959559,37960150,True,1,591
9330,37978565,37978765,True,2,200
9331,37990707,38015747,True,3,25040
9332,37991511,38016100,True,1,24589
9333,38016590,38020436,True,9,3846
9334,38016590,38021591,True,2,5001
9335,38020857,38021002,True,3,145
9336,38035689,38039546,False,1,3857
9337,38035689,38041559,False,1,5870
9338,38050428,38052363,True,6,1935
9339,38061148,38061870,False,1,722
9340,38061148,38061870,True,1,722
9341,38061148,38061941,True,1,793
9342,38061791,38066734,True,1,4943
9343,38062095,38063025,True,2,930
9344,38065877,38065966,True,1,89
9345,38080443,38082141,True,1,1698
9346,38080452,38082141,True,4,1689
9347,38082723,38083266,False,1,543
9348,38109536,38111091,True,3,1555
9349,38116881,38117966,True,1,1085
9350,38118357,38120812,False,1,2455
9351,38119438,38122221,True,1,2783
9352,38138127,38155163,False,1,17036
9353,38153976,38158166,True,1,4190
9354,38157975,38162164,True,1,4189
9355,38158568,38162486,True,1,3918
9356,38159510,38162558,True,1,3048
9357,38203654,38206869,True,1,3215
9358,38207725,38208349,True,1,624
9359,38208470,38209126,True,2,656
9360,38211263,38217594,True,1,6331
9361,38219712,38221693,False,1,1981
9362,38219712,38221693,True,1,1981
9363,38232405,38234075,True,2,1670
9364,38239476,38240653,True,1,1177
9365,38239779,38240362,True,1,583
9366,38245243,38245400,False,1,157
9367,38250699,38251214,True,1,515
9368,38261003,38278840,False,1,17837
9369,38273111,38273677,True,1,566
9370,38277514,38303214,True,1,25700
9371,38277514,38306417,True,1,28903
9372,38281533,38323862,True,1,42329
9373,38281533,38325955,True,2,44422
9374,38281533,38326950,True,1,45417
9375,38281533,38353885,True,3,72352
9376,38289125,38289324,True,1,199
9377,38289125,38297904,True,1,8779
9378,38289125,38306815,True,1,17690
9379,38289967,38298438,True,1,8471
9380,38299656,38307583,False,1,7927
9381,38299656,38309063,False,1,9407
9382,38310844,38311382,True,1,538
9383,38326844,38327019,False,1,175
9384,38326844,38327019,True,3,175
9385,38327178,38328806,True,1,1628
9386,38327181,38328806,True,1,1625
9387,38327181,38330180,True,1,2999
9388,38333113,38334313,True,1,1200
9389,38334468,38334696,True,4,228
9390,38335462,38335953,True,2,491
9391,38336562,38339144,True,1,2582
9392,38342414,38347933,True,1,5519
9393,38342414,38361544,True,1,19130
9394,38343076,38348339,True,1,5263
9395,38349726,38381700,True,1,31974
9396,38349756,38351150,False,1,1394
9397,38359620,38363717,True,1,4097
9398,38367520,38374331,True,1,6811
9399,38367614,38367758,True,1,144
9400,38367702,38367774,True,2,72
9401,38367943,38371019,True,1,3076
9402,38367989,38368423,False,1,434
9403,38373289,38375193,True,1,1904
9404,38373289,38399458,True,2,26169
9405,38380303,38485160,True,3,104857
9406,38384663,38394943,True,1,10280
9407,38386917,38454890,True,1,67973
9408,38396207,38397219,True,1,1012
9409,38397374,38398878,True,3,1504
9410,38400559,38407034,False,1,6475
9411,38407869,38410073,True,1,2204
9412,38413765,38419339,True,1,5574
9413,38416131,38420798,False,1,4667
9414,38433030,38448460,True,1,15430
9415,38446163,38447464,False,1,1301
9416,38461416,38461996,True,2,580
9417,38461593,38506916,True,2,45323
9418,38462581,38467677,True,2,5096
9419,38465933,38467607,True,1,1674
9420,38473304,38475320,True,1,2016
9421,38478434,38482767,False,1,4333
9422,38481927,38487967,True,1,6040
9423,38491996,38492375,False,1,379
9424,38491996,38492375,True,3,379
9425,38493256,38493583,True,1,327
9426,38493652,38497062,True,2,3410
9427,38500767,38500838,True,1,71
9428,38513206,38513455,True,2,249
9429,38513206,38513737,True,3,531
9430,38513569,38513738,True,1,169
9431,38525251,38527793,False,1,2542
9432,38525251,38527793,True,3,2542
9433,38547320,38563114,True,1,15794
9434,38562447,38563240,True,1,793
9435,38562447,38564952,True,1,2505
9436,38563628,38563980,True,1,352
9437,38563716,38563980,True,1,264
9438,38565447,38565608,True,6,161
9439,38570001,38630648,True,1,60647
9440,38574776,38575164,True,2,388
9441,38575981,38579205,True,1,3224
9442,38579253,38689724,True,2,110471
9443,38579253,38918360,True,2,339107
9444,38581575,38586705,True,1,5130
9445,38586176,38589525,True,1,3349
9446,38594365,38607097,True,2,12732
9447,38594782,38612379,False,1,17597
9448,38595515,38597767,False,1,2252
9449,38606370,38606774,True,3,404
9450,38607664,38608501,True,1,837
9451,38609689,38612520,True,1,2831
9452,38624597,38624963,False,1,366
9453,38624782,38625370,False,1,588
9454,38625073,38625361,True,1,288
9455,38629265,38629431,False,1,166
9456,38629265,38629431,True,2,166
9457,38630146,38630811,True,1,665
9458,38637302,38657102,True,3,19800
9459,38637302,38659100,True,1,21798
9460,38643317,38667275,True,1,23958
9461,38645654,38650535,True,1,4881
9462,38673513,38677671,True,1,4158
9463,38675176,38675382,True,1,206
9464,38677849,38679757,False,1,1908
9465,38682075,38683592,True,1,1517
9466,38685407,38688547,True,1,3140
9467,38693002,38696616,True,1,3614
9468,38702361,38710374,True,1,8013
9469,38716635,38765130,True,1,48495
9470,38724222,38726636,True,1,2414
9471,38724222,38729438,True,3,5216
9472,38735468,38735781,True,2,313
9473,38744844,39226298,True,1,481454
9474,38746690,38746870,True,1,180
9475,38750855,38752470,True,1,1615
9476,38752639,38752743,True,1,104
9477,38756870,38757062,True,1,192
9478,38757126,38757630,True,4,504
9479,38774804,38775075,True,6,271
9480,38779825,38796729,True,1,16904
9481,38795719,38803762,False,1,8043
9482,38802389,38804231,True,7,1842
9483,38814860,38816026,False,2,1166
9484,38815022,38816585,False,1,1563
9485,38815950,38820869,False,1,4919
9486,38818114,38818694,True,1,580
9487,38818114,38832782,True,1,14668
9488,38825294,38825539,False,1,245
9489,38840165,38840821,True,1,656
9490,38843955,38863593,True,1,19638
9491,38844554,38863789,True,2,19235
9492,38855366,38863661,True,1,8295
9493,38857626,38863308,True,1,5682
9494,38858431,38870750,True,1,12319
9495,38862585,38865571,True,1,2986
9496,38863573,38878154,True,1,14581
9497,38864102,38868566,True,1,4464
9498,38874553,38882870,False,1,8317
9499,38874553,38882870,True,4,8317
9500,38875730,38879733,True,1,4003
9501,38875730,38879786,True,1,4056
9502,38878697,38879436,True,1,739
9503,38880496,38881344,True,2,848
9504,38895610,38896108,True,1,498
9505,38902743,38904243,True,1,1500
9506,38904931,38907528,True,1,2597
9507,38911238,38913147,True,1,1909
9508,38912290,38914199,True,1,1909
9509,38917888,38917992,True,1,104
9510,38917888,38918191,True,1,303
9511,38918205,38918420,True,1,215
9512,38918483,38922589,True,1,4106
9513,38934940,38935092,True,1,152
9514,38934955,38935092,False,1,137
9515,38934955,38935092,True,3,137
9516,38935872,38939360,True,1,3488
9517,38935872,38939365,True,1,3493
9518,38936109,38939326,True,2,3217
9519,38946979,38956562,True,4,9583
9520,38951052,38964898,True,1,13846
9521,38955770,38956222,True,2,452
9522,38959294,38959743,False,1,449
9523,38993588,39072788,True,1,79200
9524,38993588,39072793,True,1,79205
9525,39022611,39023222,True,1,611
9526,39023849,39028339,True,2,4490
9527,39027953,39029215,True,2,1262
9528,39049624,39050049,False,1,425
9529,39065710,39072381,False,1,6671
9530,39070588,39071278,False,1,690
9531,39070588,39072217,True,1,1629
9532,39070588,39074365,True,1,3777
9533,39076701,39076838,True,1,137
9534,39088133,39088218,False,1,85
9535,39088133,39088218,True,4,85
9536,39103416,39104145,True,1,729
9537,39104500,39106921,True,3,2421
9538,39106658,39107915,True,5,1257
9539,39107301,39112079,False,2,4778
9540,39107301,39112079,True,1,4778
9541,39119344,39120513,True,1,1169
9542,39127498,39128974,False,1,1476
9543,39133804,39142907,False,1,9103
9544,39133804,39142907,True,3,9103
9545,39152576,39179541,True,1,26965
9546,39156431,39159348,True,1,2917
9547,39163846,39164890,False,2,1044
9548,39163846,39164890,True,3,1044
9549,39165677,39165810,False,1,133
9550,39166616,39167942,False,1,1326
9551,39180495,39182890,True,1,2395
9552,39185911,39208049,True,2,22138
9553,39186430,39187539,True,2,1109
9554,39187175,39208956,True,1,21781
9555,39211856,39224773,False,1,12917
9556,39212884,39213785,False,1,901
9557,39218442,39219544,True,1,1102
9558,39225832,39226426,False,1,594
9559,39234768,39245973,True,1,11205
9560,39236477,39247015,True,1,10538
9561,39246578,39248189,False,1,1611
9562,39254159,39264007,True,3,9848
9563,39260081,39261711,True,1,1630
9564,39268988,39269179,True,1,191
9565,39277591,39277960,False,1,369
9566,39277591,39277960,True,3,369
9567,39278122,39282831,True,1,4709
9568,39279469,39279840,True,1,371
9569,39279469,39283108,False,1,3639
9570,39279469,39283108,True,1,3639
9571,39282845,39282931,True,5,86
9572,39283401,39283942,True,1,541
9573,39283873,39288944,True,1,5071
9574,39298295,39299559,True,2,1264
9575,39300157,39302273,False,2,2116
9576,39300157,39305763,False,1,5606
9577,39331377,39334510,True,1,3133
9578,39331377,39336116,True,2,4739
9579,39331377,39336945,True,1,5568
9580,39341896,39349302,False,1,7406
9581,39345441,39346831,False,2,1390
9582,39345441,39346831,True,1,1390
9583,39348522,39353762,True,1,5240
9584,39350094,39350701,True,2,607
9585,39353862,39355034,True,1,1172
9586,39374287,39375621,False,1,1334
9587,39404140,39404288,True,1,148
9588,39411083,39411865,False,1,782
9589,39411083,39411865,True,1,782
9590,39412085,39413114,True,1,1029
9591,39436216,39439502,True,1,3286
9592,39455641,39456792,False,1,1151
9593,39455641,39456792,True,1,1151
9594,39458825,39470766,False,1,11941
9595,39458825,39470766,True,1,11941
9596,39458825,39474034,True,1,15209
9597,39469843,39471815,True,3,1972
9598,39470388,39588908,True,4,118520
9599,39473434,39474777,True,1,1343
9600,39481429,39481562,True,3,133
9601,39488493,39491304,True,3,2811
9602,39495202,39495484,False,1,282
9603,39496208,39498974,True,1,2766
9604,39499046,39500470,True,1,1424
9605,39503133,39507807,True,1,4674
9606,39512350,39512463,True,4,113
9607,39520694,39522838,False,1,2144
9608,39520694,39524072,True,1,3378
9609,39552416,39565455,True,1,13039
9610,39556124,39558466,True,1,2342
9611,39559437,39562679,True,1,3242
9612,39559437,39568333,True,2,8896
9613,39560608,39570033,False,1,9425
9614,39573926,39574819,False,1,893
9615,39573926,39575437,False,1,1511
9616,39593620,39602270,True,1,8650
9617,39606535,39606794,False,1,259
9618,39617309,39620256,True,1,2947
9619,39625075,39625723,True,1,648
9620,39625082,39625730,True,1,648
9621,39645178,39646178,True,1,1000
9622,39673669,39675624,True,3,1955
9623,39674110,39674287,False,1,177
9624,39676026,39676413,True,1,387
9625,39701537,39712044,True,1,10507
9626,39713430,39751058,False,1,37628
9627,39726369,39727600,False,2,1231
9628,39726369,39727600,True,1,1231
9629,39727803,39728657,True,2,854
9630,39734588,39737372,True,1,2784
9631,39736535,39739244,False,1,2709
9632,39736535,39740525,False,1,3990
9633,39739686,39742976,True,1,3290
9634,39740511,39785950,True,1,45439
9635,39742158,39743449,True,2,1291
9636,39764237,39774906,False,2,10669
9637,39764503,39764708,True,2,205
9638,39782791,39785794,False,1,3003
9639,39789059,39791151,False,1,2092
9640,39794313,39799019,False,1,4706
9641,39809635,39885992,True,1,76357
9642,39809988,39820357,True,1,10369
9643,39809988,39821268,True,1,11280
9644,39819855,39826434,True,1,6579
9645,39825385,39912590,True,1,87205
9646,39831585,39852999,True,1,21414
9647,39838545,39839191,False,1,646
9648,39839120,39840848,False,1,1728
9649,39842261,39845005,True,2,2744
9650,39847073,39850749,False,1,3676
9651,39847073,39850749,True,1,3676
9652,39847073,39867220,False,1,20147
9653,39847073,39872062,True,2,24989
9654,39847073,39873436,True,1,26363
9655,39847073,39904973,True,1,57900
9656,39858682,39877982,True,1,19300
9657,39862802,39863473,False,1,671
9658,39866431,39878880,True,2,12449
9659,39866431,39886600,True,1,20169
9660,39867591,39869213,False,1,1622
9661,39867591,39895425,False,1,27834
9662,39872280,39880457,False,1,8177
9663,39877034,39887179,True,1,10145
9664,39878221,39887764,True,1,9543
9665,39897533,39897939,True,1,406
9666,39897533,39898475,False,1,942
9667,39897533,39898769,True,1,1236
9668,39915667,39916138,True,1,471
9669,39915667,39916808,True,1,1141
9670,39939594,39951225,True,1,11631
9671,39939613,39951225,True,1,11612
9672,39940021,39951405,True,1,11384
9673,39940655,39951710,True,1,11055
9674,39941606,39952169,True,1,10563
9675,39943889,39953368,True,1,9479
9676,39944786,39953762,True,1,8976
9677,39948267,39955606,True,1,7339
9678,39953521,39966001,True,1,12480
9679,39953521,39978994,False,1,25473
9680,39953521,39978994,True,1,25473
9681,39953923,39976851,True,1,22928
9682,39972992,39974498,False,1,1506
9683,39972992,39974498,True,1,1506
9684,39977584,39980867,False,1,3283
9685,39977584,39980867,True,2,3283
9686,39980698,39990276,True,2,9578
9687,39984739,39996837,True,1,12098
9688,39994322,39996103,False,2,1781
9689,39994322,39996103,True,5,1781
9690,39996026,40001031,True,2,5005
9691,39997123,40001536,True,1,4413
9692,39999476,40004985,False,1,5509
9693,40005752,40007132,False,1,1380
9694,40005752,40007132,True,3,1380
9695,40005752,40007477,True,1,1725
9696,40009268,40011255,True,1,1987
9697,40010402,40012736,False,1,2334
9698,40014270,40015746,False,1,1476
9699,40017289,40032913,False,1,15624
9700,40017289,40032913,True,8,15624
9701,40017399,40032911,True,1,15512
9702,40017941,40018513,True,2,572
9703,40018642,40029630,True,1,10988
9704,40023621,40037808,True,2,14187
9705,40032017,40032976,True,1,959
9706,40043118,40047136,False,1,4018
9707,40048899,40055158,False,1,6259
9708,40051346,40053723,True,5,2377
9709,40054509,40069355,True,1,14846
9710,40056983,40057393,True,1,410
9711,40066392,40070417,True,1,4025
9712,40066392,40070445,True,1,4053
9713,40066392,40084653,True,1,18261
9714,40074729,40088785,True,1,14056
9715,40086054,40096006,True,1,9952
9716,40087033,40125286,True,1,38253
9717,40087033,40127852,True,1,40819
9718,40088442,40088735,True,1,293
9719,40089061,40101886,True,1,12825
9720,40098383,40106639,True,1,8256
9721,40109756,40116696,True,1,6940
9722,40118855,40166950,True,3,48095
9723,40118855,40190030,True,1,71175
9724,40125123,40131421,True,2,6298
9725,40135660,40140962,True,2,5302
9726,40137327,40137869,False,3,542
9727,40141014,40145897,True,1,4883
9728,40142101,40144845,True,1,2744
9729,40143680,40144483,True,1,803
9730,40144168,40144971,True,1,803
9731,40149528,40151874,True,1,2346
9732,40154747,40161095,True,1,6348
9733,40163795,40195346,True,1,31551
9734,40193400,40194141,True,1,741
9735,40199705,40199820,True,2,115
9736,40199727,40199820,True,1,93
9737,40202558,40209742,True,2,7184
9738,40205958,40206214,True,1,256
9739,40210210,40211557,True,3,1347
9740,40211491,40396073,True,2,184582
9741,40211549,40213966,True,1,2417
9742,40214677,40214853,True,1,176
9743,40219730,40222615,False,1,2885
9744,40223497,40223824,False,1,327
9745,40223497,40223824,True,2,327
9746,40223497,40240183,True,1,16686
9747,40233310,40249037,True,3,15727
9748,40233310,40265376,True,1,32066
9749,40238937,40246078,True,2,7141
9750,40253029,40254964,True,1,1935
9751,40254158,40255138,True,1,980
9752,40266708,40280001,False,1,13293
9753,40270158,40270772,True,1,614
9754,40272431,40272504,True,1,73
9755,40289064,40291267,True,1,2203
9756,40335580,40340182,False,1,4602
9757,40341666,40342253,True,5,587
9758,40355059,40368092,True,2,13033
9759,40355878,40356340,True,1,462
9760,40355996,40356341,True,1,345
9761,40363163,40363506,True,1,343
9762,40363181,40368586,False,1,5405
9763,40373026,40373828,False,1,802
9764,40377746,40403848,True,1,26102
9765,40377746,40404830,False,1,27084
9766,40384739,40385870,True,1,1131
9767,40388229,40390952,True,1,2723
9768,40404802,40414298,True,6,9496
9769,40404802,40418579,True,1,13777
9770,40405235,40411474,True,1,6239
9771,40412407,40415065,False,1,2658
9772,40415888,40424040,True,2,8152
9773,40418114,40425763,True,1,7649
9774,40422242,40422468,True,8,226
9775,40431752,40431960,False,1,208
9776,40442013,40443142,True,1,1129
9777,40449459,40451980,False,1,2521
9778,40459570,40459864,True,1,294
9779,40459570,40484529,True,1,24959
9780,40465450,40466486,True,1,1036
9781,40473745,40473843,True,1,98
9782,40493741,40495588,True,1,1847
9783,40510851,40513527,True,2,2676
9784,40554508,40556808,True,1,2300
9785,40556191,40573185,True,1,16994
9786,40585908,40586867,False,1,959
9787,40604107,40604617,False,1,510
9788,40604107,40604617,True,1,510
9789,40604259,40606429,True,4,2170
9790,40605044,40605685,True,1,641
9791,40637809,40638620,False,1,811
9792,40644413,40647787,True,4,3374
9793,40651282,40654107,False,1,2825
9794,40652937,40654916,False,2,1979
9795,40656137,40658143,False,1,2006
9796,40682084,40684474,False,1,2390
9797,40689069,40691174,True,3,2105
9798,40691539,40698488,True,3,6949
9799,40706607,40707967,True,3,1360
9800,40709873,40727264,True,1,17391
9801,40725545,40725628,True,1,83
9802,40726323,40728385,True,1,2062
9803,40741380,40742379,True,1,999
9804,40741505,40741922,True,1,417
9805,40742280,40773982,True,2,31702
9806,40744168,40747608,True,2,3440
9807,40744168,40762940,True,1,18772
9808,40755811,40756092,True,1,281
9809,40767650,40768840,False,2,1190
9810,40770525,40771011,True,1,486
9811,40770590,40771027,True,1,437
9812,40770746,40771069,True,1,323
9813,40771380,40774120,True,2,2740
9814,40773228,40773682,False,1,454
9815,40776310,40776390,False,3,80
9816,40787697,40788782,False,1,1085
9817,40793658,40808012,True,1,14354
9818,40796998,40807238,True,2,10240
9819,40803253,40803403,True,2,150
9820,40803308,40804967,True,1,1659
9821,40804992,40882211,True,2,77219
9822,40807774,40808824,False,1,1050
9823,40807972,40883984,True,1,76012
9824,40809902,40810061,False,1,159
9825,40818395,40818638,True,1,243
9826,40818395,40820363,True,2,1968
9827,40823553,40824430,True,1,877
9828,40823553,40837085,True,1,13532
9829,40841842,40843645,True,2,1803
9830,40845550,40845707,False,1,157
9831,40864569,40868934,False,1,4365
9832,40879894,40881140,True,1,1246
9833,40879894,40881966,True,1,2072
9834,40899929,40902033,True,7,2104
9835,40902987,40937844,False,1,34857
9836,40902987,41042825,False,1,139838
9837,40905680,40927839,True,1,22159
9838,40925861,40926263,True,1,402
9839,40925861,40926559,True,1,698
9840,40925861,40934285,False,1,8424
9841,40925861,40934285,True,1,8424
9842,40925861,40939695,True,2,13834
9843,40931858,40932479,True,1,621
9844,40966357,40966496,True,1,139
9845,40974059,40975653,True,1,1594
9846,40976223,40976743,False,1,520
9847,40976994,40979493,False,1,2499
9848,40981133,40989768,True,1,8635
9849,41025223,41029615,True,1,4392
9850,41026821,41030009,True,1,3188
9851,41027879,41030553,True,1,2674
9852,41027960,41030553,True,1,2593
9853,41028065,41030553,True,1,2488
9854,41029449,41031427,True,1,1978
9855,41032716,41035532,False,1,2816
9856,41045356,41231770,True,1,186414
9857,41065758,41066943,True,1,1185
9858,41065790,41066905,True,3,1115
9859,41066072,41067069,True,1,997
9860,41068164,41073356,True,1,5192
9861,41069492,41070003,True,2,511
9862,41069492,41070267,True,2,775
9863,41093323,41095391,True,1,2068
9864,41096766,41100056,True,2,3290
9865,41103037,41103118,False,1,81
9866,41108344,41108464,True,1,120
9867,41152754,41153910,True,1,1156
9868,41157631,41170373,True,1,12742
9869,41158592,41172898,False,1,14306
9870,41177076,41224711,True,1,47635
9871,41177252,41224887,False,1,47635
9872,41196438,41198451,False,1,2013
9873,41199435,41199874,True,2,439
9874,41224042,41272767,False,1,48725
9875,41227631,41249993,True,1,22362
9876,41231536,41235552,False,1,4016
9877,41234992,41254478,True,3,19486
9878,41242166,41243618,True,2,1452
9879,41264690,41269332,False,1,4642
9880,41269452,41269974,False,1,522
9881,41269452,41269974,True,2,522
9882,41281692,41283900,True,1,2208
9883,41289263,41290080,True,1,817
9884,41310704,41318130,True,1,7426
9885,41315461,41316222,True,1,761
9886,41316766,41316996,True,1,230
9887,41318702,41322052,False,1,3350
9888,41318702,41322052,True,1,3350
9889,41374236,41374554,True,3,318
9890,41374827,41374928,False,2,101
9891,41382440,41387149,True,1,4709
9892,41382440,41390592,True,4,8152
9893,41390613,41391080,False,1,467
9894,41396040,41403991,False,1,7951
9895,41404176,41404319,True,1,143
9896,41404236,41405414,True,1,1178
9897,41404236,41408122,True,1,3886
9898,41404269,41408122,False,1,3853
9899,41404445,41408122,True,3,3677
9900,41410088,41422780,True,1,12692
9901,41417742,41418219,True,1,477
9902,41417742,41420554,False,1,2812
9903,41417742,41458976,True,1,41234
9904,41429142,41483327,True,1,54185
9905,41429161,41483327,True,1,54166
9906,41429838,41447421,True,1,17583
9907,41432297,41484526,True,1,52229
9908,41435878,41436388,True,1,510
9909,41448036,41448127,False,1,91
9910,41449579,41456076,True,1,6497
9911,41449902,41491172,True,1,41270
9912,41461990,41463865,True,8,1875
9913,41471704,41504588,True,1,32884
9914,41475933,41476588,True,1,655
9915,41487325,41492387,False,1,5062
9916,41489177,41491448,False,1,2271
9917,41492665,41493165,True,1,500
9918,41493596,41494016,True,2,420
9919,41497028,41497255,True,1,227
9920,41497028,41498025,True,1,997
9921,41497356,41498025,True,2,669
9922,41497356,41503324,True,1,5968
9923,41515205,41517440,True,2,2235
9924,41525117,41528936,True,1,3819
9925,41525345,41528523,True,1,3178
9926,41535518,41537214,True,1,1696
9927,41535529,41536566,True,1,1037
9928,41543743,41562648,False,1,18905
9929,41543743,41567286,False,1,23543
9930,41550758,41556615,True,2,5857
9931,41555772,41576811,False,1,21039
9932,41559437,41561151,True,5,1714
9933,41559442,41560556,True,2,1114
9934,41562880,41568464,True,1,5584
9935,41567420,41568027,False,1,607
9936,41583570,41592313,True,1,8743
9937,41592530,41596533,True,2,4003
9938,41593734,41599817,True,5,6083
9939,41611200,41631232,True,1,20032
9940,41611200,41646992,True,1,35792
9941,41617198,41618248,True,1,1050
9942,41618050,41618244,True,4,194
9943,41619095,41620588,True,1,1493
9944,41623618,41624861,True,3,1243
9945,41635793,41636038,True,2,245
9946,41635905,41636038,True,1,133
9947,41636568,41641217,True,1,4649
9948,41640716,41641230,True,1,514
9949,41644649,41645209,True,1,560
9950,41647307,41647458,True,1,151
9951,41647307,41648288,True,1,981
9952,41653852,41654500,True,1,648
9953,41655762,41655996,True,1,234
9954,41663660,41672462,False,1,8802
9955,41666347,41667971,False,1,1624
9956,41669087,41669890,False,1,803
9957,41670543,41670780,True,2,237
9958,41672784,41673021,False,1,237
9959,41672784,41673021,True,1,237
9960,41674894,41677213,True,1,2319
9961,41679438,41680815,True,1,1377
9962,41680729,41684887,True,1,4158
9963,41683823,41694264,True,1,10441
9964,41696834,41696956,True,3,122
9965,41697139,41700882,True,1,3743
9966,41697139,41707279,True,1,10140
9967,41723918,41753287,True,5,29369
9968,41723926,41753306,True,1,29380
9969,41725069,41753740,True,1,28671
9970,41733813,41736645,True,1,2832
9971,41741086,41742823,True,1,1737
9972,41742690,41744848,False,1,2158
9973,41749762,41751236,True,1,1474
9974,41754009,41765620,False,4,11611
9975,41754009,41765620,True,2,11611
9976,41756071,41769331,True,1,13260
9977,41771671,41786145,True,1,14474
9978,41772160,41786634,False,1,14474
9979,41772160,41786634,True,6,14474
9980,41783676,41785348,False,1,1672
9981,41787078,41792854,False,1,5776
9982,41787078,41828315,True,1,41237
9983,41794529,41794628,True,1,99
9984,41809291,41810418,True,3,1127
9985,41817960,41827260,True,1,9300
9986,41823413,41825362,False,1,1949
9987,41823413,41838432,True,1,15019
9988,41823413,41842998,False,1,19585
9989,41824285,41825880,False,1,1595
9990,41824285,41825880,True,1,1595
9991,41824285,41838950,True,1,14665
9992,41824936,41826231,True,1,1295
9993,41830644,41830785,True,1,141
9994,41831219,41835531,False,1,4312
9995,41831219,41846862,True,1,15643
9996,41831219,41860386,False,1,29167
9997,41841857,41843559,True,1,1702
9998,41846776,41847024,True,1,248
9999,41846786,41847024,True,1,238
10000,41846837,41847024,True,1,187
10001,41846842,41847024,True,1,182
10002,41852872,41853374,True,2,502
10003,41857483,41864860,True,1,7377
10004,41868212,41868689,True,1,477
10005,41869852,41886288,False,1,16436
10006,41873221,41873312,True,1,91
10007,41875231,41878002,True,3,2771
10008,41886026,41886138,True,1,112
10009,41889304,41891143,True,2,1839
10010,41918396,41934425,False,1,16029
10011,41920375,41924280,True,1,3905
10012,41927335,41930093,True,1,2758
10013,41927335,41932243,True,1,4908
10014,41937363,41976567,True,2,39204
10015,41941245,41946343,False,1,5098
10016,41944216,41946996,True,1,2780
10017,41947873,41952319,True,1,4446
10018,41951103,41983456,False,1,32353
10019,41956186,41956577,True,3,391
10020,41957280,41957371,True,3,91
10021,41958172,41966974,False,1,8802
10022,41981761,41983211,True,4,1450
10023,42010740,42011640,True,1,900
10024,42012191,42019486,True,1,7295
10025,42013482,42014382,True,1,900
10026,42049493,42050948,True,2,1455
10027,42049493,42051023,True,2,1530
10028,42049493,42051990,True,2,2497
10029,42049493,42052745,True,1,3252
10030,42049493,42053282,True,1,3789
10031,42060544,42105569,True,1,45025
10032,42066252,42075712,True,3,9460
10033,42069106,42073338,False,1,4232
10034,42081632,42083271,False,1,1639
10035,42081632,42083271,True,1,1639
10036,42092336,42093457,True,1,1121
10037,42094712,42095471,False,1,759
10038,42094712,42095471,True,2,759
10039,42103706,42106771,True,4,3065
10040,42111995,42112273,False,1,278
10041,42117447,42123388,False,1,5941
10042,42124364,42125560,True,2,1196
10043,42130737,42173908,True,1,43171
10044,42139250,42144795,True,1,5545
10045,42139289,42140857,True,1,1568
10046,42140754,42141204,True,5,450
10047,42143752,42145031,True,1,1279
10048,42143754,42145031,False,1,1277
10049,42143754,42145031,True,2,1277
10050,42162447,42164207,True,1,1760
10051,42167117,42167766,True,4,649
10052,42189311,42333513,False,1,144202
10053,42203415,42215509,True,1,12094
10054,42203415,42218664,True,1,15249
10055,42204645,42205235,True,1,590
10056,42212267,42222886,True,3,10619
10057,42212267,42223811,True,1,11544
10058,42212280,42222886,False,1,10606
10059,42213468,42219359,True,3,5891
10060,42213468,42232827,True,1,19359
10061,42218053,42221679,False,1,3626
10062,42223710,42224779,True,2,1069
10063,42231137,42233031,True,1,1894
10064,42233785,42248377,True,1,14592
10065,42238874,42246457,True,1,7583
10066,42239635,42251016,True,1,11381
10067,42239658,42240103,True,1,445
10068,42244146,42247759,False,1,3613
10069,42256815,42261965,True,1,5150
10070,42266777,42270013,True,6,3236
10071,42268002,42271771,True,1,3769
10072,42269501,42276199,False,1,6698
10073,42282602,42283014,True,2,412
10074,42282602,42289724,True,2,7122
10075,42285659,42286000,False,1,341
10076,42288925,42289600,True,1,675
10077,42291861,42293468,False,1,1607
10078,42305252,42314039,False,1,8787
10079,42305252,42314039,True,1,8787
10080,42305252,42319847,True,1,14595
10081,42305744,42306148,True,1,404
10082,42311667,42321028,False,1,9361
10083,42313964,42318635,True,1,4671
10084,42313964,42324443,True,1,10479
10085,42337343,42340809,True,1,3466
10086,42339978,42342208,True,1,2230
10087,42339978,42342315,False,1,2337
10088,42339978,42342315,True,2,2337
10089,42340667,42341440,True,1,773
10090,42350638,42351118,False,1,480
10091,42361250,42372031,True,1,10781
10092,42361250,42377671,True,1,16421
10093,42368840,42371543,False,1,2703
10094,42376248,42387363,True,1,11115
10095,42376248,42389690,True,1,13442
10096,42379949,42389818,True,1,9869
10097,42382750,42393070,True,1,10320
10098,42398067,42398382,True,1,315
10099,42402766,42440536,False,1,37770
10100,42407034,42409018,True,2,1984
10101,42417715,42417857,True,2,142
10102,42426926,42437914,True,1,10988
10103,42428249,42429810,True,1,1561
10104,42430643,42430738,True,1,95
10105,42450506,42451439,True,1,933
10106,42473250,42474875,True,1,1625
10107,42490237,42506065,True,1,15828
10108,42498706,42499061,True,1,355
10109,42500460,42505505,False,1,5045
10110,42530106,42531734,False,2,1628
10111,42530106,42531734,True,2,1628
10112,42535625,42535719,True,3,94
10113,42539502,42563443,True,3,23941
10114,42539766,42539920,True,3,154
10115,42539766,42540468,True,1,702
10116,42540004,42542411,True,2,2407
10117,42544246,42559778,True,1,15532
10118,42555064,42555614,True,1,550
10119,42559923,42591527,True,1,31604
10120,42568052,42590856,True,1,22804
10121,42568052,42591067,True,1,23015
10122,42568297,42578573,True,1,10276
10123,42568916,42591346,True,1,22430
10124,42594087,42598959,False,1,4872
10125,42606427,42609050,True,3,2623
10126,42611315,42697603,False,1,86288
10127,42611315,42697603,True,1,86288
10128,42617086,42620276,True,1,3190
10129,42623464,42630367,False,1,6903
10130,42624825,42639372,False,1,14547
10131,42638912,42641508,True,2,2596
10132,42643037,42643537,True,2,500
10133,42648370,42653378,False,1,5008
10134,42648370,42656953,False,1,8583
10135,42649828,42651191,True,3,1363
10136,42667741,42668057,True,1,316
10137,42673417,42673871,True,2,454
10138,42683664,42684089,True,1,425
10139,42684026,42747733,False,1,63707
10140,42708781,42708994,True,2,213
10141,42709525,42712569,True,1,3044
10142,42713328,42713415,False,1,87
10143,42713328,42719164,False,1,5836
10144,42719171,42719400,True,1,229
10145,42721434,42724102,True,1,2668
10146,42725052,42729861,True,1,4809
10147,42726233,42728166,False,1,1933
10148,42726237,42728166,False,1,1929
10149,42738990,42739670,True,1,680
10150,42739090,42739692,False,1,602
10151,42739090,42739692,True,2,602
10152,42739097,42739704,False,1,607
10153,42753175,42753598,True,1,423
10154,42766525,42766629,True,2,104
10155,42775062,42775292,True,1,230
10156,42775062,42811423,True,1,36361
10157,42785614,42837148,True,4,51534
10158,42793383,42795116,False,1,1733
10159,42800662,42801891,False,3,1229
10160,42827579,42827830,False,3,251
10161,42827703,42829443,False,1,1740
10162,42827859,42827971,True,1,112
10163,42828788,42830149,True,1,1361
10164,42829743,42849960,True,1,20217
10165,42829778,42849960,True,1,20182
10166,42830794,42830905,False,1,111
10167,42831174,42831286,False,1,112
10168,42832447,42833806,True,2,1359
10169,42834220,42834940,True,1,720
10170,42840234,42844934,True,5,4700
10171,42847324,42847553,True,1,229
10172,42856206,42872944,True,1,16738
10173,42870369,42885827,True,1,15458
10174,42873157,42874562,False,1,1405
10175,42897003,42898613,True,1,1610
10176,42906162,42909239,True,2,3077
10177,42910209,42931162,False,1,20953
10178,42914819,42927520,True,1,12701
10179,42916200,42916351,True,4,151
10180,42918241,42918614,False,1,373
10181,42919281,42919373,False,1,92
10182,42919281,42919373,True,3,92
10183,42925428,42927942,True,1,2514
10184,42925954,42926327,True,1,373
10185,42926532,42926639,True,1,107
10186,42935133,42935312,True,2,179
10187,42935564,42935981,True,2,417
10188,42938285,42939176,False,1,891
10189,42950337,42951058,False,1,721
10190,42951503,42966008,True,3,14505
10191,42954271,42957578,True,1,3307
10192,42957156,42979283,False,1,22127
10193,42968218,42971566,True,1,3348
10194,42970842,42971065,True,16,223
10195,42984782,42985706,True,1,924
10196,42996807,42997014,True,1,207
10197,43003433,43003791,True,1,358
10198,43020985,43021494,False,1,509
10199,43020985,43021494,True,1,509
10200,43051739,43052070,True,1,331
10201,43077084,43079728,False,1,2644
10202,43077084,43079728,True,4,2644
10203,43077878,43078410,False,2,532
10204,43083679,43086300,True,2,2621
10205,43090102,43094956,True,1,4854
10206,43090363,43091977,True,4,1614
10207,43090363,43095480,True,1,5117
10208,43096678,43101003,True,2,4325
10209,43100441,43101503,True,3,1062
10210,43117503,43117772,True,3,269
10211,43119751,43121938,True,1,2187
10212,43124834,43125137,True,1,303
10213,43127817,43330725,True,1,202908
10214,43134452,43136329,True,1,1877
10215,43145738,43216838,True,1,71100
10216,43159989,43167849,True,4,7860
10217,43159989,43185633,True,1,25644
10218,43166046,43167454,True,2,1408
10219,43181285,43183837,True,2,2552
10220,43189385,43194205,True,1,4820
10221,43189385,43238485,True,1,49100
10222,43222074,43234819,True,2,12745
10223,43233076,43240448,False,1,7372
10224,43236066,43236257,False,1,191
10225,43236066,43238124,False,1,2058
10226,43240018,43240207,False,1,189
10227,43245123,43245744,True,2,621
10228,43257601,43264865,True,1,7264
10229,43274245,43281399,False,1,7154
10230,43275277,43278582,False,1,3305
10231,43286518,43288371,False,1,1853
10232,43305518,43306997,True,1,1479
10233,43309580,43314515,False,1,4935
10234,43309580,43314515,True,1,4935
10235,43309580,43316013,False,1,6433
10236,43309580,43319925,False,1,10345
10237,43316519,43321557,True,1,5038
10238,43330246,43331797,False,1,1551
10239,43332508,43334552,False,1,2044
10240,43333324,43335421,False,1,2097
10241,43333550,43335550,False,2,2000
10242,43338007,43452738,False,1,114731
10243,43338329,43343005,False,1,4676
10244,43354054,43357920,False,1,3866
10245,43356760,43356858,False,2,98
10246,43356760,43356858,True,7,98
10247,43358651,43358893,True,2,242
10248,43358667,43359073,True,1,406
10249,43361324,43362534,False,1,1210
10250,43361954,43362802,False,1,848
10251,43372932,43373370,True,2,438
10252,43374565,43376054,True,1,1489
10253,43377012,43400894,True,2,23882
10254,43379231,43381312,True,1,2081
10255,43379760,43380068,True,1,308
10256,43391622,43392298,True,1,676
10257,43429472,43429675,True,1,203
10258,43432641,43432771,True,1,130
10259,43432902,43437496,True,1,4594
10260,43438036,43442007,True,5,3971
10261,43438036,43454617,True,2,16581
10262,43438930,43442500,True,1,3570
10263,43448601,43475861,False,1,27260
10264,43448601,43479754,True,1,31153
10265,43457022,43457563,True,2,541
10266,43457022,43459792,True,1,2770
10267,43458611,43478337,False,2,19726
10268,43458691,43478329,False,1,19638
10269,43459509,43460941,False,1,1432
10270,43459509,43478766,False,1,19257
10271,43459863,43460563,True,1,700
10272,43472627,43475569,False,1,2942
10273,43485255,43487037,True,3,1782
10274,43500956,43501559,False,1,603
10275,43501227,43501420,True,1,193
10276,43503317,43506670,True,3,3353
10277,43512355,43518969,True,1,6614
10278,43523719,43524390,False,1,671
10279,43533423,43538021,True,4,4598
10280,43533825,43534565,True,3,740
10281,43540646,43544811,False,1,4165
10282,43543541,43568738,True,1,25197
10283,43547792,43576632,True,1,28840
10284,43554478,43601545,True,1,47067
10285,43558061,43603290,False,1,45229
10286,43568294,43569097,True,1,803
10287,43571721,43573886,True,2,2165
10288,43576917,43578277,True,2,1360
10289,43578978,43579428,True,1,450
10290,43578978,43579431,True,1,453
10291,43579182,43579531,True,1,349
10292,43580142,43582738,True,1,2596
10293,43585311,43585471,True,1,160
10294,43593894,43595957,True,1,2063
10295,43605414,43618064,False,1,12650
10296,43605414,43618064,True,8,12650
10297,43605589,43618070,True,1,12481
10298,43607927,43609062,False,1,1135
10299,43610995,43612724,True,1,1729
10300,43612934,43613033,True,1,99
10301,43616383,43617019,True,1,636
10302,43636224,43655928,True,1,19704
10303,43640607,43641275,True,1,668
10304,43643361,43643639,True,1,278
10305,43643737,43643861,True,1,124
10306,43643908,43644846,False,1,938
10307,43644876,43644987,False,1,111
10308,43644931,43645081,False,1,150
10309,43646523,43646672,False,1,149
10310,43646523,43646672,True,1,149
10311,43646549,43646672,True,4,123
10312,43647306,43651333,False,2,4027
10313,43647306,43651333,True,2,4027
10314,43647306,43698794,False,1,51488
10315,43650943,43651463,True,1,520
10316,43654980,43656170,False,2,1190
10317,43654980,43656170,True,1,1190
10318,43661717,43662741,True,2,1024
10319,43663872,43663952,True,1,80
10320,43671867,43716326,True,2,44459
10321,43671867,43722974,True,2,51107
10322,43691761,43755472,False,1,63711
10323,43697070,43698429,False,1,1359
10324,43697070,43698429,True,3,1359
10325,43703067,43703158,True,1,91
10326,43707687,43712456,True,2,4769
10327,43715582,43718941,True,2,3359
10328,43735531,43735625,True,4,94
10329,43736927,43737007,True,1,80
10330,43743114,43758076,True,1,14962
10331,43743482,43743596,True,1,114
10332,43744764,43747819,False,2,3055
10333,43755692,43758240,True,1,2548
10334,43763778,43763877,True,2,99
10335,43764913,43765078,True,2,165
10336,43766212,43776671,True,1,10459
10337,43781377,43782106,False,1,729
10338,43782761,43783134,False,1,373
10339,43797965,43808649,False,1,10684
10340,43800901,43801081,True,2,180
10341,43805984,43806218,True,1,234
10342,43807674,43850883,True,1,43209
10343,43808273,43813483,False,1,5210
10344,43812176,43846640,True,1,34464
10345,43817633,43833659,True,2,16026
10346,43822377,43835294,True,1,12917
10347,43822501,43843324,False,1,20823
10348,43824845,43836541,True,2,11696
10349,43824845,43836674,True,1,11829
10350,43830851,43839589,True,1,8738
10351,43831808,43835154,True,1,3346
10352,43833692,43840899,True,1,7207
10353,43833692,43841032,True,1,7340
10354,43837445,43844063,True,1,6618
10355,43843895,43868983,True,2,25088
10356,43843895,43886979,True,1,43084
10357,43844684,43869166,True,1,24482
10358,43846464,43846884,True,4,420
10359,43848752,43848942,True,2,190
10360,43848752,43849384,True,1,632
10361,43856640,43857685,False,1,1045
10362,43856640,43857685,True,3,1045
10363,43882486,43883110,True,4,624
10364,43887782,43888223,True,1,441
10365,43890777,43890987,True,2,210
10366,43890777,43900942,True,1,10165
10367,43893522,43898662,False,1,5140
10368,43893522,43898662,True,2,5140
10369,43897503,43899507,False,1,2004
10370,43897503,43902280,False,2,4777
10371,43897503,43902280,True,2,4777
10372,43904438,43909253,True,1,4815
10373,43911505,43912491,True,1,986
10374,43916352,43917037,True,1,685
10375,43917681,43944002,True,3,26321
10376,43917991,43918167,True,1,176
10377,43925417,43932828,False,1,7411
10378,43929385,43933162,True,1,3777
10379,43929788,43930024,True,1,236
10380,43930240,43931031,True,1,791
10381,43932794,43933448,True,2,654
10382,43935991,43936322,True,1,331
10383,43935991,43938649,True,3,2658
10384,43938325,43938922,False,1,597
10385,43939338,43940607,True,1,1269
10386,43939797,43941145,True,1,1348
10387,43945206,43945742,True,2,536
10388,43947718,43950239,True,1,2521
10389,43965453,43965674,False,1,221
10390,43965453,43965674,True,1,221
10391,43965453,43965972,True,1,519
10392,43972321,43973537,True,1,1216
10393,43974201,43974492,True,2,291
10394,43979850,43980437,True,2,587
10395,43979850,43982941,True,2,3091
10396,43980359,43988438,True,7,8079
10397,43983019,43983424,True,1,405
10398,43983019,43994212,True,1,11193
10399,43989949,44024219,False,3,34270
10400,43989949,44041537,False,11,51588
10401,43991166,43995106,True,2,3940
10402,43991597,43991682,True,2,85
10403,43993353,43993690,True,1,337
10404,43993662,43994094,True,1,432
10405,44009147,44011573,True,1,2426
10406,44009147,44011696,True,1,2549
10407,44010723,44012090,True,5,1367
10408,44010832,44013342,True,2,2510
10409,44013364,44014489,True,1,1125
10410,44014621,44015441,True,1,820
10411,44026116,44028849,True,1,2733
10412,44032778,44032823,True,1,45
10413,44038566,44039268,True,3,702
10414,44038671,44039373,True,1,702
10415,44039183,44095112,False,1,55929
10416,44039183,44106261,True,1,67078
10417,44040692,44044472,True,5,3780
10418,44045718,44053765,False,4,8047
10419,44045718,44053765,True,5,8047
10420,44045898,44053949,False,1,8051
10421,44069649,44083802,False,1,14153
10422,44079941,44080696,True,1,755
10423,44081477,44089342,True,1,7865
10424,44081477,44097301,True,1,15824
10425,44081477,44097401,True,1,15924
10426,44091160,44093573,True,1,2413
10427,44095184,44095669,True,1,485
10428,44102161,44107505,True,2,5344
10429,44103936,44105573,False,1,1637
10430,44103936,44105573,True,1,1637
10431,44107332,44109482,False,1,2150
10432,44107332,44109482,True,1,2150
10433,44109550,44110533,True,1,983
10434,44112825,44121336,True,1,8511
10435,44134319,44136125,True,2,1806
10436,44152692,44154776,True,1,2084
10437,44154397,44154778,True,1,381
10438,44156615,44158952,True,2,2337
10439,44180109,44180446,True,1,337
10440,44198225,44198245,False,1,20
10441,44205314,44205574,True,1,260
10442,44206055,44207660,False,1,1605
10443,44206055,44207660,True,1,1605
10444,44207834,44212040,True,2,4206
10445,44222343,44222630,True,1,287
10446,44227462,44233861,False,1,6399
10447,44231063,44244539,False,1,13476
10448,44231063,44265646,False,4,34583
10449,44231798,44273288,True,1,41490
10450,44232475,44237428,True,1,4953
10451,44246927,44250478,True,1,3551
10452,44247092,44250643,True,1,3551
10453,44264712,44265121,False,1,409
10454,44265720,44269661,True,2,3941
10455,44266466,44270100,False,1,3634
10456,44266621,44269931,True,1,3310
10457,44271728,44281736,True,1,10008
10458,44277786,44279646,True,1,1860
10459,44285152,44285421,False,1,269
10460,44285152,44286641,False,9,1489
10461,44294403,44321107,False,1,26704
10462,44296046,44296157,False,1,111
10463,44298717,44298843,True,3,126
10464,44306505,44318912,True,1,12407
10465,44311272,44313126,True,1,1854
10466,44315225,44316450,True,1,1225
10467,44320046,44323127,True,1,3081
10468,44339394,44339545,False,1,151
10469,44341030,44345965,True,1,4935
10470,44361162,44361336,True,1,174
10471,44362336,44368757,False,1,6421
10472,44384188,44384277,True,2,89
10473,44391296,44393998,False,1,2702
10474,44398606,44407190,False,1,8584
10475,44398606,44407190,True,1,8584
10476,44408991,44409426,True,1,435
10477,44408991,44422151,True,1,13160
10478,44413453,44439670,True,1,26217
10479,44416372,44447842,False,1,31470
10480,44417618,44418485,False,1,867
10481,44421036,44422093,True,1,1057
10482,44427534,44427618,True,1,84
10483,44429799,44440069,True,2,10270
10484,44434919,44435094,True,1,175
10485,44435591,44454564,False,1,18973
10486,44435591,44454564,True,1,18973
10487,44449682,44486968,True,3,37286
10488,44450299,44487256,True,1,36957
10489,44470702,44478573,True,1,7871
10490,44470702,44490874,True,1,20172
10491,44473572,44473759,True,1,187
10492,44491542,44500393,True,1,8851
10493,44510229,44512102,False,1,1873
10494,44531094,44531220,True,1,126
10495,44551635,44553731,True,2,2096
10496,44555872,44685691,False,1,129819
10497,44556133,44558835,False,3,2702
10498,44559283,44564766,True,1,5483
10499,44575294,44577873,True,3,2579
10500,44587353,44587602,False,1,249
10501,44587385,44587609,True,1,224
10502,44589453,44591819,False,1,2366
10503,44597453,44630947,True,4,33494
10504,44606465,44622058,False,1,15593
10505,44606465,44622058,True,1,15593
10506,44606992,44608277,True,2,1285
10507,44617553,44622945,True,6,5392
10508,44617553,44625170,True,1,7617
10509,44618793,44618987,True,1,194
10510,44623369,44624264,True,3,895
10511,44624467,44624904,True,1,437
10512,44629707,44629825,True,1,118
10513,44629707,44629882,True,1,175
10514,44630507,44849682,False,1,219175
10515,44641315,44641422,True,2,107
10516,44656358,44657642,True,1,1284
10517,44658501,44660467,False,1,1966
10518,44674070,44674236,True,1,166
10519,44691646,44694034,False,1,2388
10520,44701296,44748262,True,2,46966
10521,44703571,44708477,False,1,4906
10522,44704177,44708812,False,1,4635
10523,44712226,44712426,True,2,200
10524,44716400,44717854,True,1,1454
10525,44719831,44722738,True,1,2907
10526,44725355,44725483,False,1,128
10527,44726290,44737718,True,1,11428
10528,44741568,45023528,True,1,281960
10529,44741568,45035054,True,1,293486
10530,44758354,44779704,True,1,21350
10531,44758354,44779764,True,1,21410
10532,44758354,44784039,True,5,25685
10533,44760076,44760161,True,1,85
10534,44760980,44761107,False,1,127
10535,44762719,44762932,False,2,213
10536,44771441,44815357,False,1,43916
10537,44772832,44772990,False,1,158
10538,44772832,44772990,True,1,158
10539,44779566,44779705,True,3,139
10540,44784600,44784763,True,1,163
10541,44800570,44801054,False,1,484
10542,44818739,44818880,True,2,141
10543,44818785,44821213,False,1,2428
10544,44818785,44821213,True,1,2428
10545,44832045,44838323,True,1,6278
10546,44844372,44847472,True,1,3100
10547,44846563,44847034,True,1,471
10548,44862781,44868398,False,1,5617
10549,44862781,44871981,False,1,9200
10550,44867484,44867695,True,1,211
10551,44873293,44874367,True,2,1074
10552,44876196,44876876,True,2,680
10553,44890807,44891499,True,2,692
10554,44893690,44893790,True,1,100
10555,44894295,44899206,False,1,4911
10556,44894421,45402272,False,1,507851
10557,44894570,44897900,True,1,3330
10558,44896963,44897047,False,1,84
10559,44897141,44914349,False,1,17208
10560,44914386,44915506,True,3,1120
10561,44917432,44917545,False,1,113
10562,44917432,44924546,True,1,7114
10563,44918517,44991244,True,1,72727
10564,44924499,44925391,True,1,892
10565,44925469,44925785,True,1,316
10566,44925866,44928908,True,1,3042
10567,44928330,44928540,True,1,210
10568,44931800,44931945,True,2,145
10569,44931871,44932016,True,1,145
10570,44932528,45412822,True,1,480294
10571,44932528,45428511,True,1,495983
10572,44932528,45464708,True,1,532180
10573,44938608,44955809,True,1,17201
10574,44942839,44942966,True,1,127
10575,44951679,44951881,True,2,202
10576,44956411,45010219,True,1,53808
10577,44957027,44959372,True,2,2345
10578,44987248,44987634,False,1,386
10579,45006168,45027804,True,1,21636
10580,45017802,45017955,True,1,153
10581,45039006,45102295,True,1,63289
10582,45041560,45041759,False,1,199
10583,45049804,45049966,True,1,162
10584,45050085,45059982,True,1,9897
10585,45061057,45065606,True,1,4549
10586,45077909,45078096,True,1,187
10587,45085355,45085983,True,1,628
10588,45086945,45088510,False,1,1565
10589,45093393,45113331,False,1,19938
10590,45094168,45094986,True,1,818
10591,45094168,45095183,True,1,1015
10592,45094168,45095475,True,1,1307
10593,45109448,45109593,False,1,145
10594,45110157,45567044,True,1,456887
10595,45115395,45120721,True,1,5326
10596,45125433,45126469,True,2,1036
10597,45128694,45128898,False,1,204
10598,45141813,45153118,True,1,11305
10599,45147256,45147416,True,1,160
10600,45149681,45159487,True,1,9806
10601,45160720,45161001,True,1,281
10602,45182861,45183291,True,3,430
10603,45184197,45591977,True,1,407780
10604,45198470,45198555,True,1,85
10605,45204342,45208345,True,6,4003
10606,45206004,45207538,False,1,1534
10607,45210796,45212122,True,2,1326
10608,45220763,45225496,True,1,4733
10609,45230636,45463773,False,1,233137
10610,45232050,45232263,True,1,213
10611,45232891,45571517,True,1,338626
10612,45232896,45579223,True,1,346327
10613,45255261,45255865,False,1,604
10614,45262372,45266450,True,1,4078
10615,45262486,45262649,True,2,163
10616,45268938,45269023,True,3,85
10617,45269120,45288153,True,1,19033
10618,45272668,45272890,True,1,222
10619,45284592,45311314,False,1,26722
10620,45284592,45311314,True,3,26722
10621,45292493,45320638,False,1,28145
10622,45305038,45310049,False,3,5011
10623,45315604,45322090,False,1,6486
10624,45315659,45315912,False,1,253
10625,45341002,45341460,True,1,458
10626,45341002,45341585,False,1,583
10627,45350898,45351156,True,1,258
10628,45351570,45353769,True,1,2199
10629,45376604,45384553,True,1,7949
10630,45379534,45386047,False,1,6513
10631,45379534,45386047,True,1,6513
10632,45379599,45379848,True,1,249
10633,45380454,45645299,True,1,264845
10634,45389232,45432138,True,2,42906
10635,45389319,45389471,True,1,152
10636,45390003,45694883,False,1,304880
10637,45392878,45403530,True,1,10652
10638,45407784,45407868,True,2,84
10639,45431484,45453313,True,1,21829
10640,45459242,45459912,False,1,670
10641,45459242,45532943,False,1,73701
10642,45471160,45473518,False,1,2358
10643,45472779,45474424,True,1,1645
10644,45475383,45479102,False,1,3719
10645,45475383,45479102,True,1,3719
10646,45479722,45479964,True,1,242
10647,45498069,45498317,True,1,248
10648,45531337,45532198,False,1,861
10649,45533665,45533826,True,2,161
10650,45533665,45535075,True,1,1410
10651,45534071,45535128,True,1,1057
10652,45543856,45544024,True,1,168
10653,45556595,45574770,True,3,18175
10654,45556840,45557493,True,1,653
10655,45556840,45594714,True,2,37874
10656,45558279,45559142,False,1,863
10657,45565848,45565960,True,1,112
10658,45568990,45633083,False,1,64093
10659,45573491,46033856,False,1,460365
10660,45577238,45577405,True,1,167
10661,45597713,45605015,False,1,7302
10662,45634401,45653232,True,1,18831
10663,45649975,45652663,True,2,2688
10664,45652275,45752122,True,1,99847
10665,45657002,45660608,True,1,3606
10666,45667064,45669308,True,2,2244
10667,45682562,45687151,True,1,4589
10668,45688276,45692348,True,1,4072
10669,45690005,45694508,True,1,4503
10670,45698686,45699596,True,1,910
10671,45699890,45799310,False,1,99420
10672,45705054,45709867,True,1,4813
10673,45706755,45715296,True,1,8541
10674,45714709,45719027,True,1,4318
10675,45729525,45740534,False,1,11009
10676,45737534,45747933,True,1,10399
10677,45738085,45742490,True,1,4405
10678,45758144,45759346,True,6,1202
10679,45774452,45788183,True,1,13731
10680,45780225,45785783,True,2,5558
10681,45781187,45782268,True,8,1081
10682,45783053,45783204,True,2,151
10683,45785464,45817720,True,1,32256
10684,45785464,45818458,True,1,32994
10685,45803569,45807021,True,1,3452
10686,45836005,45836615,True,1,610
10687,45836222,45843783,False,1,7561
10688,45838211,45851002,True,1,12791
10689,45843134,45847193,True,1,4059
10690,45848532,45856166,True,1,7634
10691,45851297,45857485,True,2,6188
10692,45851674,45864237,False,1,12563
10693,45856236,45860010,True,3,3774
10694,45876370,45876602,True,1,232
10695,45877468,45886089,True,1,8621
10696,45883925,45889526,False,1,5601
10697,45885229,45958744,True,1,73515
10698,45893376,45894616,False,1,1240
10699,45895783,45964305,True,1,68522
10700,45897088,45964962,False,1,67874
10701,45902611,45967721,False,1,65110
10702,45902618,45967728,True,1,65110
10703,45903997,45937147,False,1,33150
10704,45910497,45971658,True,1,61161
10705,45912345,45913938,True,1,1593
10706,45915221,45974026,True,1,58805
10707,45916807,45916905,True,1,98
10708,45917004,45974918,True,1,57914
10709,45919019,45975923,True,1,56904
10710,45921020,45929557,True,1,8537
10711,45921020,45932494,False,1,11474
10712,45923731,45978282,False,1,54551
10713,45925884,45979353,True,1,53469
10714,45926312,45927218,True,1,906
10715,45927678,45980255,True,1,52577
10716,45929844,45981340,True,1,51496
10717,45931809,45982317,False,1,50508
10718,45931820,45982328,True,1,50508
10719,45933347,45983089,True,1,49742
10720,45936989,45947716,True,1,10727
10721,45937407,45985120,True,1,47713
10722,45940324,45940619,True,1,295
10723,45940347,45940619,True,1,272
10724,45941235,45987033,True,1,45798
10725,45945533,45989181,False,1,43648
10726,45948258,45990548,False,1,42290
10727,45949078,45949969,False,1,891
10728,45951320,45992078,True,1,40758
10729,45953359,45993096,False,1,39737
10730,45955229,45994031,False,1,38802
10731,45955236,45994038,True,1,38802
10732,45956616,45994667,True,1,38051
10733,45956719,45994774,False,1,38055
10734,45959477,45965612,True,1,6135
10735,45959962,45996400,True,1,36438
10736,45963730,45998285,False,1,34555
10737,45965901,45968129,False,1,2228
10738,45965901,45999366,True,1,33465
10739,45966659,45967446,True,1,787
10740,45966659,45980750,True,1,14091
10741,45969267,45969809,False,1,542
10742,45969267,46001046,True,1,31779
10743,45970518,46001654,True,1,31136
10744,45974909,45976832,False,1,1923
10745,45974909,46003871,True,1,28962
10746,45977772,45978003,True,2,231
10747,45977956,46005392,True,1,27436
10748,45978848,46005837,False,1,26989
10749,45978863,46005852,False,1,26989
10750,45980647,45980960,False,1,313
10751,45982098,46007465,False,1,25367
10752,45985200,46009018,True,1,23818
10753,45986648,46008050,False,1,21402
10754,45986648,46009741,True,1,23093
10755,45988616,45988799,True,1,183
10756,45989303,46011063,True,1,21760
10757,45991689,46012260,True,1,20571
10758,45995037,46013936,True,1,18899
10759,45997217,46015021,False,1,17804
10760,46001838,46003270,False,1,1432
10761,46001838,46017335,True,1,15497
10762,46002960,46017894,True,1,14934
10763,46004956,46018893,True,1,13937
10764,46004965,46018902,True,1,13937
10765,46009067,46020950,True,1,11883
10766,46010242,46021536,True,1,11294
10767,46011538,46016960,True,6,5422
10768,46013194,46023014,False,1,9820
10769,46016094,46022771,False,1,6677
10770,46016094,46024462,True,1,8368
10771,46018438,46025634,False,1,7196
10772,46022349,46027590,True,1,5241
10773,46024302,46028564,True,1,4262
10774,46032738,46033269,True,1,531
10775,46054073,46054558,False,1,485
10776,46058638,46058686,True,1,48
10777,46067843,46077763,True,1,9920
10778,46074738,46074798,True,1,60
10779,46074866,46145242,True,3,70376
10780,46092618,46095871,True,3,3253
10781,46098495,46103612,True,1,5117
10782,46124603,46124886,True,1,283
10783,46134384,46137716,False,1,3332
10784,46134384,46137716,True,3,3332
10785,46153664,46156091,True,4,2427
10786,46166369,46168310,False,1,1941
10787,46189631,46193083,False,1,3452
10788,46191706,46194962,False,1,3256
10789,46202506,46204916,True,1,2410
10790,46208275,46216526,False,1,8251
10791,46208491,46210875,True,1,2384
10792,46212879,46214968,False,1,2089
10793,46225273,46226299,True,1,1026
10794,46235063,46239800,False,1,4737
10795,46238667,46240017,False,1,1350
10796,46284043,46284713,False,1,670
10797,46291117,46302803,True,2,11686
10798,46291117,46308746,True,2,17629
10799,46291117,46309657,True,1,18540
10800,46291117,46325738,True,1,34621
10801,46291281,46291628,True,2,347
10802,46292329,46303367,True,1,11038
10803,46292329,46309310,True,1,16981
10804,46310044,46310756,True,1,712
10805,46310044,46313947,True,1,3903
10806,46317596,46326139,True,1,8543
10807,46317596,46327792,True,1,10196
10808,46360950,46363855,True,1,2905
10809,46377152,46379217,False,1,2065
10810,46382436,46382689,False,2,253
10811,46388173,46391586,True,1,3413
10812,46388690,46392257,False,1,3567
10813,46389611,46390872,False,1,1261
10814,46433988,46437876,True,3,3888
10815,46443270,46446132,False,2,2862
10816,46443270,46446132,True,1,2862
10817,46460398,46465834,True,1,5436
10818,46460398,46465837,True,1,5439
10819,46460398,46467512,True,1,7114
10820,46469555,46470318,True,1,763
10821,46471703,46472185,True,2,482
10822,46472220,46472415,True,1,195
10823,46475756,46475906,False,1,150
10824,46485356,46485571,True,5,215
10825,46486999,46535269,True,1,48270
10826,46488442,46488858,True,1,416
10827,46489405,46494833,False,1,5428
10828,46489738,46494964,True,1,5226
10829,46491551,46491584,False,1,33
10830,46510628,46512297,True,1,1669
10831,46565417,46567708,False,1,2291
10832,46565694,46567981,False,2,2287
10833,46572861,46579239,True,4,6378
10834,46572861,46582824,True,1,9963
10835,46577331,46578492,True,2,1161
10836,46583596,46584508,True,1,912
10837,46598240,46598348,True,2,108
10838,46598240,46598351,True,1,111
10839,46598248,46598348,True,1,100
10840,46598410,46598485,True,2,75
10841,46599754,46616656,True,1,16902
10842,46602820,46603321,True,1,501
10843,46611926,46616490,True,1,4564
10844,46624182,46624998,True,1,816
10845,46626432,46629054,False,1,2622
10846,46627348,46673501,True,1,46153
10847,46663070,46665988,True,1,2918
10848,46674920,46677700,True,1,2780
10849,46678166,46679395,True,1,1229
10850,46682505,46682904,True,1,399
10851,46685692,46686674,True,1,982
10852,46685692,46687816,True,1,2124
10853,46685692,46690456,True,1,4764
10854,46685692,46692215,True,1,6523
10855,46688717,46688825,True,1,108
10856,46691383,46692637,True,1,1254
10857,46692380,46702900,True,2,10520
10858,46701906,46702179,True,2,273
10859,46705030,46706312,True,2,1282
10860,46706327,46750690,True,2,44363
10861,46712117,46712536,False,1,419
10862,46713278,46715235,True,3,1957
10863,46714832,46716789,True,2,1957
10864,46740795,46740874,True,5,79
10865,46745364,46745433,True,1,69
10866,46751277,47024475,False,1,273198
10867,46763153,46770093,False,1,6940
10868,46769081,46777497,True,1,8416
10869,46773087,46809981,False,1,36894
10870,46773087,46809981,True,2,36894
10871,46779997,46781115,True,6,1118
10872,46781622,46781713,False,1,91
10873,46800220,46803512,True,1,3292
10874,46803488,46805577,True,1,2089
10875,46813426,46820672,True,1,7246
10876,46815936,46816589,True,1,653
10877,46825424,46850100,True,1,24676
10878,46826061,46828196,True,2,2135
10879,46831353,46831814,False,1,461
10880,46831353,46831814,True,5,461
10881,46834310,46834600,True,1,290
10882,46838555,46853195,True,1,14640
10883,46840764,46841100,True,1,336
10884,46841903,46842192,False,1,289
10885,46841903,46842267,False,1,364
10886,46850454,46853409,False,1,2955
10887,46862266,46863491,True,1,1225
10888,46862266,46864259,True,1,1993
10889,46870310,46872008,True,1,1698
10890,46883186,46883663,True,2,477
10891,46884417,46885163,False,1,746
10892,46908047,46908609,False,1,562
10893,46912717,46912836,True,1,119
10894,46912952,46913219,True,6,267
10895,46941966,46952698,False,1,10732
10896,46943744,46943925,True,1,181
10897,46952053,46956747,True,1,4694
10898,46953883,46955067,True,1,1184
10899,46963702,46964090,True,1,388
10900,46972606,46975911,False,1,3305
10901,46975250,46976302,True,2,1052
10902,46990643,46992011,True,1,1368
10903,46990643,46997634,True,2,6991
10904,46999903,47001164,False,1,1261
10905,46999903,47001167,False,1,1264
10906,47002080,47010289,False,1,8209
10907,47015544,47016780,True,1,1236
10908,47032852,47032937,True,2,85
10909,47043273,47062647,False,1,19374
10910,47043380,47044265,True,1,885
10911,47046977,47118535,True,2,71558
10912,47056456,47058064,False,1,1608
10913,47056456,47058064,True,7,1608
10914,47068071,47068163,False,2,92
10915,47069108,47069896,True,1,788
10916,47073040,47077161,True,1,4121
10917,47074860,47076620,False,1,1760
10918,47075357,47076320,True,2,963
10919,47086024,47097039,True,1,11015
10920,47086024,47097935,True,1,11911
10921,47089588,47089763,False,3,175
10922,47089588,47089763,True,1,175
10923,47091043,47091978,True,1,935
10924,47105213,47108492,False,1,3279
10925,47114210,47114617,False,1,407
10926,47118179,47154919,True,1,36740
10927,47120558,47123799,True,1,3241
10928,47129510,47131547,True,1,2037
10929,47137949,47138130,True,1,181
10930,47140604,47140679,True,1,75
10931,47141090,47141745,True,1,655
10932,47165884,47167012,False,1,1128
10933,47165884,47168041,False,1,2157
10934,47167417,47169291,True,1,1874
10935,47172302,47172527,False,1,225
10936,47173545,47174303,True,1,758
10937,47184828,47185929,True,1,1101
10938,47191055,47191729,False,1,674
10939,47191055,47191729,True,5,674
10940,47191055,47204181,True,1,13126
10941,47192152,47199120,True,1,6968
10942,47194560,47208577,True,6,14017
10943,47199934,47201630,False,1,1696
10944,47213366,47215187,True,1,1821
10945,47216948,47306725,True,1,89777
10946,47218635,47223082,True,1,4447
10947,47228929,47230182,True,1,1253
10948,47229472,47233665,True,1,4193
10949,47230059,47230761,True,1,702
10950,47251680,47252613,True,1,933
10951,47273834,47273967,True,8,133
10952,47274221,47274581,True,1,360
10953,47274221,47287785,True,1,13564
10954,47275620,47281538,True,1,5918
10955,47305597,47306960,True,4,1363
10956,47332890,47333999,True,1,1109
10957,47346594,47347266,True,1,672
10958,47346594,47348454,True,3,1860
10959,47371572,47375288,True,1,3716
10960,47372686,47374615,True,5,1929
10961,47372849,47373144,False,1,295
10962,47372849,47373144,True,1,295
10963,47375654,47379473,True,2,3819
10964,47378989,47385529,False,1,6540
10965,47380861,47381603,True,1,742
10966,47382984,47383546,True,2,562
10967,47382984,47391477,True,3,8493
10968,47391716,47393340,True,1,1624
10969,47392462,47395392,True,1,2930
10970,47393676,47394348,True,1,672
10971,47393676,47395536,True,3,1860
10972,47401986,47408264,True,1,6278
10973,47403732,47407081,False,1,3349
10974,47403989,47404073,True,2,84
10975,47415521,47418391,True,1,2870
10976,47421580,47424434,True,1,2854
10977,47424430,47425466,True,1,1036
10978,47427846,47433822,True,1,5976
10979,47427846,47438336,True,3,10490
10980,47439650,47443864,False,2,4214
10981,47439650,47443864,True,2,4214
10982,47439650,47448634,True,1,8984
10983,47443875,47444585,False,1,710
10984,47443875,47444585,True,4,710
10985,47448131,47448320,True,1,189
10986,47456725,47457840,True,1,1115
10987,47462568,47471239,True,1,8671
10988,47466702,47467703,False,1,1001
10989,47466702,47474736,True,2,8034
10990,47470375,47478896,True,1,8521
10991,47489239,47497963,True,1,8724
10992,47489239,47505581,True,1,16342
10993,47491033,47492152,False,1,1119
10994,47499739,47501501,True,2,1762
10995,47499739,47501509,True,1,1770
10996,47500301,47501660,True,1,1359
10997,47500333,47501660,True,1,1327
10998,47510273,47520443,True,1,10170
10999,47510273,47526344,True,1,16071
11000,47510273,47532891,True,1,22618
11001,47510944,47540474,True,1,29530
11002,47511478,47512581,True,4,1103
11003,47532384,47532927,True,1,543
11004,47533075,47533284,False,1,209
11005,47533255,47533737,True,1,482
11006,47538098,47546963,True,1,8865
11007,47552073,47552369,True,2,296
11008,47552224,47552467,True,1,243
11009,47552834,47553313,True,1,479
11010,47570372,47647028,True,1,76656
11011,47580425,47580784,True,2,359
11012,47591191,47596994,False,3,5803
11013,47591191,47596994,True,4,5803
11014,47602808,47603047,False,1,239
11015,47602808,47603047,True,2,239
11016,47603587,47603676,True,1,89
11017,47609143,47610248,True,1,1105
11018,47609296,47613891,False,1,4595
11019,47613648,47651540,False,1,37892
11020,47613648,47651540,True,2,37892
11021,47622097,47666632,True,1,44535
11022,47622939,47631299,True,1,8360
11023,47631540,47637368,False,2,5828
11024,47631671,47631834,False,1,163
11025,47631671,47631834,True,3,163
11026,47636470,47638794,True,1,2324
11027,47652477,47653691,True,3,1214
11028,47655346,47658039,True,1,2693
11029,47669559,47675744,True,1,6185
11030,47673215,47680621,True,1,7406
11031,47684201,47684400,True,1,199
11032,47684674,47686901,True,1,2227
11033,47692602,47693572,True,3,970
11034,47692602,47693686,True,1,1084
11035,47692602,47694254,True,1,1652
11036,47692602,47694522,False,1,1920
11037,47694962,47696109,True,2,1147
11038,47694968,47695993,True,2,1025
11039,47702470,47702833,True,1,363
11040,47703091,47709892,False,1,6801
11041,47703193,47709892,True,1,6699
11042,47703952,47704882,True,2,930
11043,47713479,47714711,True,1,1232
11044,47738555,47738836,True,1,281
11045,47764026,47764912,True,1,886
11046,47769326,47769844,True,1,518
11047,47770857,47775828,True,1,4971
11048,47806594,47818553,True,1,11959
11049,47806594,47830893,True,1,24299
11050,47816152,47826954,False,1,10802
11051,47818790,47830883,True,2,12093
11052,47830939,47914323,True,1,83384
11053,47831084,47832464,True,1,1380
11054,47831084,47837482,True,1,6398
11055,47850121,47859619,True,3,9498
11056,47852568,47854520,True,2,1952
11057,47858903,47866643,False,1,7740
11058,47868399,47875868,True,2,7469
11059,47877833,47878146,True,2,313
11060,47891751,47936441,True,1,44690
11061,47901593,47906112,True,1,4519
11062,47903368,47927560,False,1,24192
11063,47907252,47907494,False,1,242
11064,47916958,47917620,True,1,662
11065,47916958,47917633,True,4,675
11066,47917347,47917956,True,1,609
11067,47917438,47917991,True,1,553
11068,47918717,47919124,True,1,407
11069,47931688,47931991,True,2,303
11070,47946490,47948580,False,1,2090
11071,47946490,47948580,True,3,2090
11072,47961803,47963167,False,1,1364
11073,47961803,47982724,False,5,20921
11074,47962038,47962985,False,1,947
11075,47964100,47965461,True,1,1361
11076,47967837,48279826,True,1,311989
11077,47973835,47982776,False,1,8941
11078,47973835,47982776,True,1,8941
11079,47975355,47983637,True,1,8282
11080,47982213,47982473,True,2,260
11081,47986549,47994213,False,1,7664
11082,47990894,47997405,False,1,6511
11083,47997579,47997929,True,1,350
11084,48008979,48025936,True,1,16957
11085,48036587,48037365,True,1,778
11086,48036587,48037368,True,1,781
11087,48050749,48051147,True,3,398
11088,48050749,48053099,False,1,2350
11089,48051440,48053099,True,1,1659
11090,48051445,48053099,True,1,1654
11091,48051710,48053099,True,1,1389
11092,48053021,48053431,True,5,410
11093,48057835,48057921,True,3,86
11094,48061144,48061223,False,1,79
11095,48061387,48064239,False,1,2852
11096,48065299,48065379,True,1,80
11097,48067356,48067480,True,2,124
11098,48068207,48068346,True,2,139
11099,48068735,48069140,False,1,405
11100,48069101,48069214,True,2,113
11101,48070738,48074455,True,5,3717
11102,48075572,48092160,True,1,16588
11103,48076169,48077378,True,3,1209
11104,48077562,48078043,True,1,481
11105,48087980,48088301,False,1,321
11106,48089824,48090441,True,1,617
11107,48100105,48100515,True,5,410
11108,48104026,48108344,False,1,4318
11109,48139923,48145364,True,1,5441
11110,48146218,48146794,True,1,576
11111,48171177,48176667,True,1,5490
11112,48174512,48185470,False,1,10958
11113,48185163,48191229,True,1,6066
11114,48190314,48191429,True,1,1115
11115,48195482,48199856,True,1,4374
11116,48198767,48207357,True,1,8590
11117,48204882,48236852,False,1,31970
11118,48210078,48210801,True,1,723
11119,48210078,48211227,True,1,1149
11120,48210725,48211479,True,2,754
11121,48211553,48213606,False,1,2053
11122,48211553,48213606,True,2,2053
11123,48216233,48216333,True,1,100
11124,48230200,48236407,False,1,6207
11125,48230200,48236407,True,1,6207
11126,48235385,48236790,True,1,1405
11127,48244585,48244727,True,4,142
11128,48249796,48249951,True,1,155
11129,48252981,48254767,False,1,1786
11130,48252981,48254767,True,1,1786
11131,48257420,48259254,True,3,1834
11132,48258598,48263090,True,6,4492
11133,48261092,48264700,True,1,3608
11134,48261904,48274052,True,1,12148
11135,48265409,48267351,False,1,1942
11136,48267996,48269686,False,1,1690
11137,48267996,48279422,False,1,11426
11138,48268023,48269686,False,1,1663
11139,48284501,48285533,False,1,1032
11140,48289495,48308795,True,1,19300
11141,48289495,48334512,True,1,45017
11142,48300639,48312562,True,1,11923
11143,48300639,48331323,False,1,30684
11144,48303287,48309064,False,1,5777
11145,48303287,48309064,True,3,5777
11146,48307166,48313091,True,1,5925
11147,48307166,48317785,True,2,10619
11148,48323260,48327632,True,4,4372
11149,48326893,48344544,True,2,17651
11150,48328909,48331209,False,1,2300
11151,48335672,48337567,True,2,1895
11152,48335672,48358591,True,2,22919
11153,48335672,48393202,True,1,57530
11154,48339724,48340642,True,1,918
11155,48343916,48344133,True,1,217
11156,48347044,48350538,True,3,3494
11157,48353808,48355938,True,1,2130
11158,48355838,48355938,True,1,100
11159,48356030,48356533,True,2,503
11160,48360872,48372385,False,1,11513
11161,48361899,48367135,False,1,5236
11162,48368214,48371562,True,1,3348
11163,48372680,48375909,False,1,3229
11164,48381748,48388129,True,1,6381
11165,48387861,48400396,True,1,12535
11166,48387861,48425443,True,3,37582
11167,48398236,48398664,True,2,428
11168,48398236,48403347,False,1,5111
11169,48398236,48403347,True,1,5111
11170,48398904,48403475,True,1,4571
11171,48400256,48404329,True,2,4073
11172,48402611,48440193,True,1,37582
11173,48432669,48445230,False,2,12561
11174,48432669,48445230,True,1,12561
11175,48436630,48437691,False,1,1061
11176,48436630,48446127,True,1,9497
11177,48451800,48452161,True,1,361
11178,48463281,48501883,True,1,38602
11179,48466014,48469105,True,1,3091
11180,48471687,48471921,False,1,234
11181,48473333,48473521,True,1,188
11182,48473615,48473910,True,1,295
11183,48483902,48489437,True,1,5535
11184,48483902,48491570,True,1,7668
11185,48483902,48492570,True,1,8668
11186,48506237,48507902,True,1,1665
11187,48506237,48512750,True,1,6513
11188,48535159,48624926,True,1,89767
11189,48537519,48550938,False,1,13419
11190,48540114,48558715,True,2,18601
11191,48540920,48609143,False,1,68223
11192,48545339,48549353,False,1,4014
11193,48545339,48549353,True,2,4014
11194,48572788,48573717,True,1,929
11195,48581174,48581642,False,1,468
11196,48581174,48581642,True,1,468
11197,48582338,48582555,False,2,217
11198,48587149,48590997,False,1,3848
11199,48587149,48590997,True,2,3848
11200,48587149,48591274,True,1,4125
11201,48587382,48590997,True,1,3615
11202,48593501,48593633,True,2,132
11203,48597181,48598492,True,2,1311
11204,48599566,48603471,True,1,3905
11205,48599719,48600070,True,1,351
11206,48599719,48600112,True,1,393
11207,48600933,48602614,True,3,1681
11208,48600933,48603989,True,1,3056
11209,48608911,48635009,True,1,26098
11210,48618235,48618597,True,1,362
11211,48627365,48629508,True,2,2143
11212,48629953,48630363,True,2,410
11213,48629953,48630368,True,1,415
11214,48631813,48633831,True,1,2018
11215,48644813,48645450,True,2,637
11216,48647700,48648664,True,1,964
11217,48666911,48667360,True,1,449
11218,48676724,48680688,True,1,3964
11219,48681527,48682861,False,1,1334
11220,48684713,48687919,False,1,3206
11221,48692752,48693547,True,1,795
11222,48694529,48705186,False,1,10657
11223,48746361,48746724,True,1,363
11224,48752755,48752958,False,2,203
11225,48752755,48752958,True,1,203
11226,48752755,48760256,False,1,7501
11227,48765635,48766387,False,1,752
11228,48766647,48767942,True,3,1295
11229,48772234,48780613,False,1,8379
11230,48783250,48794409,False,1,11159
11231,48784627,48785645,True,1,1018
11232,48795117,48795864,False,1,747
11233,48796014,48796305,True,1,291
11234,48806616,48808546,True,4,1930
11235,48806616,48811786,False,1,5170
11236,48815581,48839654,True,4,24073
11237,48815997,48839709,True,2,23712
11238,48818306,48830920,True,2,12614
11239,48818306,48831894,False,1,13588
11240,48819167,48821170,True,1,2003
11241,48823965,48824841,False,1,876
11242,48846089,48847206,True,7,1117
11243,48852386,48852846,True,2,460
11244,48855407,48859474,True,1,4067
11245,48868460,48872741,True,2,4281
11246,48878568,48878685,True,1,117
11247,48878623,48890784,True,1,12161
11248,48878623,48895445,True,1,16822
11249,48878623,48898471,True,3,19848
11250,48878623,48946032,True,1,67409
11251,48886879,48887395,False,1,516
11252,48887122,48912183,True,1,25061
11253,48890595,48918104,False,1,27509
11254,48890595,48949993,False,1,59398
11255,48894054,48894126,True,1,72
11256,48894487,48896050,True,3,1563
11257,48896019,48896118,True,2,99
11258,48900223,48973488,True,1,73265
11259,48910122,48912010,True,1,1888
11260,48910122,49006594,True,2,96472
11261,48916310,48917415,True,3,1105
11262,48919307,48919731,True,1,424
11263,48926177,48927164,True,1,987
11264,48926876,48930797,False,1,3921
11265,48927283,48927728,True,1,445
11266,48928582,48934310,True,1,5728
11267,48930887,48931400,True,2,513
11268,48931627,48933703,True,2,2076
11269,48947638,48949090,True,1,1452
11270,48952887,48983167,True,1,30280
11271,48952887,48983831,False,1,30944
11272,48952887,48994101,False,1,41214
11273,48963935,48964657,False,1,722
11274,48964940,48966186,True,1,1246
11275,48965027,48966186,True,2,1159
11276,48965027,48966608,True,1,1581
11277,48967021,48996200,True,2,29179
11278,48975470,48978891,False,1,3421
11279,48975470,48978891,True,1,3421
11280,48976041,48983772,True,1,7731
11281,48990774,48997945,True,2,7171
11282,48992908,49019885,True,2,26977
11283,48992908,49099672,True,1,106764
11284,48995911,49006272,True,4,10361
11285,49011457,49013151,False,3,1694
11286,49011457,49013234,False,1,1777
11287,49011457,49023504,False,1,12047
11288,49018300,49025635,True,1,7335
11289,49037366,49269228,True,2,231862
11290,49037366,49269232,True,1,231866
11291,49042607,49044121,True,1,1514
11292,49053610,49055681,False,1,2071
11293,49056389,49197919,True,1,141530
11294,49058751,49060309,True,3,1558
11295,49062903,49063043,True,1,140
11296,49071559,49076598,False,1,5039
11297,49080282,49080779,True,1,497
11298,49081007,49082297,True,1,1290
11299,49081585,49082875,True,1,1290
11300,49086577,49086872,True,1,295
11301,49088781,49214052,False,1,125271
11302,49091902,49095991,True,5,4089
11303,49091902,49101164,True,1,9262
11304,49098267,49113845,True,1,15578
11305,49099351,49101211,True,1,1860
11306,49100092,49100290,True,1,198
11307,49100092,49100990,True,3,898
11308,49103020,49108389,True,4,5369
11309,49104015,49112337,True,1,8322
11310,49107901,49111702,False,2,3801
11311,49107901,49111702,True,1,3801
11312,49127125,49127455,True,1,330
11313,49127125,49129581,True,2,2456
11314,49127575,49129620,True,4,2045
11315,49132821,49132937,True,1,116
11316,49135643,49141150,True,1,5507
11317,49155006,49156466,True,1,1460
11318,49156437,49156761,True,1,324
11319,49156825,49169448,True,2,12623
11320,49168038,49168655,True,1,617
11321,49168487,49168574,True,3,87
11322,49169094,49169243,True,2,149
11323,49169449,49170615,True,1,1166
11324,49169449,49170670,True,1,1221
11325,49171714,49172661,False,1,947
11326,49171714,49172870,False,1,1156
11327,49201712,49202092,True,1,380
11328,49210887,49211569,True,2,682
11329,49216578,49216740,True,1,162
11330,49225271,49225365,True,1,94
11331,49226296,49272753,True,1,46457
11332,49226296,49276367,True,1,50071
11333,49231705,49232224,True,1,519
11334,49231705,49236583,True,4,4878
11335,49232211,49233278,True,1,1067
11336,49233757,49233841,False,1,84
11337,49233757,49233841,True,1,84
11338,49234515,49234649,True,1,134
11339,49240797,49240901,True,1,104
11340,49240927,49241031,False,1,104
11341,49244263,49244626,False,1,363
11342,49249712,49251334,True,1,1622
11343,49260275,49261079,True,1,804
11344,49264532,49264759,True,1,227
11345,49273174,49273274,False,1,100
11346,49273174,49273274,True,1,100
11347,49282807,49282907,True,1,100
11348,49283050,49283153,True,1,103
11349,49291869,49303725,True,2,11856
11350,49292292,49303969,True,1,11677
11351,49296954,49300307,False,1,3353
11352,49299136,49307443,True,1,8307
11353,49299136,49310662,True,1,11526
11354,49299202,49299311,True,1,109
11355,49299202,49299317,False,2,115
11356,49299202,49299317,True,5,115
11357,49301501,49303413,True,1,1912
11358,49306372,49307629,True,1,1257
11359,49316938,49317508,True,3,570
11360,49319102,49320618,True,1,1516
11361,49333740,49339455,False,1,5715
11362,49333740,49339455,True,1,5715
11363,49333740,49364950,True,2,31210
11364,49334834,49354893,True,1,20059
11365,49334834,49365371,True,1,30537
11366,49348067,49348899,True,1,832
11367,49349912,49350615,True,2,703
11368,49350279,49350638,True,2,359
11369,49357927,49358338,False,1,411
11370,49357927,49358338,True,2,411
11371,49365749,49366700,True,1,951
11372,49365971,49366080,True,1,109
11373,49365971,49366128,True,2,157
11374,49365971,49366364,True,1,393
11375,49368597,49370827,True,5,2230
11376,49372485,49373319,False,1,834
11377,49372485,49373393,True,1,908
11378,49391539,49395400,True,1,3861
11379,49393728,49396666,False,1,2938
11380,49403641,49404070,True,2,429
11381,49403700,49404070,True,3,370
11382,49404285,49404525,True,2,240
11383,49404648,49404785,True,2,137
11384,49404970,49405107,True,1,137
11385,49411579,49414092,True,1,2513
11386,49417987,49418118,True,2,131
11387,49418931,49419074,True,2,143
11388,49418931,49419729,True,1,798
11389,49424166,49429603,True,1,5437
11390,49424178,49429597,True,1,5419
11391,49437066,49441675,True,2,4609
11392,49440039,49440491,False,1,452
11393,49455619,49456648,False,1,1029
11394,49467986,49469783,False,1,1797
11395,49469712,49470377,True,2,665
11396,49469931,49531815,True,2,61884
11397,49469931,49558473,True,1,88542
11398,49476437,49478452,True,1,2015
11399,49476851,49480350,True,3,3499
11400,49477286,49500748,True,1,23462
11401,49480947,49508249,False,1,27302
11402,49482215,49482620,True,1,405
11403,49484638,49488023,True,3,3385
11404,49511178,49517614,True,3,6436
11405,49520004,49520146,False,1,142
11406,49520004,49520146,True,2,142
11407,49538504,49538709,True,1,205
11408,49543659,49544389,True,2,730
11409,49544680,49545196,True,1,516
11410,49545264,49545570,True,1,306
11411,49549363,49549543,True,3,180
11412,49550422,49552606,True,1,2184
11413,49550498,49552606,True,1,2108
11414,49550630,49552606,True,1,1976
11415,49551370,49553088,True,1,1718
11416,49557937,49559663,False,1,1726
11417,49558817,49559159,True,1,342
11418,49558817,49559215,True,1,398
11419,49561714,49565545,True,1,3831
11420,49565390,49566849,True,1,1459
11421,49566538,49567153,True,1,615
11422,49568127,49568746,True,1,619
11423,49574477,49594521,True,2,20044
11424,49575328,49575412,True,4,84
11425,49576932,49577916,True,1,984
11426,49594357,49598210,True,1,3853
11427,49603652,49605156,True,1,1504
11428,49603690,49605344,True,2,1654
11429,49603690,49606415,True,1,2725
11430,49606771,49615104,False,1,8333
11431,49610827,49611315,False,1,488
11432,49610827,49611315,True,3,488
11433,49611213,49614455,True,2,3242
11434,49614773,49674177,True,3,59404
11435,49615781,49615912,True,1,131
11436,49618179,49629217,True,3,11038
11437,49618179,49662430,True,1,44251
11438,49618933,49619455,True,1,522
11439,49627682,49641585,True,1,13903
11440,49630882,49631575,True,1,693
11441,49632126,49632578,True,1,452
11442,49645908,49648963,False,3,3055
11443,49645908,49651658,False,1,5750
11444,49647230,49652633,True,1,5403
11445,49647230,49660085,True,1,12855
11446,49647243,49652626,True,1,5383
11447,49651521,49652052,False,1,531
11448,49651831,49684102,True,2,32271
11449,49653980,49654101,False,1,121
11450,49655813,49656405,False,1,592
11451,49655813,49656915,True,1,1102
11452,49656422,49656673,True,1,251
11453,49656422,49657183,True,1,761
11454,49657793,49669642,True,1,11849
11455,49657793,49686546,True,1,28753
11456,49658795,49665640,True,1,6845
11457,49658993,49670188,True,2,11195
11458,49659026,49670188,True,1,11162
11459,49659026,49687092,True,1,28066
11460,49661852,49665148,True,1,3296
11461,49663047,49663158,True,1,111
11462,49666578,49667303,True,1,725
11463,49668301,49674885,True,1,6584
11464,49668970,49669504,False,1,534
11465,49672564,49673660,True,3,1096
11466,49672648,49674351,False,1,1703
11467,49673022,49673981,True,4,959
11468,49673573,49674230,True,3,657
11469,49674871,49675928,True,3,1057
11470,49676061,49680095,False,2,4034
11471,49676061,49680095,True,4,4034
11472,49676663,49677004,True,1,341
11473,49676940,49677061,True,3,121
11474,49678158,49680003,True,3,1845
11475,49679421,49682682,True,1,3261
11476,49681353,49683438,True,2,2085
11477,49681860,49698509,True,2,16649
11478,49681860,49702384,True,1,20524
11479,49684596,49684919,True,3,323
11480,49686572,49687764,True,2,1192
11481,49689906,49697606,True,1,7700
11482,49689906,49703127,True,2,13221
11483,49714516,49714734,True,4,218
11484,49715311,49727491,True,2,12180
11485,49726452,49727924,True,1,1472
11486,49726676,49753280,True,1,26604
11487,49736283,49736425,True,1,142
11488,49743373,49746037,True,1,2664
11489,49747572,49750735,False,1,3163
11490,49747572,49750735,True,1,3163
11491,49748060,49754012,True,2,5952
11492,49765226,49804479,True,1,39253
11493,49767469,49773833,True,1,6364
11494,49771479,49772042,True,1,563
11495,49772887,49773247,True,1,360
11496,49781551,49786149,True,1,4598
11497,49792931,49793229,True,1,298
11498,49797104,49798409,True,1,1305
11499,49798356,49799077,True,1,721
11500,49798465,49799058,True,1,593
11501,49811261,49816362,False,1,5101
11502,49818669,49818958,True,2,289
11503,49818699,49827324,True,1,8625
11504,49824524,49825665,False,1,1141
11505,49831666,49832121,False,1,455
11506,49833493,49834911,True,1,1418
11507,49836833,49837619,True,1,786
11508,49836921,49840271,True,1,3350
11509,49860076,49867786,True,1,7710
11510,49862292,49869714,True,1,7422
11511,49862292,49872814,True,6,10522
11512,49875473,49876213,True,2,740
11513,49877453,49878196,True,3,743
11514,49888237,49888588,True,1,351
11515,49888237,49893105,True,1,4868
11516,49888237,49893739,True,1,5502
11517,49903656,49905240,True,2,1584
11518,49929707,49939501,True,1,9794
11519,49931974,49937153,True,1,5179
11520,49933940,49945712,True,5,11772
11521,49939431,49942066,True,2,2635
11522,49940272,49942522,True,1,2250
11523,49949576,49949943,True,2,367
11524,49950771,49951711,True,1,940
11525,49950869,49951809,False,1,940
11526,49959493,49983636,True,1,24143
11527,49963969,49965770,False,1,1801
11528,49963969,49965770,True,1,1801
11529,49974106,49974137,False,1,31
11530,49974426,49980356,True,1,5930
11531,49975442,49976769,True,5,1327
11532,49990520,49995670,True,1,5150
11533,49995520,49996485,False,1,965
11534,49998411,50003042,True,3,4631
11535,49998607,50003032,True,2,4425
11536,50006360,50014425,True,1,8065
11537,50007324,50007544,True,1,220
11538,50026585,50029128,True,1,2543
11539,50032544,50038716,True,1,6172
11540,50032719,50033049,True,1,330
11541,50044839,50047038,True,1,2199
11542,50046807,50047038,True,1,231
11543,50053044,50054036,True,1,992
11544,50058291,50069586,True,1,11295
11545,50084360,50085251,False,1,891
11546,50084752,50143474,False,1,58722
11547,50084752,50143474,True,2,58722
11548,50085021,50085629,True,3,608
11549,50085739,50086172,True,1,433
11550,50104174,50104690,False,2,516
11551,50104174,50109839,True,1,5665
11552,50104174,50110983,True,1,6809
11553,50113257,50114390,True,1,1133
11554,50118766,50119248,True,1,482
11555,50137763,50200454,True,1,62691
11556,50137790,50143736,True,1,5946
11557,50137790,50200454,True,1,62664
11558,50143875,50195990,True,1,52115
11559,50143980,50196155,True,1,52175
11560,50151637,50152038,True,1,401
11561,50151637,50152230,True,1,593
11562,50151637,50152501,True,1,864
11563,50151637,50153154,False,1,1517
11564,50157224,50157355,False,1,131
11565,50163401,50166000,True,1,2599
11566,50163433,50166253,True,1,2820
11567,50165363,50192374,False,1,27011
11568,50187657,50191028,False,1,3371
11569,50200580,50201222,False,1,642
11570,50200580,50201222,True,2,642
11571,50203560,50233358,True,2,29798
11572,50217141,50217926,True,1,785
11573,50230555,50230713,True,4,158
11574,50244900,50245435,False,3,535
11575,50246363,50260329,True,1,13966
11576,50246363,50262840,True,2,16477
11577,50247473,50248940,True,3,1467
11578,50247782,50248564,False,1,782
11579,50260849,50261123,True,1,274
11580,50261553,50264617,False,1,3064
11581,50276373,50277868,True,1,1495
11582,50276373,50281798,True,1,5425
11583,50282048,50282430,False,1,382
11584,50288539,50290086,False,1,1547
11585,50293625,50295103,True,1,1478
11586,50297021,50297149,True,1,128
11587,50304070,50309458,False,1,5388
11588,50308192,50310486,True,1,2294
11589,50310205,50311983,False,1,1778
11590,50321073,50321503,False,1,430
11591,50321737,50321837,True,1,100
11592,50324668,50361381,False,1,36713
11593,50324668,50416234,True,1,91566
11594,50332103,50332483,False,1,380
11595,50335970,50342443,True,1,6473
11596,50337121,50340765,False,1,3644
11597,50337121,50340765,True,2,3644
11598,50337121,50346414,True,1,9293
11599,50350727,50356173,True,1,5446
11600,50352841,50363494,True,5,10653
11601,50352841,50364048,True,2,11207
11602,50352841,50364051,True,2,11210
11603,50352841,50366821,True,2,13980
11604,50365942,50372644,False,1,6702
11605,50381032,50384368,True,1,3336
11606,50390081,50419262,True,1,29181
11607,50400278,50407328,False,1,7050
11608,50400278,50407328,True,3,7050
11609,50403205,50405452,True,1,2247
11610,50404446,50404541,True,5,95
11611,50405959,50407080,False,2,1121
11612,50411070,50419704,False,1,8634
11613,50411070,50419704,True,1,8634
11614,50411070,50420932,False,1,9862
11615,50411070,50420932,True,2,9862
11616,50411070,50421832,True,1,10762
11617,50411070,50437356,True,1,26286
11618,50431888,50718504,True,1,286616
11619,50438468,50438652,True,1,184
11620,50454505,50470432,False,1,15927
11621,50455158,50459749,True,3,4591
11622,50455158,50471730,True,1,16572
11623,50456662,50456801,True,1,139
11624,50457762,50468576,True,1,10814
11625,50460308,50461206,True,1,898
11626,50471705,50489593,True,1,17888
11627,50480365,50483025,True,1,2660
11628,50490838,50500560,False,1,9722
11629,50499380,50502425,True,2,3045
11630,50509438,50510246,True,2,808
11631,50511518,50546178,True,1,34660
11632,50512420,50547080,True,1,34660
11633,50516302,50520819,True,1,4517
11634,50522917,50524281,True,2,1364
11635,50522979,50524281,True,4,1302
11636,50528982,50530433,True,1,1451
11637,50530160,50579164,True,2,49004
11638,50535393,50539680,True,1,4287
11639,50542606,50544044,False,1,1438
11640,50544212,50544570,True,2,358
11641,50551044,50558231,True,1,7187
11642,50552859,50556821,True,4,3962
11643,50553749,50555860,True,2,2111
11644,50558772,50564343,True,1,5571
11645,50559718,50564693,True,2,4975
11646,50562353,50563686,True,1,1333
11647,50563243,50569546,True,4,6303
11648,50572182,50573108,False,1,926
11649,50572852,50575381,False,1,2529
11650,50572852,50575381,True,1,2529
11651,50598127,50600641,False,1,2514
11652,50603398,50605929,False,1,2531
11653,50609468,50611054,False,1,1586
11654,50609468,50611698,False,1,2230
11655,50611128,50616176,True,1,5048
11656,50614642,50615495,True,1,853
11657,50628953,50630061,True,1,1108
11658,50633501,50634266,True,3,765
11659,50651661,50653142,True,1,1481
11660,50652608,50653971,False,1,1363
11661,50657216,50658877,False,1,1661
11662,50660805,50662948,False,1,2143
11663,50662769,50665321,True,1,2552
11664,50669884,50670332,False,1,448
11665,50676771,50679708,False,1,2937
11666,50676771,50679708,True,4,2937
11667,50676774,50679740,True,1,2966
11668,50696420,50705001,True,1,8581
11669,50696424,50705001,True,1,8577
11670,50721024,50726548,True,1,5524
11671,50721024,50736725,True,1,15701
11672,50724353,50725104,False,1,751
11673,50725218,50725969,False,1,751
11674,50731470,50738069,True,11,6599
11675,50731470,50738490,True,1,7020
11676,50745127,50745400,True,1,273
11677,50750096,50774683,False,1,24587
11678,50757813,50757885,True,1,72
11679,50768342,50771229,True,3,2887
11680,50769897,50775002,True,1,5105
11681,50774927,50784973,False,1,10046
11682,50776853,50782746,False,1,5893
11683,50776853,50782746,True,1,5893
11684,50783599,50784288,True,2,689
11685,50809358,50810615,True,1,1257
11686,50830546,50830625,True,1,79
11687,50835990,50836669,True,1,679
11688,50836371,50838083,False,1,1712
11689,50849447,50852514,True,1,3067
11690,50849468,50850733,False,1,1265
11691,50853998,50854120,True,1,122
11692,50855759,50856944,False,1,1185
11693,50867615,50869644,True,3,2029
11694,50872883,50873248,False,1,365
11695,50885234,50885628,False,2,394
11696,50895832,50911603,True,1,15771
11697,50902898,50928940,False,1,26042
11698,50913118,50914403,False,1,1285
11699,50913118,50914403,True,3,1285
11700,50913918,50914510,False,3,592
11701,50913918,50914510,True,1,592
11702,50917342,50917724,False,1,382
11703,50918446,50919399,True,1,953
11704,50926883,50930124,True,1,3241
11705,50927617,50930802,False,1,3185
11706,50929540,50974268,True,1,44728
11707,50932562,51032964,True,1,100402
11708,50939775,50972435,True,1,32660
11709,50940212,50972515,True,1,32303
11710,50944147,50949283,True,1,5136
11711,50963155,50966868,False,1,3713
11712,50997268,51004349,False,1,7081
11713,50997824,50998795,False,1,971
11714,51009900,51027326,True,1,17426
11715,51011693,51014605,False,1,2912
11716,51011693,51017505,False,1,5812
11717,51011693,51019015,True,1,7322
11718,51023338,51023634,False,1,296
11719,51055516,51056626,True,1,1110
11720,51063252,51074248,True,2,10996
11721,51098688,51100257,True,2,1569
11722,51107306,51107890,True,1,584
11723,51115501,51115732,True,1,231
11724,51137935,51138778,False,2,843
11725,51137935,51138778,True,1,843
11726,51166799,51167625,True,4,826
11727,51190789,51198065,True,1,7276
11728,51191692,51193158,True,1,1466
11729,51198166,51210042,True,9,11876
11730,51200488,51202223,True,11,1735
11731,51209451,51217472,False,1,8021
11732,51212963,51217274,True,1,4311
11733,51231244,51232980,True,1,1736
11734,51242566,51249917,False,1,7351
11735,51242566,51249917,True,2,7351
11736,51242566,51250010,True,1,7444
11737,51242566,51252909,True,2,10343
11738,51258409,51285685,True,3,27276
11739,51267306,51330548,False,1,63242
11740,51279363,51280319,True,2,956
11741,51284368,51292366,True,1,7998
11742,51299978,51305920,True,1,5942
11743,51300903,51306156,True,1,5253
11744,51301256,51302819,False,1,1563
11745,51305141,51306036,True,1,895
11746,51305141,51314206,True,1,9065
11747,51305715,51309455,True,1,3740
11748,51308205,51310699,True,1,2494
11749,51312523,51321051,True,2,8528
11750,51312523,51321480,True,1,8957
11751,51313998,51316828,True,1,2830
11752,51314946,51321552,True,2,6606
11753,51316271,51322203,True,1,5932
11754,51329735,51331751,True,2,2016
11755,51329735,51342903,False,2,13168
11756,51355466,51356155,False,1,689
11757,51377783,51385695,True,6,7912
11758,51377783,51400939,True,1,23156
11759,51401401,51407353,False,1,5952
11760,51401401,51407353,True,1,5952
11761,51407818,51850277,True,1,442459
11762,51428565,51429230,False,1,665
11763,51487290,51487646,True,2,356
11764,51488441,51489629,False,2,1188
11765,51490151,51491163,False,1,1012
11766,51491004,51491280,False,1,276
11767,51495253,51497945,True,2,2692
11768,51495399,51498179,True,1,2780
11769,51499234,51508202,True,1,8968
11770,51500000,51502926,False,1,2926
11771,51505028,51505977,False,1,949
11772,51509935,51517079,True,2,7144
11773,51510601,51583992,False,1,73391
11774,51515056,51530638,False,1,15582
11775,51515056,51530638,True,2,15582
11776,51515056,51567992,True,1,52936
11777,51518348,51518428,True,1,80
11778,51521560,51521937,False,1,377
11779,51521560,51521937,True,3,377
11780,51521560,51531056,True,1,9496
11781,51524435,51530716,True,2,6281
11782,51547642,51551892,True,1,4250
11783,51560219,51560465,False,1,246
11784,51566571,51582134,False,1,15563
11785,51566571,51582134,True,1,15563
11786,51598079,51600048,True,1,1969
11787,51598141,51609717,True,1,11576
11788,51598141,51676627,False,1,78486
11789,51598157,51600126,True,1,1969
11790,51602271,51611618,False,1,9347
11791,51605025,51628091,True,1,23066
11792,51643970,51646125,True,1,2155
11793,51654886,51657173,False,1,2287
11794,51656533,51666023,True,1,9490
11795,51663200,51664041,True,3,841
11796,51663856,51664569,True,1,713
11797,51669536,51670515,False,1,979
11798,51688304,51693334,True,1,5030
11799,51688304,51695730,True,1,7426
11800,51690853,51690933,True,2,80
11801,51701253,51701390,True,1,137
11802,51701380,51705645,True,1,4265
11803,51703485,51704902,False,1,1417
11804,51740352,51750486,True,1,10134
11805,51751683,51757607,True,3,5924
11806,51766467,51768711,True,1,2244
11807,51774824,51791858,True,1,17034
11808,51778753,51778843,False,1,90
11809,51778941,51779447,True,1,506
11810,51779634,51786507,True,1,6873
11811,51800311,51802202,False,5,1891
11812,51809182,51814187,True,1,5005
11813,51826662,51827754,True,1,1092
11814,51826662,51827789,True,2,1127
11815,51831061,51833335,True,1,2274
11816,51831857,51845746,True,1,13889
11817,51848980,51849125,True,1,145
11818,51872957,51873172,False,1,215
11819,51874163,51875457,True,1,1294
11820,51881368,51946312,False,1,64944
11821,51888786,51924689,True,1,35903
11822,51888786,51956887,True,1,68101
11823,51892634,51989321,True,1,96687
11824,51916503,51923460,True,4,6957
11825,51921980,51961202,False,1,39222
11826,51921980,51961202,True,2,39222
11827,51921980,52001417,True,1,79437
11828,51925999,51926191,True,1,192
11829,51929597,51934815,True,1,5218
11830,51930721,51931491,True,1,770
11831,51946913,51948529,True,1,1616
11832,51980959,51985918,False,1,4959
11833,51980959,51989900,False,1,8941
11834,52070970,52084800,False,1,13830
11835,52085920,52086055,True,1,135
11836,52086373,52147249,False,1,60876
11837,52086373,52147249,True,1,60876
11838,52133496,52159029,True,1,25533
11839,52165851,52168204,False,1,2353
11840,52168170,52169696,True,1,1526
11841,52168358,52178564,False,1,10206
11842,52173355,52173435,False,1,80
11843,52175252,52178575,True,5,3323
11844,52175252,52178644,True,1,3392
11845,52175252,52179048,True,2,3796
11846,52175252,52180419,True,1,5167
11847,52175252,52180853,True,1,5601
11848,52189593,52190731,True,1,1138
11849,52195981,52197270,True,1,1289
11850,52196857,52198239,False,1,1382
11851,52215761,52216745,False,2,984
11852,52224044,52259931,False,1,35887
11853,52224044,52259931,True,1,35887
11854,52224044,52320130,True,1,96086
11855,52224044,52320173,True,1,96129
11856,52229988,52238366,True,1,8378
11857,52249388,52262691,False,1,13303
11858,52253507,52274655,True,1,21148
11859,52253570,52254198,True,2,628
11860,52276379,52295068,True,1,18689
11861,52282764,52286173,True,1,3409
11862,52292916,52295904,True,4,2988
11863,52293588,52296191,True,1,2603
11864,52294812,52296826,True,1,2014
11865,52295219,52407985,False,1,112766
11866,52298348,52300186,True,1,1838
11867,52298639,52299153,True,1,514
11868,52301394,52301626,False,1,232
11869,52301394,52301626,True,2,232
11870,52301530,52301911,True,1,381
11871,52305439,52308120,True,1,2681
11872,52313043,52313498,True,1,455
11873,52317135,52329549,True,1,12414
11874,52318553,52323277,True,4,4724
11875,52322833,52324398,True,1,1565
11876,52332136,52332830,True,1,694
11877,52336127,52340081,False,1,3954
11878,52378326,52385072,True,1,6746
11879,52383199,52383618,True,1,419
11880,52384534,52409407,True,1,24873
11881,52394508,52396096,True,1,1588
11882,52411419,52413657,True,1,2238
11883,52411855,52412637,True,1,782
11884,52412777,52414978,True,1,2201
11885,52421200,52422457,True,1,1257
11886,52421705,52542018,True,1,120313
11887,52423036,52429679,False,1,6643
11888,52423036,52438656,True,1,15620
11889,52425905,52429954,False,1,4049
11890,52446258,52447672,True,3,1414
11891,52448959,52449554,True,1,595
11892,52449431,52465693,False,1,16262
11893,52449431,52465693,True,1,16262
11894,52454184,52454586,True,4,402
11895,52461513,52461668,True,2,155
11896,52468600,52469485,True,1,885
11897,52476158,52476678,False,1,520
11898,52481268,52489279,True,1,8011
11899,52481268,52506036,True,1,24768
11900,52481887,52489650,True,1,7763
11901,52482011,52483419,True,1,1408
11902,52482769,52483912,True,2,1143
11903,52495938,52496662,True,1,724
11904,52514332,52578257,True,1,63925
11905,52549059,52549519,True,1,460
11906,52563097,52566542,False,1,3445
11907,52574831,52585304,True,2,10473
11908,52575859,52620823,False,1,44964
11909,52642841,52643651,True,1,810
11910,52642841,52709304,True,1,66463
11911,52644621,52710157,True,1,65536
11912,52644758,52710294,True,1,65536
11913,52645098,52686494,True,1,41396
11914,52645098,52710401,True,1,65303
11915,52659232,52662234,True,1,3002
11916,52663220,52717552,True,2,54332
11917,52663267,52717552,True,1,54285
11918,52696732,52725492,True,1,28760
11919,52697389,52725729,True,2,28340
11920,52697389,52754304,True,1,56915
11921,52698186,52703952,True,1,5766
11922,52702474,52739471,True,1,36997
11923,52707545,52817140,True,1,109595
11924,52712310,52712391,False,1,81
11925,52722128,52722284,False,2,156
11926,52728954,52729257,True,1,303
11927,52730309,52730779,True,2,470
11928,52730977,52733598,True,1,2621
11929,52730977,52733613,True,2,2636
11930,52730977,52734188,True,1,3211
11931,52736900,52737196,True,1,296
11932,52740044,52819314,True,1,79270
11933,52743903,52811191,True,1,67288
11934,52756169,52758177,True,1,2008
11935,52766737,52767346,True,5,609
11936,52766850,52767341,True,1,491
11937,52766979,52767456,True,1,477
11938,52780671,52781145,True,1,474
11939,52792160,52795170,True,1,3010
11940,52801184,52804656,True,1,3472
11941,52805104,52808062,True,3,2958
11942,52805104,52808232,True,1,3128
11943,52808066,52808609,True,1,543
11944,52808946,52809418,True,1,472
11945,52827767,52827853,True,2,86
11946,52844741,52845475,False,1,734
11947,52844741,52845475,True,1,734
11948,52846066,52846715,False,1,649
11949,52870300,52872115,True,1,1815
11950,52871148,52874822,True,2,3674
11951,52871969,52875403,True,1,3434
11952,52875566,52878436,True,1,2870
11953,52876673,52877216,True,1,543
11954,52876673,52879048,True,1,2375
11955,52876979,52881352,False,1,4373
11956,52881575,52884307,True,2,2732
11957,52881575,52884882,True,1,3307
11958,52886152,52976428,False,1,90276
11959,52916522,52916985,True,3,463
11960,52916522,52917859,True,1,1337
11961,52935473,52944728,False,1,9255
11962,52935473,52944728,True,3,9255
11963,52944592,52948549,False,1,3957
11964,52966809,52967793,True,1,984
11965,52969271,53014225,True,1,44954
11966,52971127,52973211,True,1,2084
11967,52980700,52981382,True,1,682
11968,52985670,52989322,True,1,3652
11969,52991211,53025185,True,1,33974
11970,52993061,52993294,True,1,233
11971,53003050,53003273,True,1,223
11972,53008052,53010923,True,1,2871
11973,53008070,53010922,False,1,2852
11974,53008070,53010922,True,3,2852
11975,53011049,53011772,True,3,723
11976,53034449,53034894,False,1,445
11977,53034449,53034894,True,2,445
11978,53062926,53063211,False,1,285
11979,53063015,53063432,True,3,417
11980,53063489,53063949,True,1,460
11981,53065784,53065873,True,1,89
11982,53077300,53083924,True,1,6624
11983,53080893,53092173,True,1,11280
11984,53104004,53105703,False,1,1699
11985,53107492,53107918,False,1,426
11986,53121493,53126943,True,3,5450
11987,53131168,53253809,True,6,122641
11988,53138110,53156121,False,1,18011
11989,53138110,53156121,True,1,18011
11990,53139315,53141805,False,1,2490
11991,53149378,53150762,False,1,1384
11992,53149445,53149633,True,1,188
11993,53163350,53165239,True,2,1889
11994,53163350,53167288,True,1,3938
11995,53171459,53200334,True,2,28875
11996,53171459,53224376,True,1,52917
11997,53186424,53186790,False,1,366
11998,53187902,53188268,False,1,366
11999,53189134,53189500,False,1,366
12000,53190614,53190980,False,1,366
12001,53191635,53191729,True,1,94
12002,53194621,53195310,True,1,689
12003,53207448,53236129,True,1,28681
12004,53211931,53233462,True,1,21531
12005,53211931,53322213,False,1,110282
12006,53211931,53327268,True,1,115337
12007,53212906,53213466,True,1,560
12008,53217595,53217619,True,1,24
12009,53217832,53217910,True,4,78
12010,53222884,53223164,True,2,280
12011,53228208,53241708,True,1,13500
12012,53228208,53330459,False,1,102251
12013,53228208,53335514,True,1,107306
12014,53239938,53243512,True,1,3574
12015,53247036,53251166,True,1,4130
12016,53249795,53261993,False,1,12198
12017,53249795,53261993,True,1,12198
12018,53255404,53348823,True,1,93419
12019,53263016,53263981,False,1,965
12020,53269465,53270402,False,1,937
12021,53273566,53278495,True,3,4929
12022,53273566,53293394,True,1,19828
12023,53288972,53289427,False,1,455
12024,53288972,53291070,True,1,2098
12025,53292511,53298647,True,1,6136
12026,53296896,53297002,True,1,106
12027,53311033,53311547,True,1,514
12028,53311109,53311547,True,4,438
12029,53311109,53312817,True,1,1708
12030,53314770,53316099,True,1,1329
12031,53316321,53324697,True,1,8376
12032,53325429,53328979,True,1,3550
12033,53325429,53329880,True,1,4451
12034,53326179,53326286,True,1,107
12035,53329027,53415301,True,1,86274
12036,53332417,53332830,True,1,413
12037,53348915,53349765,False,1,850
12038,53348915,53349765,True,1,850
12039,53355044,53355601,True,1,557
12040,53357076,53358430,True,1,1354
12041,53361158,53362944,True,3,1786
12042,53361158,53363583,True,2,2425
12043,53369590,53370623,True,2,1033
12044,53376637,53376729,True,1,92
12045,53376637,53377639,True,2,1002
12046,53377328,53378472,True,2,1144
12047,53381363,53383512,False,1,2149
12048,53381363,53383512,True,1,2149
12049,53382874,53383513,False,1,639
12050,53382959,53383104,True,1,145
12051,53388800,53389032,True,1,232
12052,53398189,53398190,True,1,1
12053,53412841,53495861,True,1,83020
12054,53415962,53416395,True,3,433
12055,53423637,53423745,True,1,108
12056,53427352,53431913,True,1,4561
12057,53432857,53459862,False,1,27005
12058,53446188,53447467,False,1,1279
12059,53448389,53449284,True,2,895
12060,53450461,53451805,False,1,1344
12061,53454649,53454844,True,3,195
12062,53463819,53464236,True,1,417
12063,53472307,53478761,True,1,6454
12064,53474681,53475143,False,1,462
12065,53474681,53475143,True,1,462
12066,53487563,53490700,False,1,3137
12067,53516783,53551150,False,2,34367
12068,53517639,53518152,True,5,513
12069,53528331,53528605,True,1,274
12070,53529035,53532099,False,1,3064
12071,53571034,53584248,True,1,13214
12072,53571879,53584670,True,1,12791
12073,53576633,53579550,True,3,2917
12074,53576828,53577531,True,1,703
12075,53578615,53579119,False,1,504
12076,53581974,53594770,True,5,12796
12077,53598019,53598873,True,1,854
12078,53601495,53615089,True,2,13594
12079,53601495,53616893,True,2,15398
12080,53601495,53618133,True,1,16638
12081,53608333,53609763,True,1,1430
12082,53650731,53654635,True,1,3904
12083,53657661,53740457,True,3,82796
12084,53666738,53684249,True,1,17511
12085,53678623,53679166,False,1,543
12086,53683327,53701744,True,2,18417
12087,53696218,53700671,True,6,4453
12088,53702068,53702477,True,1,409
12089,53712722,53719662,True,1,6940
12090,53715747,53721232,True,1,5485
12091,53720674,53721301,True,1,627
12092,53721011,53721362,False,1,351
12093,53725303,53783436,True,3,58133
12094,53738251,53744404,True,1,6153
12095,53739364,53743008,True,1,3644
12096,53744437,53746564,True,1,2127
12097,53744868,53745698,True,2,830
12098,53748151,53748417,True,1,266
12099,53748494,53749547,True,1,1053
12100,53748591,53748739,True,1,148
12101,53758059,53759030,False,1,971
12102,53759794,53759814,True,1,20
12103,53759914,53761836,True,1,1922
12104,53761918,53762272,True,4,354
12105,53762440,53766429,True,2,3989
12106,53776227,53777996,True,4,1769
12107,53800771,53800883,True,1,112
12108,53807049,53809182,True,1,2133
12109,53809370,53809608,True,1,238
12110,53809441,53811197,True,1,1756
12111,53814164,53817553,True,1,3389
12112,53815796,53818134,True,1,2338
12113,53820287,53824259,True,3,3972
12114,53831606,53866113,True,1,34507
12115,53833257,53856612,True,2,23355
12116,53833257,53864269,True,1,31012
12117,53843946,53845891,True,2,1945
12118,53849733,53861006,False,1,11273
12119,53852414,53852864,False,1,450
12120,53861555,53861779,False,1,224
12121,53869025,53876603,False,1,7578
12122,53869247,53869914,False,1,667
12123,53872698,53873140,True,1,442
12124,53874438,53875826,True,1,1388
12125,53877235,53877345,True,1,110
12126,53879019,53880847,True,1,1828
12127,53883721,53884137,True,1,416
12128,53894180,53908981,True,1,14801
12129,53894770,53909254,True,1,14484
12130,53912884,53918315,True,2,5431
12131,53916033,53917978,True,1,1945
12132,53916033,53919112,True,1,3079
12133,53932556,53932669,True,1,113
12134,53933635,53934168,True,1,533
12135,53951667,53957676,False,1,6009
12136,53951667,53957676,True,1,6009
12137,53960242,53966842,True,3,6600
12138,53960242,53977690,True,6,17448
12139,53973363,53977683,True,2,4320
12140,53974435,53984258,True,2,9823
12141,53974435,53985051,True,1,10616
12142,53974435,53985471,True,1,11036
12143,53975743,53976247,True,1,504
12144,53978661,53989074,True,1,10413
12145,53978661,53989688,True,1,11027
12146,53988981,53989441,True,1,460
12147,53990998,53993202,True,1,2204
12148,54009274,54013701,True,1,4427
12149,54018045,54023878,False,1,5833
12150,54018045,54023878,True,2,5833
12151,54023793,54067786,False,1,43993
12152,54023793,54067786,True,4,43993
12153,54032266,54032785,True,1,519
12154,54035877,54036474,True,1,597
12155,54046552,54078661,True,3,32109
12156,54047115,54047630,True,1,515
12157,54061763,54061856,True,4,93
12158,54073198,54076049,True,13,2851
12159,54082947,54083377,True,1,430
12160,54083026,54083107,True,7,81
12161,54083613,54084357,True,1,744
12162,54086089,54086929,True,1,840
12163,54094047,54094722,True,1,675
12164,54094756,54095031,True,1,275
12165,54103276,54103685,True,2,409
12166,54107063,54112723,False,4,5660
12167,54111709,54116830,True,1,5121
12168,54112224,54113511,True,1,1287
12169,54116580,54117344,True,3,764
12170,54125083,54125269,True,1,186
12171,54125787,54139703,True,1,13916
12172,54128507,54128616,False,1,109
12173,54137798,54182062,True,1,44264
12174,54142090,54192330,True,1,50240
12175,54142295,54145251,True,2,2956
12176,54142383,54192518,True,1,50135
12177,54142656,54192653,True,1,49997
12178,54154120,54155670,True,1,1550
12179,54154138,54155688,True,1,1550
12180,54169889,54176597,True,3,6708
12181,54171183,54178003,True,1,6820
12182,54182947,54198380,True,3,15433
12183,54187002,54187802,False,1,800
12184,54188235,54190554,True,2,2319
12185,54188235,54191299,True,2,3064
12186,54193778,54194325,True,5,547
12187,54194535,54195425,True,2,890
12188,54195426,54196598,True,1,1172
12189,54198783,54199140,True,1,357
12190,54202530,54202885,True,1,355
12191,54212531,54220257,True,1,7726
12192,54214638,54221139,True,1,6501
12193,54215217,54221210,True,1,5993
12194,54218786,54266973,True,3,48187
12195,54218786,54277637,True,1,58851
12196,54218786,54278637,True,1,59851
12197,54224123,54225739,True,1,1616
12198,54224803,54226146,True,1,1343
12199,54229212,54231701,True,1,2489
12200,54229563,54231926,True,1,2363
12201,54229988,54231926,True,1,1938
12202,54251665,54252932,True,1,1267
12203,54263795,54318935,True,2,55140
12204,54267027,54267491,True,2,464
12205,54271719,54274427,False,1,2708
12206,54271719,54275108,False,1,3389
12207,54281056,54281699,True,1,643
12208,54288047,54289080,True,2,1033
12209,54291309,54537190,False,1,245881
12210,54294147,54295540,True,2,1393
12211,54295367,54299267,False,1,3900
12212,54305204,54309822,True,2,4618
12213,54306830,54312136,True,1,5306
12214,54315959,54326310,True,1,10351
12215,54317052,54317444,True,1,392
12216,54321367,54322091,False,1,724
12217,54323182,54323621,False,1,439
12218,54337315,54337860,True,1,545
12219,54338224,54338817,True,1,593
12220,54351008,54354805,True,2,3797
12221,54351008,54355732,False,1,4724
12222,54351258,54354805,False,1,3547
12223,54354418,54354506,False,1,88
12224,54354418,54354511,True,1,93
12225,54359934,54362997,True,1,3063
12226,54360140,54371174,True,1,11034
12227,54362374,54363333,True,1,959
12228,54364377,54365322,False,1,945
12229,54364377,54365322,True,2,945
12230,54366193,54438058,True,1,71865
12231,54366278,54438143,True,1,71865
12232,54369981,54370146,True,1,165
12233,54370737,54372126,True,1,1389
12234,54373812,54377973,True,1,4161
12235,54374025,54378889,False,1,4864
12236,54387194,54438602,True,1,51408
12237,54387533,54397687,False,1,10154
12238,54388178,54389121,True,1,943
12239,54405516,54406551,False,1,1035
12240,54405516,54406551,True,1,1035
12241,54407848,54407946,True,1,98
12242,54412112,54416521,True,1,4409
12243,54413973,54414085,True,1,112
12244,54417129,54417441,False,1,312
12245,54419459,54426108,False,1,6649
12246,54422001,54423175,True,1,1174
12247,54422001,54429472,False,1,7471
12248,54429763,54432314,True,1,2551
12249,54429763,54436218,True,1,6455
12250,54430791,54436707,True,1,5916
12251,54431087,54431160,False,1,73
12252,54431087,54431160,True,2,73
12253,54433163,54438575,True,2,5412
12254,54433350,54433502,False,1,152
12255,54433350,54433502,True,2,152
12256,54434695,54435878,True,2,1183
12257,54439273,54442217,False,1,2944
12258,54440625,54443474,False,1,2849
12259,54443355,54453298,True,1,9943
12260,54443422,54444828,False,1,1406
12261,54443422,54444828,True,1,1406
12262,54450708,54452804,True,3,2096
12263,54450908,54453244,False,1,2336
12264,54452025,54452127,False,1,102
12265,54465805,54466142,True,2,337
12266,54468389,54468888,True,1,499
12267,54470968,54471437,False,1,469
12268,54472871,54473359,False,1,488
12269,54472871,54473359,True,1,488
12270,54473622,54474363,True,2,741
12271,54474559,54475271,True,1,712
12272,54475484,54482710,True,1,7226
12273,54476551,54477872,True,1,1321
12274,54479456,54480056,True,1,600
12275,54479794,54480394,True,1,600
12276,54480179,54480279,False,1,100
12277,54491441,54493067,False,1,1626
12278,54496632,54498790,True,1,2158
12279,54506919,54529919,True,1,23000
12280,54506942,54516892,True,11,9950
12281,54507038,54524829,False,1,17791
12282,54511807,54512706,True,2,899
12283,54514467,54554881,True,1,40414
12284,54549151,54550269,False,1,1118
12285,54549151,54550269,True,2,1118
12286,54552688,54553217,True,1,529
12287,54559090,54572380,False,1,13290
12288,54560666,54561179,False,1,513
12289,54564942,54565121,False,1,179
12290,54564942,54565121,True,1,179
12291,54564958,54565121,True,2,163
12292,54565239,54566828,True,1,1589
12293,54565339,54566402,True,1,1063
12294,54565339,54566983,True,1,1644
12295,54569623,54570858,True,2,1235
12296,54576925,54577305,True,1,380
12297,54577509,54578295,True,1,786
12298,54582129,54587737,True,1,5608
12299,54584624,54586451,True,1,1827
12300,54586930,54587533,True,1,603
12301,54587696,54588888,True,3,1192
12302,54603537,54604451,True,2,914
12303,54613358,54613745,True,1,387
12304,54616677,54616823,True,1,146
12305,54619829,54624808,True,2,4979
12306,54619829,54629205,True,1,9376
12307,54636548,54637771,True,3,1223
12308,54641297,54646530,True,1,5233
12309,54644928,54645502,True,1,574
12310,54644928,54647183,True,1,2255
12311,54648201,54648251,True,3,50
12312,54648217,54648424,True,2,207
12313,54650570,54666614,True,1,16044
12314,54650570,54676734,True,3,26164
12315,54653601,54656557,True,1,2956
12316,54655820,54684236,True,1,28416
12317,54659684,54660648,False,1,964
12318,54663317,54664052,True,1,735
12319,54664958,54670406,True,1,5448
12320,54666283,54667422,True,1,1139
12321,54693586,54697963,False,1,4377
12322,54693586,54697963,True,1,4377
12323,54693586,54698467,False,1,4881
12324,54697344,54706959,True,2,9615
12325,54697344,54706961,True,1,9617
12326,54697344,54706997,True,1,9653
12327,54697344,54709637,True,1,12293
12328,54704315,54706433,True,1,2118
12329,54708000,54708162,True,2,162
12330,54713377,54723742,True,1,10365
12331,54720642,54722301,True,1,1659
12332,54721276,54721550,True,1,274
12333,54725123,54726847,True,1,1724
12334,54740274,54741792,True,1,1518
12335,54742404,54749366,True,1,6962
12336,54744167,54744933,True,1,766
12337,54764147,54776073,True,1,11926
12338,54778197,54780667,True,2,2470
12339,54794342,54847718,True,1,53376
12340,54794342,54852145,True,1,57803
12341,54800088,54802487,True,3,2399
12342,54802459,54809859,True,5,7400
12343,54827421,54827881,True,1,460
12344,54827421,54854857,True,1,27436
12345,54832547,54834949,False,3,2402
12346,54832547,54834949,True,5,2402
12347,54832547,54838853,False,3,6306
12348,54832547,54838853,True,5,6306
12349,54839559,54843123,True,3,3564
12350,54844030,54845730,True,1,1700
12351,54845901,54846318,True,1,417
12352,54846419,54846836,True,1,417
12353,54852434,54852991,True,3,557
12354,54860783,54864458,True,1,3675
12355,54864519,54866078,True,1,1559
12356,54870233,54870941,True,1,708
12357,54870693,54871261,True,1,568
12358,54870944,54872180,True,1,1236
12359,54877260,54879953,True,1,2693
12360,54880758,54881000,True,2,242
12361,54888293,54891228,False,1,2935
12362,54888293,54891228,True,3,2935
12363,54890183,54900174,True,1,9991
12364,54910200,54910408,True,4,208
12365,54920117,54923052,False,1,2935
12366,54930774,54940536,True,1,9762
12367,54935027,54935382,True,1,355
12368,54941466,54942773,True,1,1307
12369,54944816,54945546,True,2,730
12370,54945024,54948038,False,7,3014
12371,54955767,54956691,True,3,924
12372,54970513,54977509,True,7,6996
12373,54971822,55006979,True,4,35157
12374,54971855,55006979,True,2,35124
12375,54983300,54998793,True,2,15493
12376,54986846,54987493,True,1,647
12377,54996709,54997260,True,2,551
12378,54996769,54997382,True,1,613
12379,55011063,55026729,True,2,15666
12380,55036315,55036868,True,2,553
12381,55049270,55050314,True,1,1044
12382,55056843,55089963,False,19,33120
12383,55056843,55189788,False,6,132945
12384,55061040,55061290,True,1,250
12385,55065208,55067124,False,1,1916
12386,55065208,55067124,True,2,1916
12387,55085822,55086047,False,1,225
12388,55094962,55095095,True,2,133
12389,55095521,55099574,False,1,4053
12390,55098475,55098757,True,4,282
12391,55113119,55113307,True,1,188
12392,55116995,55117565,True,1,570
12393,55122145,55122875,True,1,730
12394,55122448,55148451,True,2,26003
12395,55122965,55146687,True,1,23722
12396,55131049,55135867,True,2,4818
12397,55147786,55150032,True,1,2246
12398,55160873,55162083,True,1,1210
12399,55174462,55177367,True,2,2905
12400,55174684,55174801,True,6,117
12401,55175039,55177087,False,1,2048
12402,55180688,55180959,True,1,271
12403,55184594,55188819,False,2,4225
12404,55184594,55188819,True,2,4225
12405,55184594,55196424,False,1,11830
12406,55186870,55187496,True,1,626
12407,55187035,55187496,True,7,461
12408,55187035,55188850,True,1,1815
12409,55187035,55189474,False,1,2439
12410,55187035,55189474,True,1,2439
12411,55188329,55189607,True,1,1278
12412,55201335,55201429,True,2,94
12413,55202957,55203142,False,2,185
12414,55208737,55209056,True,1,319
12415,55211389,55211603,False,1,214
12416,55217086,55258523,True,1,41437
12417,55238852,55239446,False,1,594
12418,55239650,55243295,True,1,3645
12419,55258831,55261833,True,1,3002
12420,55264181,55265071,False,1,890
12421,55264181,55265071,True,1,890
12422,55266099,55266892,True,1,793
12423,55278742,55278829,False,1,87
12424,55283807,55285492,True,1,1685
12425,55287708,55303707,True,1,15999
12426,55297517,55305844,False,3,8327
12427,55297517,55305844,True,1,8327
12428,55301705,55301839,True,1,134
12429,55302782,55307303,True,1,4521
12430,55312006,55312678,False,1,672
12431,55318151,55318360,True,1,209
12432,55323862,55331948,False,1,8086
12433,55324098,55331904,False,2,7806
12434,55330539,55330676,True,3,137
12435,55330942,55331019,True,1,77
12436,55334627,55335118,False,1,491
12437,55334627,55335118,True,1,491
12438,55335155,55335610,True,2,455
12439,55337123,55340268,True,2,3145
12440,55343379,55345273,True,2,1894
12441,55354342,55408127,True,7,53785
12442,55356573,55356806,True,2,233
12443,55356573,55358142,True,1,1569
12444,55356573,55372046,True,1,15473
12445,55356573,55397368,True,1,40795
12446,55356573,55398150,True,1,41577
12447,55356573,55398168,True,1,41595
12448,55356573,55398662,True,1,42089
12449,55356573,55398957,True,1,42384
12450,55356573,55398967,True,1,42394
12451,55356573,55399283,True,1,42710
12452,55356573,55417497,True,1,60924
12453,55356573,55418332,True,1,61759
12454,55356573,55418415,True,1,61842
12455,55356573,55418630,True,1,62057
12456,55356573,55419398,True,1,62825
12457,55363629,55363827,True,2,198
12458,55369456,55369554,True,1,98
12459,55375285,55379255,True,1,3970
12460,55389782,55394059,True,3,4277
12461,55391568,55392685,True,2,1117
12462,55412280,55413863,True,1,1583
12463,55413882,55414632,True,1,750
12464,55417621,55419374,False,1,1753
12465,55430094,55430280,True,1,186
12466,55435984,55496413,True,2,60429
12467,55438388,55439443,True,1,1055
12468,55439536,55439814,True,3,278
12469,55456985,55464482,True,2,7497
12470,55459142,55459601,True,1,459
12471,55465573,55466917,True,1,1344
12472,55465573,55469797,True,1,4224
12473,55516681,55517515,True,1,834
12474,55516738,55517515,True,3,777
12475,55524236,55526548,True,2,2312
12476,55538444,55538863,True,1,419
12477,55558160,55567126,True,1,8966
12478,55559601,55567848,True,3,8247
12479,55576536,55577115,True,1,579
12480,55582552,55916747,True,1,334195
12481,55586468,55591904,False,1,5436
12482,55586468,55591904,True,5,5436
12483,55587452,55587799,False,1,347
12484,55601637,55617655,True,4,16018
12485,55611830,55612358,True,1,528
12486,55611844,55612126,True,2,282
12487,55611844,55612358,True,2,514
12488,55611844,55626767,False,1,14923
12489,55611844,55626767,True,1,14923
12490,55611844,55626770,True,1,14926
12491,55613165,55615662,False,1,2497
12492,55613194,55615718,True,1,2524
12493,55614587,55616301,True,1,1714
12494,55651413,55653591,True,2,2178
12495,55652259,55661775,True,1,9516
12496,55659734,55662125,True,1,2391
12497,55679477,55691116,True,1,11639
12498,55681198,55692834,False,1,11636
12499,55681198,55692834,True,1,11636
12500,55689668,55690082,True,1,414
12501,55699289,55699766,True,1,477
12502,55699289,55700320,True,1,1031
12503,55703095,55703754,True,1,659
12504,55703095,55704238,True,2,1143
12505,55703898,55704586,True,2,688
12506,55704421,55704836,True,1,415
12507,55722182,55734525,True,1,12343
12508,55727593,55731416,True,2,3823
12509,55742787,55750507,True,2,7720
12510,55747451,55747866,False,1,415
12511,55749376,55751573,False,1,2197
12512,55750292,55751908,True,5,1616
12513,55752471,55753172,True,1,701
12514,55755740,55755927,True,1,187
12515,55760459,55763957,True,1,3498
12516,55773781,55774302,True,1,521
12517,55777792,55780790,True,1,2998
12518,55791586,55791772,True,1,186
12519,55802418,55802581,True,3,163
12520,55831927,55835194,True,1,3267
12521,55833680,55851558,True,1,17878
12522,55841279,55855284,False,1,14005
12523,55841279,55855284,True,1,14005
12524,55860992,55868078,True,1,7086
12525,55867321,55877825,True,1,10504
12526,55878433,55878528,True,5,95
12527,55884648,55884734,True,2,86
12528,55884652,55884741,True,2,89
12529,55895597,55902482,True,1,6885
12530,55898787,55960434,True,2,61647
12531,55898787,56243287,True,1,344500
12532,55900127,55901285,True,1,1158
12533,55901333,55905317,True,3,3984
12534,55901333,55907926,True,2,6593
12535,55912913,55915948,True,2,3035
12536,55926146,55926250,True,2,104
12537,55950073,55952381,True,1,2308
12538,55985557,55987306,True,3,1749
12539,55989249,55990122,True,2,873
12540,55997755,55999907,False,1,2152
12541,55997755,55999907,True,1,2152
12542,56000025,56000774,False,1,749
12543,56000640,56090125,True,2,89485
12544,56002106,56004765,True,2,2659
12545,56006750,56007536,True,1,786
12546,56008920,56054697,False,1,45777
12547,56008920,56054697,True,1,45777
12548,56019805,56021026,True,6,1221
12549,56065077,56082597,True,1,17520
12550,56084991,56087448,True,1,2457
12551,56097789,56101738,True,1,3949
12552,56098011,56102221,True,1,4210
12553,56098258,56102279,True,1,4021
12554,56105161,56106470,True,6,1309
12555,56117699,56162974,True,1,45275
12556,56117846,56118699,False,1,853
12557,56163676,56164418,False,2,742
12558,56180561,56182971,False,1,2410
12559,56180561,56194093,True,1,13532
12560,56184841,56185575,True,2,734
12561,56199629,56215764,True,1,16135
12562,56202650,56243265,True,1,40615
12563,56202650,56250648,True,3,47998
12564,56219257,56222074,True,3,2817
12565,56219494,56221794,True,1,2300
12566,56219494,56225779,True,2,6285
12567,56220029,56222095,True,1,2066
12568,56222517,56227295,True,2,4778
12569,56227190,56228729,True,2,1539
12570,56227190,56230879,True,4,3689
12571,56231956,56237578,True,2,5622
12572,56238418,56248487,True,1,10069
12573,56242656,56244517,True,1,1861
12574,56243423,56246008,True,1,2585
12575,56254920,56257715,True,1,2795
12576,56258976,56266642,False,1,7666
12577,56259137,56259894,False,1,757
12578,56259796,56261508,True,3,1712
12579,56263660,56266575,False,1,2915
12580,56291348,56331997,True,1,40649
12581,56291348,56337013,True,1,45665
12582,56305464,56363547,True,1,58083
12583,56314653,56316516,True,2,1863
12584,56315081,56316589,True,1,1508
12585,56315201,56316589,True,1,1388
12586,56335269,56337219,True,1,1950
12587,56349481,56361298,True,2,11817
12588,56386136,56387816,True,1,1680
12589,56386172,56387816,True,2,1644
12590,56390156,56417393,True,1,27237
12591,56392061,56392925,True,1,864
12592,56392061,56418429,False,1,26368
12593,56392061,56418429,True,1,26368
12594,56392469,56392719,True,1,250
12595,56398230,56402151,True,5,3921
12596,56409448,56409741,True,4,293
12597,56419202,56419361,True,1,159
12598,56426242,56427234,True,2,992
12599,56436806,56438569,True,2,1763
12600,56440233,56445362,True,1,5129
12601,56444535,56444882,False,1,347
12602,56459225,56462640,True,1,3415
12603,56469778,56474417,True,4,4639
12604,56469778,56474448,True,1,4670
12605,56469778,56478757,True,1,8979
12606,56470367,56474766,True,1,4399
12607,56497307,56498496,True,2,1189
12608,56497307,56502029,False,1,4722
12609,56497307,56502029,True,1,4722
12610,56499008,56500844,True,1,1836
12611,56499008,56500864,True,1,1856
12612,56513859,56526129,True,3,12270
12613,56523258,56533244,True,4,9986
12614,56537478,56537878,False,1,400
12615,56537478,56537878,True,1,400
12616,56564209,56565306,False,1,1097
12617,56566426,56587903,True,1,21477
12618,56568959,56580912,False,1,11953
12619,56572178,56572818,True,2,640
12620,56573376,56576509,True,1,3133
12621,56587145,56587672,True,8,527
12622,56587169,56592433,True,1,5264
12623,56592193,56615989,True,2,23796
12624,56594593,56599291,False,1,4698
12625,56597911,56601737,True,3,3826
12626,56607683,56608666,True,1,983
12627,56608460,56632543,True,1,24083
12628,56630160,56631199,False,1,1039
12629,56630212,56631251,False,1,1039
12630,56630896,56633367,False,1,2471
12631,56630896,56646500,False,1,15604
12632,56635534,56635737,True,1,203
12633,56635534,56644990,True,1,9456
12634,56635534,56646789,True,1,11255
12635,56664486,56668866,True,1,4380
12636,56677999,56873461,True,1,195462
12637,56683095,56685329,False,1,2234
12638,56683095,56685329,True,3,2234
12639,56690960,56691981,False,1,1021
12640,56695245,56696563,False,1,1318
12641,56703581,56709169,True,1,5588
12642,56703581,56711906,True,1,8325
12643,56708384,56709742,True,2,1358
12644,56711565,56711673,True,1,108
12645,56713363,56714397,True,2,1034
12646,56716245,56717403,True,1,1158
12647,56729788,56732164,True,2,2376
12648,56734018,56734480,True,1,462
12649,56736435,56741852,True,1,5417
12650,56746620,56747037,True,1,417
12651,56746624,56747037,True,1,413
12652,56753840,56755236,True,1,1396
12653,56778438,56779374,False,1,936
12654,56781353,56822646,True,1,41293
12655,56782100,56782194,True,7,94
12656,56787468,56787665,False,2,197
12657,56803286,56803666,True,1,380
12658,56803286,56803704,True,1,418
12659,56817947,56819069,False,1,1122
12660,56819894,56822011,True,1,2117
12661,56820312,56822429,True,1,2117
12662,56864096,56886533,True,1,22437
12663,56871548,56871629,True,1,81
12664,56887705,56888142,True,1,437
12665,56887705,56888920,True,1,1215
12666,56887705,56927380,True,1,39675
12667,56887705,56943382,True,1,55677
12668,56898036,56898269,True,1,233
12669,56904679,56979934,True,1,75255
12670,56919552,56920250,True,1,698
12671,56936042,56937400,True,1,1358
12672,56939241,56939349,True,1,108
12673,56943347,56944550,True,1,1203
12674,56943347,56945159,False,1,1812
12675,56950540,57003024,True,1,52484
12676,56951246,56972642,True,1,21396
12677,56951246,56976777,True,2,25531
12678,56951246,56993907,True,1,42661
12679,56953360,56996378,True,1,43018
12680,56956196,56966756,True,1,10560
12681,56966946,56973349,True,1,6403
12682,56977555,56977655,True,5,100
12683,56977740,56977840,False,2,100
12684,56977740,56977840,True,6,100
12685,56986944,56987071,True,1,127
12686,56987128,56987221,True,1,93
12687,56987640,56988972,True,2,1332
12688,56987663,56987742,True,2,79
12689,56987665,56991014,True,2,3349
12690,56988848,56992558,True,1,3710
12691,56992492,56993333,False,1,841
12692,56995478,56995564,False,1,86
12693,56999149,57000501,True,1,1352
12694,57012028,57012387,True,2,359
12695,57021923,57023977,True,1,2054
12696,57046884,57051524,False,1,4640
12697,57046884,57051524,True,1,4640
12698,57054670,57057045,False,1,2375
12699,57054670,57057045,True,1,2375
12700,57062998,57063359,False,1,361
12701,57073710,57075209,True,1,1499
12702,57081010,57081825,True,1,815
12703,57097651,57097986,True,2,335
12704,57104831,57114840,True,1,10009
12705,57109709,57111139,False,1,1430
12706,57110663,57112158,False,1,1495
12707,57118165,57129961,False,1,11796
12708,57118165,57129961,True,1,11796
12709,57118165,57147727,True,1,29562
12710,57125382,57125471,True,3,89
12711,57130666,57157622,True,1,26956
12712,57144389,57144469,True,1,80
12713,57144389,57146806,True,1,2417
12714,57151398,57169113,True,2,17715
12715,57155721,57165997,False,1,10276
12716,57155721,57165997,True,2,10276
12717,57172410,57181654,True,1,9244
12718,57193852,57194503,True,1,651
12719,57206724,57206845,True,2,121
12720,57211844,57413115,True,1,201271
12721,57217275,57224688,False,1,7413
12722,57231371,57242640,True,1,11269
12723,57232467,57242750,True,1,10283
12724,57233634,57234530,False,1,896
12725,57234161,57234282,True,7,121
12726,57237221,57245550,True,1,8329
12727,57247738,57249434,True,4,1696
12728,57251013,57252578,False,1,1565
12729,57251013,57252578,True,4,1565
12730,57287073,57287574,True,2,501
12731,57294119,57294204,True,1,85
12732,57294119,57294799,True,1,680
12733,57311147,57312618,True,1,1471
12734,57311203,57312618,True,2,1415
12735,57311885,57319185,True,1,7300
12736,57343023,57343555,True,1,532
12737,57392428,57430011,False,1,37583
12738,57392428,57430011,True,3,37583
12739,57400027,57422854,True,1,22827
12740,57412685,57417946,True,1,5261
12741,57415155,57419500,False,1,4345
12742,57415155,57419500,True,1,4345
12743,57419887,57419967,True,1,80
12744,57419887,57420768,True,1,881
12745,57423521,57423661,True,1,140
12746,57425866,57461049,True,2,35183
12747,57437973,57458610,True,2,20637
12748,57445620,57445757,True,2,137
12749,57445627,57445760,True,1,133
12750,57445669,57445757,True,1,88
12751,57445889,57447801,True,1,1912
12752,57451534,57484088,True,2,32554
12753,57464678,57502000,False,1,37322
12754,57467219,57467342,True,1,123
12755,57496105,57569236,False,1,73131
12756,57496105,57569236,True,2,73131
12757,57496760,57497499,True,1,739
12758,57496938,57499036,True,2,2098
12759,57527020,57532424,True,1,5404
12760,57527020,57536677,True,1,9657
12761,57529601,57550254,True,1,20653
12762,57532659,57532743,True,3,84
12763,57538268,57538704,True,1,436
12764,57540061,57543541,True,1,3480
12765,57540061,57547372,True,1,7311
12766,57542798,57543091,True,1,293
12767,57579361,57585717,True,1,6356
12768,57597629,57599274,True,1,1645
12769,57608907,57612584,True,3,3677
12770,57608929,57612584,True,1,3655
12771,57612543,57613198,True,1,655
12772,57622385,57623720,False,2,1335
12773,57628429,57641551,False,1,13122
12774,57642734,57648885,True,1,6151
12775,57643357,57644346,True,2,989
12776,57644945,57645359,True,1,414
12777,57644969,57645345,True,3,376
12778,57649596,57650451,True,1,855
12779,57655595,57665145,True,2,9550
12780,57657193,57658460,False,1,1267
12781,57665050,57665184,True,1,134
12782,57665050,57667092,True,3,2042
12783,57669247,57671053,True,8,1806
12784,57669331,57669939,False,1,608
12785,57674252,57674649,True,1,397
12786,57689564,57701112,True,3,11548
12787,57690917,57691047,True,1,130
12788,57708200,57708786,True,1,586
12789,57716157,57730946,True,1,14789
12790,57742828,57743107,True,1,279
12791,57743220,57745789,True,1,2569
12792,57747396,57747527,True,1,131
12793,57749954,57753529,True,1,3575
12794,57750343,57752408,True,3,2065
12795,57750343,57753770,True,1,3427
12796,57750878,57752626,True,1,1748
12797,57751987,57755295,False,1,3308
12798,57751987,57755295,True,4,3308
12799,57753667,57753963,True,1,296
12800,57756709,57757002,False,2,293
12801,57759177,57759678,False,1,501
12802,57759177,57759678,True,1,501
12803,57772785,57773174,False,1,389
12804,57772785,57773174,True,1,389
12805,57779918,57780226,True,2,308
12806,57780702,57781085,True,1,383
12807,57780702,57781138,True,1,436
12808,57780705,57781085,True,1,380
12809,57780705,57781138,True,1,433
12810,57782788,57783607,True,1,819
12811,57793299,57795984,False,1,2685
12812,57796362,57804593,True,1,8231
12813,57799020,57799836,False,1,816
12814,57800381,57803741,False,1,3360
12815,57801255,57801358,False,1,103
12816,57807161,57830402,False,1,23241
12817,57810241,57811092,False,5,851
12818,57832106,57832457,True,3,351
12819,57837622,57838915,True,1,1293
12820,57838262,57839210,True,1,948
12821,57843928,57844024,True,1,96
12822,57847393,57847480,True,1,87
12823,57853077,57853929,True,2,852
12824,57854017,57854116,False,1,99
12825,57859694,57861490,True,2,1796
12826,57863422,57871207,True,1,7785
12827,57871027,57873352,False,1,2325
12828,57871027,57873352,True,2,2325
12829,57885033,57901253,True,1,16220
12830,57886668,57886924,True,2,256
12831,57895014,57895108,False,1,94
12832,57913661,57921836,True,2,8175
12833,57923928,57930782,True,1,6854
12834,57924282,57925578,True,1,1296
12835,57925036,57925768,True,2,732
12836,57926956,57929102,True,3,2146
12837,57928173,57934852,False,1,6679
12838,57928173,57935027,True,1,6854
12839,57933325,57936608,True,1,3283
12840,57934669,57934760,True,1,91
12841,57936276,57964129,False,1,27853
12842,57939952,57940080,True,1,128
12843,57946425,57953085,True,1,6660
12844,57949260,57974326,True,1,25066
12845,57949299,57949515,True,1,216
12846,57949299,57974328,True,2,25029
12847,57949667,57974340,True,1,24673
12848,57966059,57968982,False,2,2923
12849,57972279,57972515,True,1,236
12850,57972516,57972602,True,1,86
12851,57972658,57976139,False,2,3481
12852,57972667,57976148,False,1,3481
12853,57972808,57972906,True,3,98
12854,57972808,57975322,True,1,2514
12855,57985876,57989487,False,1,3611
12856,57990470,57990470,True,1,0
12857,57990590,58005332,True,2,14742
12858,57990590,58005335,True,1,14745
12859,57992363,57992557,True,3,194
12860,57992394,57992841,True,1,447
12861,57993534,57993728,True,2,194
12862,58007431,58008281,True,1,850
12863,58008121,58011988,True,1,3867
12864,58011111,58012153,True,1,1042
12865,58012377,58013905,True,1,1528
12866,58039296,58055361,False,1,16065
12867,58055619,58064132,True,1,8513
12868,58066881,58067135,False,1,254
12869,58067512,58071176,True,1,3664
12870,58067512,58072560,True,1,5048
12871,58070106,58070248,False,1,142
12872,58070744,58105437,True,3,34693
12873,58073454,58098538,False,1,25084
12874,58077977,58080774,True,1,2797
12875,58081853,58082243,True,1,390
12876,58095391,58149678,True,1,54287
12877,58107508,58108748,True,1,1240
12878,58117864,58118225,False,1,361
12879,58123041,58123129,False,1,88
12880,58126453,58126689,True,1,236
12881,58126794,58127303,True,1,509
12882,58126794,58127904,True,1,1110
12883,58127655,58128230,True,1,575
12884,58145795,58145879,True,1,84
12885,58155131,58155945,False,1,814
12886,58156285,58176226,True,1,19941
12887,58160112,58161708,False,1,1596
12888,58160112,58162939,False,1,2827
12889,58160112,58163060,False,1,2948
12890,58167704,58168851,False,3,1147
12891,58167704,58168851,True,7,1147
12892,58172604,58174137,False,4,1533
12893,58180887,58180968,True,1,81
12894,58189429,58210407,False,1,20978
12895,58221162,58222636,True,2,1474
12896,58231437,58233651,False,1,2214
12897,58235321,58242383,True,1,7062
12898,58244392,58245171,False,1,779
12899,58262591,58271831,True,1,9240
12900,58262591,58343565,True,1,80974
12901,58262591,58345008,True,1,82417
12902,58276361,58277910,True,1,1549
12903,58277775,58324117,True,1,46342
12904,58287503,58289520,False,1,2017
12905,58318453,58320186,True,1,1733
12906,58324231,58325387,True,1,1156
12907,58325218,58327044,False,1,1826
12908,58337683,58338372,True,2,689
12909,58337683,58345595,True,1,7912
12910,58338337,58338837,True,1,500
12911,58343663,58344586,True,1,923
12912,58372560,58372662,True,1,102
12913,58382267,58382580,True,2,313
12914,58385506,58386375,True,2,869
12915,58407932,58408452,False,1,520
12916,58407932,58408452,True,3,520
12917,58408567,58421752,True,2,13185
12918,58427324,58527543,True,3,100219
12919,58427324,58527560,True,2,100236
12920,58427794,58501796,True,2,74002
12921,58452624,58453429,False,1,805
12922,58452624,58453429,True,1,805
12923,58454033,58457535,True,1,3502
12924,58462575,58464212,True,1,1637
12925,58466464,58469685,True,1,3221
12926,58468726,58566659,True,1,97933
12927,58468726,58628359,False,1,159633
12928,58468726,58628359,True,3,159633
12929,58468726,58773601,True,1,304875
12930,58474687,58482282,True,1,7595
12931,58474955,58631595,True,1,156640
12932,58482367,58555028,True,3,72661
12933,58483970,58484473,True,2,503
12934,58497879,58498709,False,1,830
12935,58497879,58498709,True,3,830
12936,58506869,58507510,False,1,641
12937,58512725,58514624,True,1,1899
12938,58549310,58549853,True,1,543
12939,58549935,58552295,True,3,2360
12940,58559808,58662816,True,1,103008
12941,58572488,58578013,True,1,5525
12942,58596418,58609588,True,3,13170
12943,58596418,58622213,True,1,25795
12944,58604275,58725278,True,1,121003
12945,58606024,58616433,True,1,10409
12946,58626845,58696438,True,1,69593
12947,58627316,58637276,False,1,9960
12948,58628359,58633782,True,1,5423
12949,58628376,58633799,True,1,5423
12950,58628376,58652334,True,1,23958
12951,58641383,58664808,True,1,23425
12952,58646049,58799034,True,4,152985
12953,58646049,58799037,True,1,152988
12954,58674039,58681099,True,1,7060
12955,58676838,58682545,True,1,5707
12956,58679818,58706979,False,1,27161
12957,58688626,58698361,False,1,9735
12958,58707292,58707661,True,1,369
12959,58724376,58729172,True,1,4796
12960,58726162,58729982,True,1,3820
12961,58741088,58743001,True,1,1913
12962,58753382,58799898,True,1,46516
12963,58753382,58822786,True,1,69404
12964,58771432,58780695,False,1,9263
12965,58788908,58789412,False,1,504
12966,58790927,58792106,False,1,1179
12967,58820087,58821180,False,1,1093
12968,58820087,58821180,True,2,1093
12969,58821042,58834725,False,1,13683
12970,58828312,58829342,True,2,1030
12971,58832427,58835273,True,3,2846
12972,58841588,58895599,False,1,54011
12973,58843983,58848056,False,1,4073
12974,58844331,58904943,True,4,60612
12975,58852575,58854408,True,1,1833
12976,58855508,58856797,True,1,1289
12977,58858798,58859050,True,1,252
12978,58867825,58868445,False,1,620
12979,58879363,58882229,True,1,2866
12980,58894296,58894810,True,1,514
12981,58894296,58896302,True,1,2006
12982,58908204,58924233,True,2,16029
12983,58909234,58909942,False,2,708
12984,58909829,58911060,True,1,1231
12985,58912299,58912872,False,1,573
12986,58929966,58930248,True,2,282
12987,58932072,58932538,True,2,466
12988,58933076,58934821,True,1,1745
12989,58933181,58933274,True,1,93
12990,58936848,58937015,True,1,167
12991,58938280,58959309,True,2,21029
12992,58942512,58943907,True,2,1395
12993,58945556,58945659,True,1,103
12994,58949987,58950862,True,1,875
12995,58949987,58960133,True,1,10146
12996,58952946,58953085,True,1,139
12997,58962629,58967091,False,1,4462
12998,58966144,58969026,True,1,2882
12999,58980605,59024331,False,1,43726
13000,58980653,58985093,True,1,4440
13001,58986991,58987968,False,1,977
13002,58987729,58988243,False,1,514
13003,58987729,58988243,True,1,514
13004,58990387,58990903,False,1,516
13005,58994154,58995513,True,1,1359
13006,58994543,58994906,False,2,363
13007,58994543,58996009,False,1,1466
13008,59039457,59055051,True,6,15594
13009,59039505,59055234,True,2,15729
13010,59039505,59059149,False,1,19644
13011,59039505,59064026,True,1,24521
13012,59040075,59041835,True,2,1760
13013,59047022,59058997,True,1,11975
13014,59047515,59050838,True,1,3323
13015,59047515,59094704,True,1,47189
13016,59053249,59054601,True,2,1352
13017,59076342,59077313,False,1,971
13018,59077908,59078729,False,1,821
13019,59085012,59156891,True,1,71879
13020,59085012,59156953,True,1,71941
13021,59085012,59182043,True,1,97031
13022,59104368,59105551,True,1,1183
13023,59108772,59155312,False,1,46540
13024,59113153,59113867,False,3,714
13025,59126256,59144812,True,4,18556
13026,59128910,59130141,False,1,1231
13027,59141497,59142273,True,4,776
13028,59145807,59149505,False,1,3698
13029,59152887,59155076,True,1,2189
13030,59156148,59158759,True,1,2611
13031,59158442,59161166,False,1,2724
13032,59161069,59167170,True,1,6101
13033,59184603,59245082,True,1,60479
13034,59197434,59215521,True,1,18087
13035,59199787,59206767,True,1,6980
13036,59204028,59212813,True,2,8785
13037,59207419,59209225,True,1,1806
13038,59211935,59253686,False,2,41751
13039,59223979,59226137,False,2,2158
13040,59224702,59226564,False,1,1862
13041,59228587,59242485,True,1,13898
13042,59245022,59245839,True,1,817
13043,59248126,59249905,True,1,1779
13044,59249831,59251851,True,10,2020
13045,59249831,59257162,False,1,7331
13046,59249831,59257182,False,1,7351
13047,59249831,59258684,True,3,8853
13048,59258824,59258968,True,1,144
13049,59263435,59265690,True,1,2255
13050,59263435,59271782,True,1,8347
13051,59281703,59283329,True,1,1626
13052,59289468,59290816,True,1,1348
13053,59289468,59291938,True,1,2470
13054,59294058,59296602,True,1,2544
13055,59312069,59312156,True,1,87
13056,59313664,59318719,True,5,5055
13057,59328335,59332200,True,5,3865
13058,59329734,59329854,False,1,120
13059,59329734,59332357,True,1,2623
13060,59344015,59344478,True,1,463
13061,59345417,59364283,True,1,18866
13062,59345417,59376047,True,1,30630
13063,59348223,59352395,True,1,4172
13064,59348671,59349284,True,1,613
13065,59349176,59349553,True,1,377
13066,59373659,59373976,True,1,317
13067,59374750,59395288,True,1,20538
13068,59376492,59409924,False,1,33432
13069,59380971,59396423,True,1,15452
13070,59380971,59398755,False,1,17784
13071,59382420,59382549,True,5,129
13072,59383138,59383399,False,1,261
13073,59389293,59390517,False,1,1224
13074,59389293,59411052,False,1,21759
13075,59397087,59402784,False,2,5697
13076,59397087,59402784,True,1,5697
13077,59397094,59402766,False,1,5672
13078,59397231,59401976,True,1,4745
13079,59406139,59407043,True,1,904
13080,59406139,59407071,True,3,932
13081,59406172,59407071,True,1,899
13082,59407562,59408706,False,1,1144
13083,59407775,59409474,True,1,1699
13084,59418478,59418771,True,1,293
13085,59418897,59419936,True,1,1039
13086,59437670,59477470,True,1,39800
13087,59448552,59449367,True,1,815
13088,59448552,59450033,True,3,1481
13089,59450189,59450278,True,1,89
13090,59450250,59451662,False,1,1412
13091,59451471,59452580,False,1,1109
13092,59493538,59493637,True,4,99
13093,59510057,59511015,True,1,958
13094,59513305,59515894,False,1,2589
13095,59515296,59521507,True,1,6211
13096,59518274,59518581,True,1,307
13097,59519764,59519894,True,1,130
13098,59538831,59539600,True,1,769
13099,59540082,59541769,True,1,1687
13100,59556386,59660243,False,1,103857
13101,59559193,59559579,False,1,386
13102,59579187,59580139,True,1,952
13103,59589576,59590263,True,1,687
13104,59589576,59590366,True,2,790
13105,59591306,59591434,False,1,128
13106,59591306,59591434,True,3,128
13107,59591916,59592141,True,1,225
13108,59591916,59652065,False,1,60149
13109,59595301,59595745,False,1,444
13110,59604183,59605818,True,1,1635
13111,59604183,59610245,True,1,6062
13112,59604830,59610500,True,1,5670
13113,59630365,59659742,True,1,29377
13114,59632467,59632554,False,1,87
13115,59634917,59635542,True,1,625
13116,59636071,59636154,True,2,83
13117,59636071,59637746,True,1,1675
13118,59640419,59641319,False,1,900
13119,59643844,59646373,True,1,2529
13120,59647052,59647717,True,2,665
13121,59647080,59647717,True,1,637
13122,59655855,59656056,True,1,201
13123,59659175,59660169,True,1,994
13124,59663545,59673507,False,1,9962
13125,59663545,59673507,True,1,9962
13126,59663545,59673548,False,1,10003
13127,59663545,59673548,True,1,10003
13128,59669724,59672100,True,1,2376
13129,59684677,59687335,True,1,2658
13130,59691026,59692727,True,1,1701
13131,59692211,59693661,True,1,1450
13132,59692214,59693661,True,1,1447
13133,59692463,59720451,True,1,27988
13134,59710989,59711112,True,1,123
13135,59714485,59714586,True,1,101
13136,59714485,59715143,True,1,658
13137,59735888,59759785,False,1,23897
13138,59740332,59740438,True,4,106
13139,59748713,59789727,True,1,41014
13140,59750054,59750626,False,1,572
13141,59750479,59750777,False,1,298
13142,59753314,59755542,True,1,2228
13143,59765528,59765985,True,6,457
13144,59770545,59770833,True,1,288
13145,59782270,59787334,True,1,5064
13146,59790210,59790337,False,1,127
13147,59792257,60070694,False,1,278437
13148,59808664,59811248,True,5,2584
13149,59820649,59820778,True,4,129
13150,59821336,59821576,True,1,240
13151,59821853,59822430,True,1,577
13152,59822364,59822941,True,1,577
13153,59823489,59824012,False,1,523
13154,59823845,59824012,False,1,167
13155,59825387,59828317,False,2,2930
13156,59825387,59828317,True,1,2930
13157,59836085,59839953,False,1,3868
13158,59836085,59839953,True,1,3868
13159,59840536,60028428,False,1,187892
13160,59842059,59844132,True,2,2073
13161,59850378,59852215,True,1,1837
13162,59865339,59867929,True,1,2590
13163,59886185,59888320,False,1,2135
13164,59902785,59905654,True,2,2869
13165,59904543,59926634,True,1,22091
13166,59905965,59912333,True,2,6368
13167,59912931,59917078,True,1,4147
13168,59923449,59925784,True,7,2335
13169,59930119,59941089,False,1,10970
13170,59930207,59931118,False,2,911
13171,59930207,59943189,True,1,12982
13172,59934923,59936571,True,1,1648
13173,59939296,59971470,False,1,32174
13174,59946803,59947776,True,1,973
13175,59946803,59947779,True,1,976
13176,59947663,59947962,False,1,299
13177,59948662,59948791,False,1,129
13178,59948662,59950180,True,1,1518
13179,59949059,59949149,False,1,90
13180,59953800,59954994,True,1,1194
13181,59953803,59954994,True,1,1191
13182,59971156,59974244,True,4,3088
13183,59978283,59978466,True,1,183
13184,59979608,59985232,True,1,5624
13185,59984747,59984850,True,1,103
13186,59985535,59986543,True,1,1008
13187,59985535,59993070,True,1,7535
13188,59986249,59988720,True,2,2471
13189,59986249,59988780,True,2,2531
13190,59999645,60024189,True,1,24544
13191,59999645,60032282,True,7,32637
13192,59999645,60034621,True,1,34976
13193,59999645,60037733,False,1,38088
13194,59999645,60037733,True,2,38088
13195,60005809,60016894,True,1,11085
13196,60005809,60057061,True,1,51252
13197,60006966,60028072,True,1,21106
13198,60008332,60008419,True,3,87
13199,60015242,60015396,False,1,154
13200,60015242,60015396,True,1,154
13201,60018722,60025585,False,1,6863
13202,60027734,60035437,True,1,7703
13203,60034486,60034566,False,1,80
13204,60034486,60034566,True,4,80
13205,60035062,60035606,True,1,544
13206,60047871,60048267,True,1,396
13207,60056969,60066240,True,1,9271
13208,60058210,60058325,True,1,115
13209,60058481,60058727,True,1,246
13210,60066294,60069404,True,1,3110
13211,60069379,60069620,True,1,241
13212,60069379,60069700,True,1,321
13213,60070187,60070985,False,2,798
13214,60070187,60071296,True,1,1109
13215,60072535,60072792,True,1,257
13216,60077019,60077216,True,1,197
13217,60077510,60078974,True,1,1464
13218,60089072,60090465,False,1,1393
13219,60092348,60093165,True,1,817
13220,60101727,60109655,False,1,7928
13221,60104707,60108808,False,2,4101
13222,60104707,60108808,True,1,4101
13223,60106774,60114065,True,1,7291
13224,60122031,60125298,True,1,3267
13225,60124659,60128153,True,1,3494
13226,60126273,60127132,True,1,859
13227,60128948,60129193,False,1,245
13228,60128948,60129193,True,1,245
13229,60129291,60130962,True,1,1671
13230,60136394,60152675,True,3,16281
13231,60138732,60140080,True,1,1348
13232,60141070,60141856,True,1,786
13233,60141695,60141920,False,1,225
13234,60142239,60142550,True,1,311
13235,60147406,60148413,False,1,1007
13236,60151425,60154152,True,1,2727
13237,60151922,60154370,True,1,2448
13238,60154241,60155197,True,1,956
13239,60154241,60155546,True,1,1305
13240,60172270,60173823,True,1,1553
13241,60174770,60174983,True,1,213
13242,60174798,60175017,True,1,219
13243,60194401,60196731,True,2,2330
13244,60194873,60194945,True,1,72
13245,60199172,60199248,True,1,76
13246,60204777,60217525,True,4,12748
13247,60207754,60209742,True,2,1988
13248,60207850,60208392,True,1,542
13249,60209667,60218278,True,1,8611
13250,60211300,60211504,True,1,204
13251,60216490,60222526,False,1,6036
13252,60232460,60235662,True,2,3202
13253,60232865,60239992,True,1,7127
13254,60241270,60241808,True,1,538
13255,60241985,60243224,True,1,1239
13256,60251454,60253380,True,4,1926
13257,60254287,60261261,True,2,6974
13258,60262824,60265933,True,1,3109
13259,60286715,60305091,True,1,18376
13260,60306566,60309173,True,4,2607
13261,60311260,60316109,False,1,4849
13262,60312738,60321055,True,1,8317
13263,60313067,60321094,True,1,8027
13264,60326894,60329022,True,1,2128
13265,60326953,60329022,True,1,2069
13266,60333372,60335252,True,1,1880
13267,60349465,60360342,True,2,10877
13268,60358210,60358712,False,1,502
13269,60358210,60358712,True,1,502
13270,60369769,60371052,False,1,1283
13271,60369769,60371052,True,2,1283
13272,60380724,60382572,True,2,1848
13273,60383491,60383545,True,1,54
13274,60383676,60388951,True,3,5275
13275,60383676,60395822,True,1,12146
13276,60386701,60386939,True,1,238
13277,60389776,60390275,True,1,499
13278,60389776,60391258,True,2,1482
13279,60396546,60396703,True,1,157
13280,60403860,60403948,False,1,88
13281,60408650,60408932,True,2,282
13282,60410756,60411222,True,2,466
13283,60411760,60413505,True,1,1745
13284,60411865,60411958,True,1,93
13285,60414972,60418640,True,1,3668
13286,60415532,60415699,True,1,167
13287,60421196,60422592,True,2,1396
13288,60424242,60424345,True,1,103
13289,60431644,60431783,True,1,139
13290,60451455,60452509,True,1,1054
13291,60454812,60455040,True,1,228
13292,60467446,60470365,True,1,2919
13293,60469067,60469192,False,1,125
13294,60471465,60471697,False,1,232
13295,60471473,60472832,True,2,1359
13296,60479765,60480692,True,1,927
13297,60484617,60574236,True,5,89619
13298,60489573,60493144,False,1,3571
13299,60497198,60498897,True,2,1699
13300,60497486,60498184,True,1,698
13301,60505157,60506004,True,1,847
13302,60505187,60506004,True,1,817
13303,60506149,60507052,False,1,903
13304,60506149,60561716,True,2,55567
13305,60506149,60561905,True,1,55756
13306,60507027,60508534,True,1,1507
13307,60507393,60509767,True,1,2374
13308,60512444,60519080,False,1,6636
13309,60515549,60517419,False,2,1870
13310,60517914,60519080,False,1,1166
13311,60523766,60526251,True,2,2485
13312,60528582,60531346,True,2,2764
13313,60530643,60533819,True,1,3176
13314,60556311,60557282,False,1,971
13315,60557878,60558699,False,1,821
13316,60558505,60632180,True,3,73675
13317,60588919,60590919,True,1,2000
13318,60589392,60591284,True,1,1892
13319,60590480,60591671,True,1,1191
13320,60590480,60591691,True,1,1211
13321,60594634,60595643,True,1,1009
13322,60600546,60632523,True,1,31977
13323,60603297,60603940,True,1,643
13324,60605959,60606337,True,1,378
13325,60607243,60607434,True,1,191
13326,60608574,60616758,True,2,8184
13327,60608574,60638187,True,1,29613
13328,60619590,60621122,True,1,1532
13329,60625910,60625978,True,3,68
13330,60626110,60626201,True,1,91
13331,60633589,60651253,True,1,17664
13332,60645478,60648849,True,1,3371
13333,60649364,60687178,True,1,37814
13334,60654327,60657245,True,2,2918
13335,60670187,60680025,True,1,9838
13336,60670667,60672143,False,1,1476
13337,60678192,60678613,False,1,421
13338,60679988,60680297,True,1,309
13339,60689397,60697079,True,1,7682
13340,60697998,60699882,True,2,1884
13341,60698255,60700139,True,3,1884
13342,60726502,60726586,True,2,84
13343,60738315,60738403,True,2,88
13344,60739677,60740858,True,3,1181
13345,60739677,60749241,True,1,9564
13346,60739677,60751232,False,1,11555
13347,60741338,60749095,True,1,7757
13348,60751952,60752865,True,1,913
13349,60757051,60758159,True,1,1108
13350,60770370,60770464,False,1,94
13351,60772303,60773261,True,1,958
13352,60779030,60779232,False,1,202
13353,60779294,60779382,True,1,88
13354,60779363,60796731,True,1,17368
13355,60779363,60798281,True,1,18918
13356,60784046,60784331,True,1,285
13357,60792145,60798437,False,1,6292
13358,60794035,60794965,True,1,930
13359,60794035,60797129,True,3,3094
13360,60794035,60799851,True,1,5816
13361,60813331,60813531,True,1,200
13362,60813933,60815388,True,1,1455
13363,60814408,60814511,True,1,103
13364,60816542,60841812,True,1,25270
13365,60821406,60822000,True,1,594
13366,60829211,60876648,True,1,47437
13367,60829320,60833199,True,1,3879
13368,60837719,60838085,False,1,366
13369,60837719,60838085,True,1,366
13370,60837719,60838098,False,1,379
13371,60837719,60838098,True,1,379
13372,60837759,60838083,False,1,324
13373,60856144,60857056,True,2,912
13374,60857520,60861507,True,4,3987
13375,60864750,60867390,True,2,2640
13376,60866716,60895243,True,1,28527
13377,60866716,60909273,True,1,42557
13378,60870872,60875394,True,1,4522
13379,60871808,60872047,True,1,239
13380,60872584,60873826,True,1,1242
13381,60894034,60908913,False,1,14879
13382,60898347,60899241,True,3,894
13383,60899845,60907943,False,3,8098
13384,60899845,60907943,True,1,8098
13385,60905901,60910263,True,1,4362
13386,60909026,60911665,True,1,2639
13387,60911022,60912291,False,1,1269
13388,60911706,60911876,True,1,170
13389,60914554,60914683,False,1,129
13390,60914554,60914683,True,1,129
13391,60915060,60915303,True,1,243
13392,60917256,60917427,False,2,171
13393,60917256,60917427,True,1,171
13394,60917269,60917436,False,1,167
13395,60917269,60933510,False,1,16241
13396,60929468,60933130,True,1,3662
13397,60935329,60939451,True,1,4122
13398,60935329,60942626,False,1,7297
13399,60935329,60953903,False,1,18574
13400,60939220,60967532,False,1,28312
13401,60939220,60967532,True,7,28312
13402,60939220,60967536,True,1,28316
13403,60952308,60953287,True,1,979
13404,60952932,60966355,True,1,13423
13405,60954246,60966902,True,1,12656
13406,60968201,60969497,False,1,1296
13407,60968201,60969497,True,3,1296
13408,60974154,60974887,False,1,733
13409,60976555,60979714,False,1,3159
13410,60976555,60979714,True,1,3159
13411,60984064,60984199,True,1,135
13412,60988908,61015882,True,1,26974
13413,60992272,60998123,True,1,5851
13414,60992994,60995102,False,2,2108
13415,60992994,60995102,True,1,2108
13416,60992994,60995851,False,1,2857
13417,60995264,61005204,False,1,9940
13418,61006208,61008589,True,1,2381
13419,61021505,61022004,False,1,499
13420,61023244,61023625,True,4,381
13421,61035420,61071874,False,1,36454
13422,61035420,61071874,True,5,36454
13423,61035927,61039407,False,1,3480
13424,61049712,61050410,True,1,698
13425,61049712,61054094,True,1,4382
13426,61066449,61067054,True,1,605
13427,61072693,61072966,True,1,273
13428,61072693,61073382,True,1,689
13429,61072693,61078919,True,1,6226
13430,61072765,61073998,True,4,1233
13431,61073087,61073591,True,1,504
13432,61073087,61074653,False,1,1566
13433,61073087,61074653,True,2,1566
13434,61073087,61076386,True,1,3299
13435,61073087,61080419,True,1,7332
13436,61076155,61092479,True,1,16324
13437,61078506,61084353,True,3,5847
13438,61087250,61088294,True,1,1044
13439,61087254,61088301,True,1,1047
13440,61088068,61089115,True,1,1047
13441,61093194,61094141,False,1,947
13442,61112053,61119906,False,1,7853
13443,61112366,61138673,True,1,26307
13444,61131831,61132234,False,1,403
13445,61132395,61226117,False,1,93722
13446,61132512,61134136,True,1,1624
13447,61132515,61134136,True,1,1621
13448,61137611,61137887,True,2,276
13449,61139505,61142325,False,1,2820
13450,61155413,61171807,True,1,16394
13451,61162775,61163347,True,2,572
13452,61167307,61177424,False,1,10117
13453,61171205,61172753,True,2,1548
13454,61178369,61178904,False,1,535
13455,61178369,61179686,False,1,1317
13456,61181461,61184123,True,1,2662
13457,61186513,61188113,True,3,1600
13458,61186513,61204870,True,1,18357
13459,61186757,61188434,True,2,1677
13460,61189381,61189847,True,4,466
13461,61189713,61189897,True,2,184
13462,61189766,61210631,True,1,20865
13463,61196531,61200949,True,1,4418
13464,61196682,61198791,False,1,2109
13465,61201629,61203619,True,2,1990
13466,61202825,61204418,False,1,1593
13467,61203483,61210600,True,1,7117
13468,61203483,61210711,True,1,7228
13469,61203667,61210601,False,1,6934
13470,61214624,61230963,False,1,16339
13471,61217947,61219462,False,1,1515
13472,61220775,61223834,True,1,3059
13473,61229895,61232148,True,1,2253
13474,61229895,61233584,True,1,3689
13475,61230438,61232148,True,1,1710
13476,61230646,61234722,True,4,4076
13477,61234817,61235730,False,1,913
13478,61234817,61235955,False,1,1138
13479,61242042,61243376,True,3,1334
13480,61257960,61258976,True,1,1016
13481,61268939,61272590,True,1,3651
13482,61276485,61277177,True,1,692
13483,61276485,61279099,True,1,2614
13484,61280279,61282007,True,1,1728
13485,61280279,61297479,True,1,17200
13486,61280279,61299453,True,2,19174
13487,61286948,61291836,True,1,4888
13488,61289230,61291119,True,2,1889
13489,61296462,61312682,True,1,16220
13490,61296462,61334230,True,2,37768
13491,61306803,61306888,False,1,85
13492,61308456,61313061,True,3,4605
13493,61309614,61310043,False,1,429
13494,61312542,61312874,False,1,332
13495,61312542,61312874,True,3,332
13496,61312542,61313623,True,1,1081
13497,61312542,61313645,True,2,1103
13498,61312542,61314440,True,1,1898
13499,61314456,61315893,True,1,1437
13500,61316036,61316228,False,1,192
13501,61319271,61319807,True,1,536
13502,61324688,61325155,True,2,467
13503,61325692,61325818,True,1,126
13504,61331089,61331377,True,1,288
13505,61335992,61337911,True,2,1919
13506,61340385,61352552,True,2,12167
13507,61340385,61418587,True,1,78202
13508,61340392,61352538,True,1,12146
13509,61340392,61426102,True,1,85710
13510,61342493,61364759,True,1,22266
13511,61342540,61342824,True,1,284
13512,61343207,61355101,True,6,11894
13513,61343207,61366965,True,1,23758
13514,61343655,61365276,True,1,21621
13515,61345272,61346556,True,1,1284
13516,61351614,61351811,True,1,197
13517,61354501,61355638,True,1,1137
13518,61354501,61355959,True,4,1458
13519,61355202,61371099,False,1,15897
13520,61360781,61361073,True,2,292
13521,61362783,61362925,False,4,142
13522,61362783,61362925,True,2,142
13523,61365199,61365404,True,1,205
13524,61365936,61366020,True,1,84
13525,61375400,61375525,False,1,125
13526,61376496,61378468,True,1,1972
13527,61376818,61377616,True,2,798
13528,61379097,61379734,True,1,637
13529,61379898,61383376,True,1,3478
13530,61384774,61385870,False,1,1096
13531,61384774,61385870,True,1,1096
13532,61384774,61386211,True,5,1437
13533,61391432,61393307,True,2,1875
13534,61392702,61392796,False,1,94
13535,61394866,61418122,True,3,23256
13536,61395380,61418352,True,1,22972
13537,61398137,61398391,True,1,254
13538,61413074,61422424,True,1,9350
13539,61418276,61418479,True,1,203
13540,61419995,61421140,True,1,1145
13541,61421024,61421688,True,1,664
13542,61422948,61423059,True,1,111
13543,61431020,61433886,False,1,2866
13544,61437192,61437394,True,1,202
13545,61443186,61461088,False,1,17902
13546,61443783,61447838,False,1,4055
13547,61443783,61450640,True,1,6857
13548,61446256,61449052,True,1,2796
13549,61446256,61450792,True,1,4536
13550,61448254,61454409,True,1,6155
13551,61448254,61643809,True,2,195555
13552,61452235,61454432,True,1,2197
13553,61455953,61464459,True,1,8506
13554,61458660,61459430,True,2,770
13555,61475446,61522497,False,1,47051
13556,61500397,61501429,True,1,1032
13557,61505747,61510574,True,2,4827
13558,61519430,61519741,True,2,311
13559,61520359,61522548,True,1,2189
13560,61536808,61538297,False,1,1489
13561,61537598,61587360,True,1,49762
13562,61537718,61539074,True,3,1356
13563,61543112,61545441,True,3,2329
13564,61543131,61543282,True,1,151
13565,61546613,61546726,True,4,113
13566,61547359,61547434,True,2,75
13567,61550413,61550500,True,2,87
13568,61559422,61559509,True,1,87
13569,61559641,61561217,True,2,1576
13570,61563191,61578932,True,1,15741
13571,61565791,61570026,True,1,4235
13572,61565805,61566741,True,2,936
13573,61566867,61568937,True,1,2070
13574,61583670,61585095,True,1,1425
13575,61583670,61585098,True,2,1428
13576,61585344,61585498,True,1,154
13577,61586088,61588559,True,3,2471
13578,61586088,61595258,True,2,9170
13579,61591563,61593567,True,2,2004
13580,61591563,61598765,True,1,7202
13581,61591563,61611759,True,1,20196
13582,61610374,61610516,False,1,142
13583,61610446,61610588,False,1,142
13584,61610446,61610588,True,3,142
13585,61610889,61611997,True,1,1108
13586,61622204,61629078,True,1,6874
13587,61628284,61628596,True,1,312
13588,61629917,61630076,True,1,159
13589,61641560,61751730,True,1,110170
13590,61643544,61644313,True,2,769
13591,61684927,61717690,True,1,32763
13592,61692738,61746448,True,1,53710
13593,61695250,61697724,True,3,2474
13594,61701453,61707156,True,1,5703
13595,61703782,61704173,True,1,391
13596,61704077,61704757,False,1,680
13597,61704801,61705714,True,1,913
13598,61704801,61708777,True,2,3976
13599,61705764,61709219,True,1,3455
13600,61707111,61709986,True,1,2875
13601,61707533,61742753,True,1,35220
13602,61708372,61708466,False,1,94
13603,61711344,61712510,True,4,1166
13604,61712756,61712848,True,1,92
13605,61713055,61713147,True,4,92
13606,61718412,61718933,True,1,521
13607,61725889,61726983,True,5,1094
13608,61725933,61726983,True,2,1050
13609,61726790,61797793,True,2,71003
13610,61729531,61729927,False,1,396
13611,61730161,61736431,False,1,6270
13612,61730390,61736660,False,1,6270
13613,61731021,61762967,True,2,31946
13614,61735970,61736278,True,1,308
13615,61752156,61752785,True,2,629
13616,61752156,61753186,True,1,1030
13617,61763571,61764483,True,1,912
13618,61764102,61764561,True,1,459
13619,61764102,61764566,True,1,464
13620,61764102,61764912,True,1,810
13621,61764353,61764687,True,1,334
13622,61764401,61764518,True,1,117
13623,61765400,61765517,False,2,117
13624,61765400,61765517,True,1,117
13625,61770762,61772455,True,1,1693
13626,61771130,61772455,True,2,1325
13627,61771176,61772457,True,1,1281
13628,61772028,61785238,False,1,13210
13629,61772028,61785238,True,1,13210
13630,61774165,61774404,True,1,239
13631,61774671,61787265,True,1,12594
13632,61775159,61775398,True,1,239
13633,61781888,61782008,True,1,120
13634,61782266,61806663,True,1,24397
13635,61786084,61791880,True,1,5796
13636,61796218,61796403,True,1,185
13637,61796306,61809222,True,1,12916
13638,61798426,61799294,True,1,868
13639,61798477,61798608,True,1,131
13640,61800348,61802793,True,1,2445
13641,61801660,61802456,True,1,796
13642,61815916,61818661,True,1,2745
13643,61815916,61818664,True,1,2748
13644,61817634,61825098,True,1,7464
13645,61818959,61836624,True,3,17665
13646,61830011,61851702,False,1,21691
13647,61833511,61833620,False,2,109
13648,61838030,61841782,False,1,3752
13649,61838030,61841782,True,1,3752
13650,61842012,61842251,True,1,239
13651,61842804,61853323,True,1,10519
13652,61851890,61853236,True,1,1346
13653,61868864,61871479,True,1,2615
13654,61871984,61872945,True,2,961
13655,61876814,61878185,False,1,1371
13656,61877194,61881062,True,1,3868
13657,61882509,61886504,True,1,3995
13658,61890595,61891563,True,1,968
13659,61891739,61899231,False,1,7492
13660,61891739,61899231,True,1,7492
13661,61892781,61900331,False,1,7550
13662,61892781,61900331,True,3,7550
13663,61897764,61899691,False,1,1927
13664,61901966,61959340,False,2,57374
13665,61902703,61903870,True,4,1167
13666,61903280,61905496,True,1,2216
13667,61903322,61913093,True,1,9771
13668,61903487,61905561,False,1,2074
13669,61906816,61918444,True,1,11628
13670,61907247,61907803,True,1,556
13671,61907607,61913428,True,1,5821
13672,61909451,61909768,True,1,317
13673,61913743,61972746,True,1,59003
13674,61921242,61924908,True,1,3666
13675,61921844,61922208,True,1,364
13676,61922357,61922797,True,1,440
13677,61922557,61922783,True,1,226
13678,61929069,61929429,True,1,360
13679,61930635,61938738,True,1,8103
13680,61937457,61938247,False,1,790
13681,61937899,61938650,True,1,751
13682,61938331,61939121,True,1,790
13683,61942371,61986258,True,1,43887
13684,61945727,61947433,True,4,1706
13685,61947638,61952173,True,1,4535
13686,61947638,61952208,True,1,4570
13687,61948085,61949885,True,1,1800
13688,61962428,61966051,True,1,3623
13689,61993136,61993297,True,1,161
13690,61993136,61993490,True,2,354
13691,61993925,61994148,True,1,223
13692,62004798,62005025,True,1,227
13693,62006451,62009925,True,2,3474
13694,62007375,62012082,True,1,4707
13695,62008963,62009068,True,1,105
13696,62018452,62018627,True,1,175
13697,62018726,62019879,True,1,1153
13698,62042534,62043101,False,2,567
13699,62056806,62078608,True,1,21802
13700,62056806,62084250,True,2,27444
13701,62064848,62074375,True,1,9527
13702,62064848,62093270,True,1,28422
13703,62066480,62070898,True,2,4418
13704,62068548,62068652,True,1,104
13705,62068548,62069551,True,3,1003
13706,62071954,62072447,True,1,493
13707,62089042,62089124,True,1,82
13708,62089967,62090143,True,2,176
13709,62096321,62107426,True,1,11105
13710,62105502,62114984,True,1,9482
13711,62105520,62114985,False,1,9465
13712,62106379,62106492,False,1,113
13713,62117159,62117268,True,1,109
13714,62118105,62121485,True,1,3380
13715,62145764,62147295,True,4,1531
13716,62159067,62159263,True,1,196
13717,62159091,62186274,True,1,27183
13718,62159776,62186750,True,1,26974
13719,62159776,62196596,True,1,36820
13720,62162092,62165060,True,1,2968
13721,62165275,62176058,True,1,10783
13722,62165275,62190023,True,1,24748
13723,62168170,62170974,True,1,2804
13724,62171694,62173307,True,1,1613
13725,62173973,62174135,True,1,162
13726,62179827,62179961,True,1,134
13727,62180398,62227213,True,1,46815
13728,62182332,62227938,True,4,45606
13729,62183064,62188872,True,5,5808
13730,62183064,62191140,True,1,8076
13731,62183192,62194675,True,1,11483
13732,62184368,62194883,True,4,10515
13733,62187068,62190796,False,1,3728
13734,62187364,62187452,False,1,88
13735,62189874,62190182,True,2,308
13736,62204837,62206276,True,1,1439
13737,62204837,62206805,True,1,1968
13738,62204837,62208050,True,1,3213
13739,62205740,62207254,True,1,1514
13740,62211393,62212057,True,1,664
13741,62220542,62224986,True,1,4444
13742,62220708,62220953,True,4,245
13743,62225146,62225237,True,1,91
13744,62239414,62239980,True,3,566
13745,62241112,62241644,False,1,532
13746,62242616,62252300,False,1,9684
13747,62252801,62252974,True,1,173
13748,62252801,62253220,True,1,419
13749,62253173,62253795,True,1,622
13750,62258197,62260489,True,2,2292
13751,62264757,62265016,True,3,259
13752,62267255,62268417,True,4,1162
13753,62268066,62271022,True,8,2956
13754,62272996,62308678,True,1,35682
13755,62275831,62276608,True,1,777
13756,62277183,62277878,True,1,695
13757,62277391,62282101,True,11,4710
13758,62277391,62289561,True,6,12170
13759,62283321,62283524,False,1,203
13760,62286409,62286501,True,2,92
13761,62291854,62292095,True,1,241
13762,62294113,62294588,True,1,475
13763,62300983,62301859,True,3,876
13764,62300983,62302244,True,1,1261
13765,62309993,62333415,True,1,23422
13766,62317189,62346096,True,2,28907
13767,62320618,62426653,True,1,106035
13768,62331195,62335683,True,1,4488
13769,62348659,62387288,False,1,38629
13770,62350638,62364593,True,1,13955
13771,62370601,62371215,True,1,614
13772,62382978,62385147,True,5,2169
13773,62384022,62387037,True,1,3015
13774,62384022,62387728,True,2,3706
13775,62384030,62385751,False,1,1721
13776,62387754,62443080,False,1,55326
13777,62387754,62461212,True,2,73458
13778,62392144,62392767,True,1,623
13779,62392289,62392788,True,2,499
13780,62392302,62392788,True,2,486
13781,62393233,62394796,True,1,1563
13782,62399323,62400629,True,1,1306
13783,62412078,62413332,True,1,1254
13784,62416866,62420194,True,1,3328
13785,62425968,62426272,True,1,304
13786,62425968,62426542,True,1,574
13787,62426512,62426984,True,1,472
13788,62437198,62484916,True,1,47718
13789,62441498,62447792,False,1,6294
13790,62441498,62447792,True,1,6294
13791,62450959,62451392,True,1,433
13792,62453681,62458100,True,1,4419
13793,62453681,62458173,True,1,4492
13794,62453803,62458100,False,1,4297
13795,62453803,62458100,True,5,4297
13796,62454760,62455344,True,1,584
13797,62465418,62466234,True,4,816
13798,62466425,62470481,True,1,4056
13799,62473475,62473638,True,3,163
13800,62475604,62475727,True,1,123
13801,62475604,62560834,True,1,85230
13802,62477394,62477743,True,1,349
13803,62477974,62563312,True,1,85338
13804,62481735,62482794,True,1,1059
13805,62484062,62484795,False,1,733
13806,62506359,62519598,False,1,13239
13807,62510182,62513270,True,1,3088
13808,62510182,62513418,True,1,3236
13809,62510821,62511869,True,1,1048
13810,62529328,62529629,False,1,301
13811,62529328,62530498,False,1,1170
13812,62535545,62536973,True,1,1428
13813,62542700,62544298,True,2,1598
13814,62555456,62561078,True,1,5622
13815,62567017,62567620,True,1,603
13816,62568790,62571222,True,1,2432
13817,62573889,62574859,True,1,970
13818,62575592,62597300,True,1,21708
13819,62581752,62582315,True,2,563
13820,62582377,62582744,True,1,367
13821,62588536,62611603,False,1,23067
13822,62588536,62611603,True,4,23067
13823,62617809,62641394,True,1,23585
13824,62619456,62627839,True,1,8383
13825,62636796,62637525,False,1,729
13826,62636796,62639008,False,1,2212
13827,62637871,62641306,True,1,3435
13828,62639891,62642293,False,1,2402
13829,62643721,62643902,True,2,181
13830,62644558,62644663,False,1,105
13831,62645457,62646603,True,1,1146
13832,62646462,62646606,False,1,144
13833,62647517,62647761,True,1,244
13834,62665253,62665344,True,1,91
13835,62681189,62683092,True,2,1903
13836,62687537,62687860,True,1,323
13837,62687918,62688000,True,2,82
13838,62688536,62689454,True,2,918
13839,62691142,62699098,False,1,7956
13840,62699359,62699448,True,1,89
13841,62700695,62718312,False,4,17617
13842,62700695,62718312,True,5,17617
13843,62724021,62730698,True,1,6677
13844,62727790,62727870,False,1,80
13845,62727790,62727870,True,2,80
13846,62733120,62733720,True,3,600
13847,62733398,62733665,False,1,267
13848,62733398,62734472,False,2,1074
13849,62733398,62734541,False,1,1143
13850,62735608,62735779,True,1,171
13851,62736100,62745878,True,2,9778
13852,62737032,62746790,True,1,9758
13853,62737835,62739402,False,1,1567
13854,62742849,62749688,True,1,6839
13855,62746364,62746528,True,1,164
13856,62755071,62761604,False,1,6533
13857,62755977,62757279,True,1,1302
13858,62758920,62759836,True,1,916
13859,62777371,62777722,False,1,351
13860,62777371,62777722,True,1,351
13861,62782835,62783637,True,3,802
13862,62793494,62795372,True,2,1878
13863,62796290,62797861,False,1,1571
13864,62802270,62806383,True,2,4113
13865,62809344,62810187,True,3,843
13866,62810541,62813840,True,7,3299
13867,62815532,62821427,True,1,5895
13868,62821846,62832229,True,1,10383
13869,62862012,62862102,False,1,90
13870,62864062,62894269,True,7,30207
13871,62869324,62874085,False,1,4761
13872,62869324,62874085,True,5,4761
13873,62878229,62878385,True,1,156
13874,62895389,62900839,True,1,5450
13875,62908063,62908953,True,2,890
13876,62914443,62915044,False,1,601
13877,62914593,62924017,True,2,9424
13878,62925429,62936049,True,2,10620
13879,62925438,62936077,True,1,10639
13880,62931894,62939246,True,2,7352
13881,62939415,62939766,True,1,351
13882,62940928,62941054,True,1,126
13883,62941636,62943557,True,2,1921
13884,62942108,62944029,True,2,1921
13885,62948383,62951549,False,1,3166
13886,62948383,62951549,True,1,3166
13887,62954723,62956444,True,3,1721
13888,62957833,62958008,True,1,175
13889,62961241,62971849,True,1,10608
13890,62962258,62964930,True,1,2672
13891,62966585,62966983,True,1,398
13892,62966997,62968235,True,1,1238
13893,62967072,62968288,True,1,1216
13894,62969096,62969285,True,1,189
13895,62974414,62978233,True,1,3819
13896,62979007,62979121,False,1,114
13897,62979205,62980630,True,1,1425
13898,62979631,62981056,True,1,1425
13899,62986713,62988704,True,1,1991
13900,62988815,63029641,True,1,40826
13901,62989021,62990430,False,1,1409
13902,62989021,62990430,True,1,1409
13903,62989668,63030005,True,4,40337
13904,62992371,63031178,True,1,38807
13905,62993700,62994260,True,1,560
13906,62993857,63950254,True,1,956397
13907,62995512,63950611,True,1,955099
13908,62995845,62996118,False,1,273
13909,62996222,62996549,True,5,327
13910,63001876,63001954,True,1,78
13911,63003048,63004123,True,2,1075
13912,63005036,63006049,True,4,1013
13913,63008054,63011873,True,1,3819
13914,63008736,63010814,False,1,2078
13915,63009819,63010189,False,1,370
13916,63009904,63009981,True,1,77
13917,63013746,63020662,True,1,6916
13918,63025543,63026189,True,1,646
13919,63025585,63026111,True,2,526
13920,63029377,63030565,False,1,1188
13921,63029377,63030565,True,2,1188
13922,63030509,63030642,True,1,133
13923,63030880,63031290,True,2,410
13924,63033143,63038095,False,1,4952
13925,63038013,63039034,True,2,1021
13926,63038013,63039737,True,3,1724
13927,63038013,63041186,True,1,3173
13928,63038013,63041268,True,1,3255
13929,63046170,63061229,True,1,15059
13930,63062714,63063459,True,1,745
13931,63062850,63072897,True,3,10047
13932,63064952,63066749,False,1,1797
13933,63064952,63066749,True,2,1797
13934,63075876,63077412,True,2,1536
13935,63078485,63078657,True,1,172
13936,63079954,63080384,True,1,430
13937,63080293,63080579,True,1,286
13938,63081514,63081760,True,2,246
13939,63081514,63082004,False,1,490
13940,63081514,63082252,False,1,738
13941,63087047,63087652,True,1,605
13942,63088647,63088833,True,1,186
13943,63091571,63094347,True,1,2776
13944,63097275,63097669,True,2,394
13945,63107418,63142722,True,1,35304
13946,63108047,63108930,False,2,883
13947,63108047,63108930,True,2,883
13948,63109059,63109450,True,1,391
13949,63109340,63109599,False,1,259
13950,63110071,63110392,False,1,321
13951,63110071,63110392,True,2,321
13952,63110071,63110695,False,1,624
13953,63110071,63110695,True,1,624
13954,63110071,63111248,False,1,1177
13955,63110927,63111141,True,1,214
13956,63112426,63139168,False,1,26742
13957,63112426,63139168,True,3,26742
13958,63113612,63113960,True,1,348
13959,63113667,63113960,True,1,293
13960,63114215,63114351,True,1,136
13961,63114928,63149595,True,2,34667
13962,63116061,63117692,True,1,1631
13963,63138725,63161902,True,1,23177
13964,63139596,63139707,True,3,111
13965,63143335,63144483,True,1,1148
13966,63149294,63192376,True,3,43082
13967,63163122,63163522,False,1,400
13968,63164704,63164790,True,1,86
13969,63166063,63166289,True,2,226
13970,63166163,63166328,True,1,165
13971,63167710,63167907,True,1,197
13972,63171492,63181017,True,1,9525
13973,63177084,63178914,True,1,1830
13974,63177084,63178951,False,1,1867
13975,63177084,63178951,True,1,1867
13976,63188154,63188487,True,1,333
13977,63190949,63191728,True,1,779
13978,63210045,63217761,True,1,7716
13979,63212925,63213279,False,1,354
13980,63213807,63214079,True,4,272
13981,63213807,63214778,True,2,971
13982,63214932,63215263,True,1,331
13983,63215773,63357675,True,1,141902
13984,63216321,63252174,False,1,35853
13985,63216321,63252174,True,1,35853
13986,63216321,63270045,True,1,53724
13987,63216321,63284151,False,1,67830
13988,63216321,63358064,True,4,141743
13989,63216321,63392806,True,1,176485
13990,63216321,63407699,True,1,191378
13991,63216659,63229953,True,2,13294
13992,63219102,63285526,False,1,66424
13993,63220524,63272008,False,1,51484
13994,63220524,63286114,False,1,65590
13995,63220524,63360027,True,2,139503
13996,63239003,63240241,True,1,1238
13997,63239006,63240241,True,1,1235
13998,63239074,63283293,True,1,44219
13999,63240514,63244433,False,1,3919
14000,63240514,63244433,True,1,3919
14001,63247527,63247917,True,1,390
14002,63259492,63260633,True,5,1141
14003,63267641,63268252,True,4,611
14004,63269277,63270240,True,5,963
14005,63269277,63273528,True,1,4251
14006,63277512,63277658,True,1,146
14007,63279060,63438510,True,1,159450
14008,63286582,63287575,True,1,993
14009,63289102,63298622,True,2,9520
14010,63289102,63298630,True,1,9528
14011,63289357,63291336,False,2,1979
14012,63289357,63291336,True,1,1979
14013,63307150,63307296,True,2,146
14014,63309797,63309998,True,5,201
14015,63321454,63321662,True,1,208
14016,63338755,63340059,True,1,1304
14017,63345122,63347281,False,1,2159
14018,63349418,63349916,True,2,498
14019,63356852,63362877,False,1,6025
14020,63356852,63362877,True,2,6025
14021,63356852,63363061,True,1,6209
14022,63359644,63360191,False,1,547
14023,63360430,63360551,True,1,121
14024,63360455,63360556,False,1,101
14025,63360683,63361653,True,1,970
14026,63366319,63366409,True,1,90
14027,63366533,63368488,True,1,1955
14028,63370402,63370506,True,1,104
14029,63370503,63370822,False,1,319
14030,63373511,63374292,False,1,781
14031,63373511,63374292,True,1,781
14032,63382341,63382534,True,7,193
14033,63389946,63390134,True,2,188
14034,63397137,63398349,True,1,1212
14035,63405126,63409534,True,1,4408
14036,63405924,63407885,True,2,1961
14037,63415563,63415953,True,3,390
14038,63415721,63415953,True,1,232
14039,63422423,63423304,True,5,881
14040,63423992,63424915,False,1,923
14041,63423992,63425787,False,1,1795
14042,63423992,63426408,False,1,2416
14043,63424680,63427484,True,1,2804
14044,63445084,63446560,True,2,1476
14045,63445084,63453465,True,1,8381
14046,63448409,63449172,False,1,763
14047,63449184,63449437,True,1,253
14048,63449305,63458494,True,2,9189
14049,63449334,63458510,True,1,9176
14050,63449334,63489650,True,1,40316
14051,63453550,63458648,True,2,5098
14052,63453554,63455234,True,1,1680
14053,63454490,63454762,True,1,272
14054,63457007,63457764,True,1,757
14055,63465382,63466214,True,1,832
14056,63465382,63466788,True,2,1406
14057,63466917,63467028,True,1,111
14058,63468182,63468259,True,1,77
14059,63473774,63474244,False,1,470
14060,63474333,63475545,True,1,1212
14061,63485909,63497468,False,1,11559
14062,63490735,63492038,True,2,1303
14063,63491435,63498132,False,1,6697
14064,63495612,63539822,True,1,44210
14065,63499005,63499089,False,1,84
14066,63500987,63504030,True,1,3043
14067,63511974,63512894,True,1,920
14068,63523811,63524088,True,2,277
14069,63530827,63530933,True,1,106
14070,63536508,63605934,True,1,69426
14071,63539763,63552730,True,2,12967
14072,63539763,63561795,True,2,22032
14073,63539990,63552819,True,1,12829
14074,63539990,63561884,True,1,21894
14075,63548402,63563297,True,1,14895
14076,63552255,63554723,True,2,2468
14077,63557157,63560059,True,1,2902
14078,63557157,63560751,True,1,3594
14079,63562857,63567412,False,2,4555
14080,63566893,63566964,False,1,71
14081,63566927,63567421,True,1,494
14082,63567131,63567841,True,1,710
14083,63572120,63573162,False,1,1042
14084,63585780,63588137,True,1,2357
14085,63585798,63607907,True,3,22109
14086,63591249,63592142,True,1,893
14087,63598826,63782254,True,1,183428
14088,63600282,63614866,True,1,14584
14089,63605669,63605878,True,2,209
14090,63605669,63607703,True,1,2034
14091,63607179,63610197,True,1,3018
14092,63610603,63616749,True,2,6146
14093,63617906,63618595,True,10,689
14094,63624416,63626893,True,1,2477
14095,63625331,63627381,True,1,2050
14096,63629857,63629954,True,1,97
14097,63647657,63649302,True,3,1645
14098,63649381,63666009,False,1,16628
14099,63649381,63666009,True,3,16628
14100,63653057,63668424,False,1,15367
14101,63654550,63654645,True,1,95
14102,63659119,63677889,True,2,18770
14103,63662494,63663396,True,3,902
14104,63669151,63669615,False,1,464
14105,63671451,63672032,True,6,581
14106,63676300,63744951,False,1,68651
14107,63676300,63956801,True,1,280501
14108,63676885,63678337,True,1,1452
14109,63695577,63695984,True,5,407
14110,63698784,63699371,False,1,587
14111,63701775,63712604,True,1,10829
14112,63710316,63838301,True,1,127985
14113,63714022,63717272,False,1,3250
14114,63727470,63727558,True,1,88
14115,63728448,63731988,True,1,3540
14116,63731280,63766946,True,2,35666
14117,63736495,63737005,True,1,510
14118,63737691,63770160,True,1,32469
14119,63739191,63741527,True,1,2336
14120,63742000,63744777,True,2,2777
14121,63765110,63765641,True,1,531
14122,63766302,63779558,True,1,13256
14123,63767614,63770627,False,1,3013
14124,63770368,63771549,True,1,1181
14125,63770368,63780895,True,2,10527
14126,63772113,63782500,True,2,10387
14127,63773168,63773393,True,1,225
14128,63773570,63783197,True,1,9627
14129,63774283,63775377,True,1,1094
14130,63780146,63781011,False,1,865
14131,63780906,63782873,False,1,1967
14132,63781090,63781256,False,1,166
14133,63784747,63796363,False,1,11616
14134,63784747,63796363,True,5,11616
14135,63784747,63796367,True,1,11620
14136,63786794,64198948,False,1,412154
14137,63790840,63790995,True,4,155
14138,63790840,63796650,True,1,5810
14139,63809978,63811748,True,1,1770
14140,63827782,63827868,True,3,86
14141,63832902,63837721,True,1,4819
14142,63840038,63841367,True,2,1329
14143,63845126,63845306,True,1,180
14144,63853571,63853652,True,3,81
14145,63875388,63875471,True,2,83
14146,63877676,63877922,True,1,246
14147,63878002,63878595,True,1,593
14148,63878635,63878837,True,1,202
14149,63879600,63879684,True,1,84
14150,63879638,63879722,True,2,84
14151,63879933,63880041,True,1,108
14152,63880366,63886756,False,1,6390
14153,63893573,63894799,True,6,1226
14154,63894943,63901309,True,2,6366
14155,63899782,63899913,True,2,131
14156,63900540,63936650,True,1,36110
14157,63901190,63901398,True,1,208
14158,63905326,63909250,True,1,3924
14159,63937706,63937870,False,1,164
14160,63938243,63940258,False,1,2015
14161,63943845,63944733,False,1,888
14162,63943845,63944871,True,1,1026
14163,63946975,63948526,True,1,1551
14164,63947025,63947121,True,1,96
14165,63947647,63947753,True,1,106
14166,63952688,63953007,True,1,319
14167,63962482,63962683,False,2,201
14168,63965258,63965389,True,2,131
14169,63966666,63966874,True,1,208
14170,63968472,63970580,False,1,2108
14171,63992167,63992267,True,2,100
14172,64003180,64003344,False,1,164
14173,64012493,64012589,True,1,96
14174,64012493,64012961,True,1,468
14175,64018158,64018477,True,3,319
14176,64020998,64021184,True,1,186
14177,64021636,64023100,True,1,1464
14178,64030298,64031013,True,3,715
14179,64046659,64053415,True,1,6756
14180,64061343,64061862,False,1,519
14181,64061343,64061862,True,1,519
14182,64084281,64084818,True,3,537
14183,64085793,64087537,True,1,1744
14184,64087534,64088548,True,1,1014
14185,64094352,64115614,True,1,21262
14186,64100003,64127567,False,1,27564
14187,64131555,64149827,True,1,18272
14188,64131555,64150051,True,1,18496
14189,64145736,64156872,True,1,11136
14190,64146731,64332683,True,4,185952
14191,64156034,64272687,True,1,116653
14192,64156034,64285248,True,1,129214
14193,64158316,64158816,False,1,500
14194,64158316,64161211,False,1,2895
14195,64159122,64161473,True,1,2351
14196,64161403,64163754,True,1,2351
14197,64166434,64166745,True,1,311
14198,64166782,64166920,True,1,138
14199,64166782,64167655,True,1,873
14200,64166789,64167299,True,2,510
14201,64169632,64169771,True,1,139
14202,64169643,64169782,True,1,139
14203,64169697,64169911,True,1,214
14204,64176924,64177009,True,2,85
14205,64186454,64187808,False,2,1354
14206,64186454,64187808,True,3,1354
14207,64191085,64191704,False,1,619
14208,64191085,64191900,True,7,815
14209,64191905,64193556,True,3,1651
14210,64194114,64194353,True,1,239
14211,64200348,64200488,False,1,140
14212,64200430,64200707,True,1,277
14213,64206475,64209900,True,1,3425
14214,64215013,64215520,False,1,507
14215,64224777,64226061,True,1,1284
14216,64225472,64231164,True,1,5692
14217,64233314,64233451,True,3,137
14218,64236301,64237045,True,2,744
14219,64236962,64237973,True,1,1011
14220,64241527,64242090,False,2,563
14221,64242014,64242119,False,2,105
14222,64242346,64264134,False,1,21788
14223,64242641,64243590,True,1,949
14224,64243946,64244137,True,1,191
14225,64243956,64244137,False,1,181
14226,64243956,64244137,True,2,181
14227,64244815,64245066,True,1,251
14228,64251565,64260499,True,1,8934
14229,64264789,64266268,True,1,1479
14230,64264839,64266294,True,1,1455
14231,64273207,64273723,True,4,516
14232,64273998,64274514,True,2,516
14233,64290118,64290473,True,1,355
14234,64292589,64293477,True,2,888
14235,64296252,64317568,True,1,21316
14236,64297662,64298043,True,1,381
14237,64297760,64297870,False,3,110
14238,64297760,64297870,True,7,110
14239,64297760,64298043,True,10,283
14240,64299918,64300782,True,1,864
14241,64299988,64300166,True,1,178
14242,64300158,64300854,False,1,696
14243,64300158,64300854,True,4,696
14244,64300650,64311948,False,1,11298
14245,64300650,64311948,True,1,11298
14246,64300650,64344930,True,2,44280
14247,64301144,64301233,True,1,89
14248,64301812,64305377,True,1,3565
14249,64301857,64301978,True,1,121
14250,64302772,64302901,True,1,129
14251,64306760,64306888,True,1,128
14252,64309921,64310171,True,1,250
14253,64317822,64318026,True,2,204
14254,64323846,64356539,False,1,32693
14255,64326273,64326376,True,1,103
14256,64326546,64326718,False,2,172
14257,64326546,64326718,True,2,172
14258,64326546,64327319,True,1,773
14259,64327922,64328424,True,1,502
14260,64346783,64432711,True,4,85928
14261,64367783,64440758,True,1,72975
14262,64368491,64368575,True,1,84
14263,64374919,64378115,False,1,3196
14264,64376401,64382890,False,1,6489
14265,64385923,64386341,True,5,418
14266,64385923,64386498,True,1,575
14267,64386400,64386499,True,1,99
14268,64403325,64403325,True,1,0
14269,64407727,64407986,True,1,259
14270,64410144,64410433,True,1,289
14271,64430218,64432493,True,1,2275
14272,64430218,64444906,False,1,14688
14273,64437454,64448577,True,1,11123
14274,64447205,64453874,True,1,6669
14275,64454060,64454694,True,1,634
14276,64457563,64460987,True,1,3424
14277,64457563,64462176,True,1,4613
14278,64457563,64466215,True,1,8652
14279,64459800,64462817,True,1,3017
14280,64459800,64462912,True,1,3112
14281,64482226,64483821,True,1,1595
14282,64490555,64490638,True,4,83
14283,64497879,64502330,True,1,4451
14284,64498296,64503632,True,2,5336
14285,64500368,64501427,True,1,1059
14286,64512748,64517364,True,1,4616
14287,64512883,64513844,True,2,961
14288,64512916,64513838,True,1,922
14289,64518845,64519070,True,1,225
14290,64520662,64629363,False,1,108701
14291,64520662,64629363,True,2,108701
14292,64522286,64567849,True,1,45563
14293,64522412,64523902,True,1,1490
14294,64522569,64528454,True,4,5885
14295,64528076,64528200,True,1,124
14296,64529685,64529789,False,1,104
14297,64529685,64530859,True,1,1174
14298,64549091,64549294,False,1,203
14299,64560781,64679033,True,1,118252
14300,64560781,64689532,True,1,128751
14301,64577994,64601238,True,2,23244
14302,64580604,64626133,True,2,45529
14303,64586324,64588908,True,2,2584
14304,64586324,64593027,True,1,6703
14305,64596558,64597001,False,1,443
14306,64598381,64602372,True,1,3991
14307,64603838,64616256,False,1,12418
14308,64627521,64646071,True,2,18550
14309,64639665,64648513,False,1,8848
14310,64639665,64648513,True,3,8848
14311,64645537,64645784,False,2,247
14312,64645537,64645784,True,4,247
14313,64645624,64645784,True,1,160
14314,64646340,64716604,False,2,70264
14315,64659941,64663406,True,1,3465
14316,64659941,64663479,False,1,3538
14317,64671946,64681862,True,2,9916
14318,64681284,64692602,True,1,11318
14319,64682172,64693075,True,1,10903
14320,64686869,64695521,True,1,8652
14321,64710500,64718507,False,1,8007
14322,64710500,64718507,True,2,8007
14323,64716816,64717674,False,1,858
14324,64725314,64726326,False,1,1012
14325,64725314,64726326,True,2,1012
14326,64725314,64726330,False,1,1016
14327,64746582,64747658,True,2,1076
14328,64746582,64749316,True,1,2734
14329,64751673,64752215,True,1,542
14330,64765525,64765833,False,1,308
14331,64769333,64770967,True,1,1634
14332,64769333,64790081,False,1,20748
14333,64769333,64790081,True,2,20748
14334,64781881,64787263,True,5,5382
14335,64781881,64790039,True,1,8158
14336,64781881,64800249,True,1,18368
14337,64796219,64798678,True,1,2459
14338,64796421,64798880,True,2,2459
14339,64796857,64798999,True,5,2142
14340,64798573,64835380,True,1,36807
14341,64808127,64808463,True,1,336
14342,64809004,64850546,True,1,41542
14343,64809004,64854247,True,1,45243
14344,64812071,64859071,True,11,47000
14345,64813957,64821903,True,1,7946
14346,64815427,64817841,True,2,2414
14347,64820046,64822837,False,1,2791
14348,64820046,64822837,True,2,2791
14349,64820046,64822846,True,3,2800
14350,64841995,64936362,True,1,94367
14351,64841995,64941063,False,1,99068
14352,64866719,64916492,True,2,49773
14353,64878421,64884946,True,1,6525
14354,64899351,64909985,True,4,10634
14355,64899600,64903411,False,1,3811
14356,64906868,64916423,True,4,9555
14357,64910487,64918076,True,1,7589
14358,64912715,64914666,False,1,1951
14359,64912715,64914666,True,2,1951
14360,64914676,64916673,False,1,1997
14361,64915967,64916973,False,1,1006
14362,64926280,64935109,True,1,8829
14363,64932726,64934045,True,1,1319
14364,64932814,64934137,True,1,1323
14365,64959272,64975191,False,1,15919
14366,64959272,64975191,True,2,15919
14367,64970682,64970982,True,2,300
14368,64975050,64977880,True,1,2830
14369,64979508,65041712,True,1,62204
14370,64983890,64987513,True,1,3623
14371,64983890,64987573,True,2,3683
14372,64992972,64997971,False,1,4999
14373,65006260,65018507,True,1,12247
14374,65010153,65089715,True,1,79562
14375,65033680,65045225,False,1,11545
14376,65036067,65037842,False,1,1775
14377,65041338,65041640,False,2,302
14378,65045214,65074350,False,1,29136
14379,65048392,65052231,True,1,3839
14380,65051849,65052239,False,1,390
14381,65051849,65052239,True,3,390
14382,65070589,65117926,True,2,47337
14383,65070960,65097986,True,1,27026
14384,65077154,65079052,False,1,1898
14385,65077154,65079052,True,4,1898
14386,65084865,65091311,True,1,6446
14387,65084865,65092971,True,1,8106
14388,65091118,65091256,True,1,138
14389,65092447,65105894,True,1,13447
14390,65093135,65106200,True,2,13065
14391,65093135,65132841,True,1,39706
14392,65093135,65161961,True,1,68826
14393,65093427,65094568,True,1,1141
14394,65093463,65095924,True,1,2461
14395,65096038,65096512,True,1,474
14396,65102832,65103371,False,1,539
14397,65103519,65103944,True,1,425
14398,65104708,65117624,False,1,12916
14399,65104708,65118618,False,1,13910
14400,65107465,65112429,True,2,4964
14401,65107465,65124479,True,1,17014
14402,65113934,65142345,True,1,28411
14403,65114706,65117123,True,4,2417
14404,65116712,65143661,True,1,26949
14405,65124217,65135632,True,1,11415
14406,65135862,65137398,True,2,1536
14407,65147378,65193830,True,2,46452
14408,65147983,65194075,True,1,46092
14409,65158910,65164815,True,2,5905
14410,65163394,65200783,True,3,37389
14411,65164649,65184749,True,1,20100
14412,65164739,65165534,True,1,795
14413,65168696,65172762,True,1,4066
14414,65170734,65174813,True,1,4079
14415,65171062,65184990,False,1,13928
14416,65171062,65184990,True,1,13928
14417,65171335,65174220,False,1,2885
14418,65171335,65174220,True,1,2885
14419,65173760,65175308,True,4,1548
14420,65183400,65183506,False,1,106
14421,65183400,65183506,True,1,106
14422,65194619,65195397,True,1,778
14423,65194619,65195948,False,1,1329
14424,65198428,65199533,False,1,1105
14425,65210499,65211869,False,1,1370
14426,65210499,65214267,True,2,3768
14427,65210787,65213868,True,1,3081
14428,65210787,65216403,True,1,5616
14429,65211438,65258405,True,2,46967
14430,65217204,65228766,True,1,11562
14431,65220947,65221454,False,1,507
14432,65225589,65226799,True,1,1210
14433,65229174,65231367,True,1,2193
14434,65238848,65249929,False,1,11081
14435,65241477,65241734,False,1,257
14436,65242948,65271480,True,2,28532
14437,65242948,65298731,True,1,55783
14438,65243343,65271770,True,1,28427
14439,65248191,65256301,True,1,8110
14440,65255266,65255874,True,2,608
14441,65255266,65256362,True,2,1096
14442,65255266,65256982,True,1,1716
14443,65259389,65261968,True,1,2579
14444,65268504,65281153,False,1,12649
14445,65275096,65294661,True,1,19565
14446,65277982,65355974,True,1,77992
14447,65290721,65291257,True,1,536
14448,65291780,65292506,True,1,726
14449,65292661,65293351,True,1,690
14450,65310312,65372109,True,4,61797
14451,65326349,65701334,True,1,374985
14452,65332511,65333713,True,2,1202
14453,65342559,65342988,True,2,429
14454,65342799,65342988,True,1,189
14455,65349654,65351565,True,1,1911
14456,65353825,65354435,True,2,610
14457,65360727,65360812,False,2,85
14458,65363578,65363679,False,1,101
14459,65364225,65368003,True,1,3778
14460,65364345,65364655,True,1,310
14461,65367091,65367962,True,1,871
14462,65370733,65370944,False,1,211
14463,65370733,65371903,True,1,1170
14464,65371234,65372027,True,1,793
14465,65374689,65404326,True,1,29637
14466,65374817,65375141,True,1,324
14467,65375078,65376200,True,1,1122
14468,65376003,65376095,True,1,92
14469,65382352,65382613,False,1,261
14470,65394830,65394901,False,3,71
14471,65398218,65401581,False,3,3363
14472,65406527,65422202,True,1,15675
14473,65418464,65422096,True,1,3632
14474,65421631,65435544,True,2,13913
14475,65424088,65436239,True,2,12151
14476,65426100,65426787,True,1,687
14477,65433811,65456763,True,1,22952
14478,65448117,65448930,True,1,813
14479,65448956,65449423,True,1,467
14480,65453610,65471994,False,1,18384
14481,65453610,65471994,True,4,18384
14482,65470294,65486322,False,1,16028
14483,65470365,65475558,False,1,5193
14484,65470365,65475558,True,1,5193
14485,65470599,65475558,False,1,4959
14486,65470599,65475558,True,1,4959
14487,65471596,65471680,True,1,84
14488,65474351,65482390,True,1,8039
14489,65479538,65479635,True,2,97
14490,65479775,65480076,True,1,301
14491,65479960,65480261,True,1,301
14492,65480867,65481121,True,1,254
14493,65481368,65482789,False,2,1421
14494,65481368,65482789,True,1,1421
14495,65492766,65496462,True,1,3696
14496,65501755,65505010,True,1,3255
14497,65505373,65506275,True,1,902
14498,65508284,65510090,True,1,1806
14499,65512718,65514849,True,1,2131
14500,65512718,65519567,False,1,6849
14501,65515526,65525927,True,2,10401
14502,65515526,65539971,True,1,24445
14503,65516030,65526212,True,1,10182
14504,65537124,65559507,False,1,22383
14505,65544675,65545376,False,1,701
14506,65545358,65545961,False,1,603
14507,65561567,65561754,True,1,187
14508,65563109,65563594,True,1,485
14509,65564119,65564560,True,1,441
14510,65567299,65567618,True,1,319
14511,65567647,65571786,True,1,4139
14512,65571098,65639204,False,1,68106
14513,65579704,65586784,True,1,7080
14514,65584296,65585986,False,1,1690
14515,65589868,65589870,True,1,2
14516,65589997,65590361,True,1,364
14517,65591367,65591447,True,1,80
14518,65597092,65701142,True,2,104050
14519,65600127,65600975,True,1,848
14520,65600127,65601200,False,1,1073
14521,65617317,65617799,True,2,482
14522,65620245,65621733,True,3,1488
14523,65620565,65621324,True,1,759
14524,65623913,65624282,False,1,369
14525,65623913,65624447,False,1,534
14526,65623913,65624967,False,1,1054
14527,65623913,65625055,False,1,1142
14528,65624430,65626789,False,1,2359
14529,65626547,65627828,True,2,1281
14530,65630307,65631563,False,1,1256
14531,65642066,65643346,True,4,1280
14532,65642066,65644107,False,1,2041
14533,65644003,65645850,True,2,1847
14534,65654006,65654199,True,1,193
14535,65656308,65657055,True,1,747
14536,65658166,65697075,False,1,38909
14537,65662959,65664750,False,1,1791
14538,65662959,65664750,True,4,1791
14539,65664535,65686483,False,2,21948
14540,65664535,65686483,True,7,21948
14541,65664926,65672636,True,2,7710
14542,65665367,65674497,True,2,9130
14543,65671705,65672201,True,1,496
14544,65673202,65674662,True,3,1460
14545,65673202,65680246,True,1,7044
14546,65677680,65678389,True,1,709
14547,65686981,65687267,True,1,286
14548,65696510,65698806,True,1,2296
14549,65698810,65702568,True,1,3758
14550,65703199,65703532,True,1,333
14551,65706286,65708674,True,1,2388
14552,65706533,65708674,True,1,2141
14553,65713416,65717382,True,1,3966
14554,65713416,65728557,True,1,15141
14555,65713416,65769242,True,1,55826
14556,65719933,65774817,True,1,54884
14557,65724656,65730647,False,1,5991
14558,65724755,65730647,False,1,5892
14559,65725971,65730923,False,1,4952
14560,65731997,65732917,False,1,920
14561,65737041,65741314,True,2,4273
14562,65740590,65741207,True,1,617
14563,65740590,65756173,True,1,15583
14564,65741543,65756285,True,1,14742
14565,65741817,65745672,True,1,3855
14566,65741817,65745824,True,1,4007
14567,65742608,65746189,True,1,3581
14568,65742608,65746341,True,1,3733
14569,65756066,65760728,True,1,4662
14570,65762194,65771610,False,1,9416
14571,65763233,65764297,True,1,1064
14572,65776875,65779085,True,1,2210
14573,65776986,65777166,False,1,180
14574,65777959,65778940,False,1,981
14575,65777959,65778940,True,1,981
14576,65779420,65780173,True,2,753
14577,65783938,65784313,True,1,375
14578,65791322,65791416,False,1,94
14579,65793469,65795775,True,2,2306
14580,65794229,65796142,True,1,1913
14581,65799774,65802346,True,1,2572
14582,65805169,65805522,False,1,353
14583,65805169,65805522,True,2,353
14584,65805169,65805716,True,1,547
14585,65805169,65807352,True,1,2183
14586,65805780,65807029,True,1,1249
14587,65809151,65810937,True,1,1786
14588,65809573,65810799,True,1,1226
14589,65814798,65819651,True,1,4853
14590,65815579,65815775,True,1,196
14591,65815929,65860911,True,1,44982
14592,65816231,65819997,True,2,3766
14593,65818269,65822379,True,1,4110
14594,65818350,65822567,True,2,4217
14595,65818350,65832442,True,1,14092
14596,65828350,65837932,True,1,9582
14597,65829671,65863492,True,1,33821
14598,65829911,65831968,True,2,2057
14599,65829935,65841470,False,1,11535
14600,65833035,65833436,True,1,401
14601,65835991,65838135,True,1,2144
14602,65837884,65838638,True,1,754
14603,65858422,65865655,True,1,7233
14604,65860158,65860697,False,1,539
14605,65861363,65866840,False,1,5477
14606,65861363,65866840,True,1,5477
14607,65863465,65863885,True,1,420
14608,65867848,65869654,True,2,1806
14609,65873269,65875806,True,1,2537
14610,65874223,65876464,True,1,2241
14611,65877638,65878034,False,1,396
14612,65877638,65878034,True,2,396
14613,65880075,65881608,True,1,1533
14614,65881766,65883097,True,1,1331
14615,65889105,65889255,True,3,150
14616,65890329,65898544,False,1,8215
14617,65895069,65895938,True,1,869
14618,65895212,65896218,True,1,1006
14619,65895475,65896595,False,1,1120
14620,65898254,65899299,False,1,1045
14621,65902195,65908238,True,3,6043
14622,65911618,65930038,True,1,18420
14623,65913580,65914347,False,2,767
14624,65913580,65914347,True,1,767
14625,65925317,65930802,False,1,5485
14626,65936948,65939691,True,1,2743
14627,65946253,65947057,True,16,804
14628,65946289,65947057,True,3,768
14629,65946577,65946814,True,1,237
14630,65946577,65947045,True,1,468
14631,65949905,65952876,True,1,2971
14632,65950150,65950569,True,1,419
14633,65952196,65953197,True,1,1001
14634,65952196,65953315,True,1,1119
14635,65962530,65982660,True,1,20130
14636,65969483,65970595,False,1,1112
14637,65969483,65970595,True,1,1112
14638,65986247,65987927,True,1,1680
14639,65994410,66000158,True,1,5748
14640,65994410,66011231,True,1,16821
14641,65994410,66011796,False,1,17386
14642,66009944,66023829,True,2,13885
14643,66014038,66017425,True,6,3387
14644,66020566,66033093,True,3,12527
14645,66028580,66028998,True,1,418
14646,66035739,66036072,False,1,333
14647,66038305,66039084,True,1,779
14648,66050589,66051679,True,2,1090
14649,66053086,66053281,True,1,195
14650,66054610,66057115,False,1,2505
14651,66064088,66068035,True,1,3947
14652,66065469,66068758,True,3,3289
14653,66068221,66091533,True,1,23312
14654,66072838,66073051,True,1,213
14655,66074983,66084612,True,3,9629
14656,66075858,66084930,True,1,9072
14657,66076935,66093645,True,4,16710
14658,66087620,66092149,False,2,4529
14659,66087620,66092149,True,1,4529
14660,66087979,66100672,True,3,12693
14661,66089238,66089951,True,2,713
14662,66096996,66106534,True,3,9538
14663,66097160,66101173,True,1,4013
14664,66101086,66116587,False,1,15501
14665,66108167,66109004,True,4,837
14666,66113860,66114016,True,1,156
14667,66122300,66126256,True,1,3956
14668,66123312,66126854,True,1,3542
14669,66123324,66126870,True,1,3546
14670,66124193,66126625,True,1,2432
14671,66124299,66126778,True,2,2479
14672,66131723,66181804,False,1,50081
14673,66132379,66173843,False,1,41464
14674,66144326,66145192,False,1,866
14675,66144326,66145192,True,2,866
14676,66146555,66147158,True,1,603
14677,66160684,66165024,False,1,4340
14678,66160684,66165024,True,1,4340
14679,66161145,66163578,False,1,2433
14680,66174855,66180413,True,2,5558
14681,66177190,66178514,True,1,1324
14682,66183169,66186537,True,1,3368
14683,66208469,66218274,True,2,9805
14684,66212964,66213386,True,1,422
14685,66215658,66215757,False,1,99
14686,66215658,66231370,True,1,15712
14687,66221601,66223724,False,1,2123
14688,66224222,66224408,True,1,186
14689,66228220,66231726,False,1,3506
14690,66233671,66234261,True,2,590
14691,66233671,66234264,True,1,593
14692,66233991,66234471,True,1,480
14693,66258599,66259416,True,1,817
14694,66262063,66262510,True,4,447
14695,66267187,66270116,True,1,2929
14696,66267702,66270116,True,1,2414
14697,66269407,66272394,True,1,2987
14698,66269453,66270512,True,1,1059
14699,66292967,66295115,True,1,2148
14700,66292967,66295363,True,1,2396
14701,66293212,66293510,True,1,298
14702,66297128,66298583,True,1,1455
14703,66297128,66311251,True,2,14123
14704,66304606,66305290,False,1,684
14705,66308816,66310358,True,1,1542
14706,66311256,66311307,True,1,51
14707,66311489,66317283,True,2,5794
14708,66321293,66383452,False,1,62159
14709,66321293,66383452,True,3,62159
14710,66323603,66396398,True,2,72795
14711,66323967,66324081,True,3,114
14712,66326284,66326405,True,1,121
14713,66326508,66345819,True,1,19311
14714,66327200,66327596,True,1,396
14715,66327944,66329098,True,3,1154
14716,66337317,66337619,True,2,302
14717,66338035,66338122,True,1,87
14718,66338804,66355003,False,1,16199
14719,66338804,66355003,True,4,16199
14720,66344910,66345090,True,1,180
14721,66345253,66346308,True,1,1055
14722,66346624,66349495,False,1,2871
14723,66352706,66352825,True,3,119
14724,66354899,66355026,True,1,127
14725,66366446,66382955,True,1,16509
14726,66366529,66393516,False,1,26987
14727,66371829,66378164,True,1,6335
14728,66379808,66385234,True,1,5426
14729,66379808,66386539,True,2,6731
14730,66387061,66407912,True,1,20851
14731,66394617,66414337,True,1,19720
14732,66394909,66442238,True,1,47329
14733,66411436,66412229,True,1,793
14734,66411560,66411664,False,1,104
14735,66411560,66412730,True,1,1170
14736,66415301,66440897,True,1,25596
14737,66421680,66433307,True,2,11627
14738,66434744,66434877,False,1,133
14739,66436812,66437341,True,2,529
14740,66439467,66453072,True,1,13605
14741,66458665,66474822,True,4,16157
14742,66462662,66464620,True,2,1958
14743,66469297,66478122,True,2,8825
14744,66470974,66471098,True,2,124
14745,66471415,66471524,True,1,109
14746,66479750,66480254,False,1,504
14747,66479750,66480254,True,1,504
14748,66480462,66485303,True,1,4841
14749,66482531,66485820,True,3,3289
14750,66491875,66542405,True,1,50530
14751,66493729,66498147,True,1,4418
14752,66493729,66557145,True,2,63416
14753,66494030,66494151,True,2,121
14754,66500066,66502940,True,1,2874
14755,66507775,66508330,True,2,555
14756,66509242,66509437,False,1,195
14757,66510013,66510856,True,3,843
14758,66514770,66514918,True,1,148
14759,66514778,66514918,True,1,140
14760,66514778,66514923,True,1,145
14761,66515108,66515360,True,1,252
14762,66519520,66519635,True,4,115
14763,66523118,66523738,True,1,620
14764,66524506,66525299,True,1,793
14765,66524630,66524734,False,1,104
14766,66524630,66525800,True,1,1170
14767,66530021,66530882,True,2,861
14768,66537019,66539201,True,2,2182
14769,66543175,66543312,True,1,137
14770,66544459,66544808,True,1,349
14771,66544603,66552431,True,1,7828
14772,66556515,66586174,True,1,29659
14773,66558302,66586824,True,2,28522
14774,66560112,66587833,True,1,27721
14775,66566242,66573954,True,1,7712
14776,66566408,66574030,True,2,7622
14777,66566943,66567609,True,1,666
14778,66566943,66567834,True,1,891
14779,66572913,66573106,True,6,193
14780,66576297,66576440,True,1,143
14781,66581012,66584833,True,6,3821
14782,66584229,66585290,False,1,1061
14783,66584463,66585307,True,1,844
14784,66598638,66611066,False,1,12428
14785,66605746,66617638,True,3,11892
14786,66612879,66615346,False,1,2467
14787,66615157,66617535,True,3,2378
14788,66615164,66617567,True,1,2403
14789,66621241,66629101,True,1,7860
14790,66637940,66658087,False,4,20147
14791,66637940,66658087,True,4,20147
14792,66643008,66645471,False,1,2463
14793,66643008,66645471,True,4,2463
14794,66653437,66654866,True,1,1429
14795,66653437,66661310,True,1,7873
14796,66657221,66658131,True,1,910
14797,66657245,66658131,False,1,886
14798,66657768,66658131,True,1,363
14799,66658266,66661220,True,1,2954
14800,66662454,66670321,False,1,7867
14801,66662849,66688747,False,1,25898
14802,66675298,66677887,True,3,2589
14803,66675298,66679517,True,3,4219
14804,66685423,66688578,True,1,3155
14805,66690929,66701287,True,1,10358
14806,66700234,66707257,False,1,7023
14807,66704213,66706574,True,1,2361
14808,66712821,66713870,True,3,1049
14809,66713901,66715336,True,1,1435
14810,66719086,66725116,True,2,6030
14811,66719690,66771584,True,4,51894
14812,66720675,66721099,True,3,424
14813,66740187,66742651,False,1,2464
14814,66740187,66742651,True,2,2464
14815,66757764,66758795,False,1,1031
14816,66757764,66758795,True,3,1031
14817,66767105,66834894,False,1,67789
14818,66768438,66772870,True,1,4432
14819,66768871,66769013,True,5,142
14820,66770179,66770595,True,1,416
14821,66770235,66770592,True,1,357
14822,66771222,66771431,True,6,209
14823,66771222,66771758,True,1,536
14824,66775954,66779098,True,3,3144
14825,66780949,66782483,True,1,1534
14826,66804909,66806045,True,2,1136
14827,66804959,66806045,True,1,1086
14828,66811512,66811638,True,1,126
14829,66811657,66812198,True,1,541
14830,66817030,66933567,True,1,116537
14831,66817030,67092844,True,3,275814
14832,66844609,66846487,True,1,1878
14833,66844907,66845160,True,1,253
14834,66854865,66855028,True,8,163
14835,66857016,66859198,True,1,2182
14836,66861688,66863881,True,3,2193
14837,66863880,66865016,False,1,1136
14838,66865816,66870284,False,1,4468
14839,66865816,66870284,True,1,4468
14840,66866904,66867409,False,1,505
14841,66866904,66867787,False,1,883
14842,66866904,66877280,False,1,10376
14843,66866904,66878922,False,1,12018
14844,66875626,66876795,True,1,1169
14845,66881698,66881951,True,1,253
14846,66882130,66886309,True,5,4179
14847,66883360,66883448,True,1,88
14848,66883360,66883999,True,1,639
14849,66885043,66888572,True,1,3529
14850,66885564,66887231,True,1,1667
14851,66896610,66897860,True,1,1250
14852,66897551,66902689,True,1,5138
14853,66898583,66899902,True,2,1319
14854,66905595,66949309,False,1,43714
14855,66905623,66911308,False,1,5685
14856,66917835,66918555,True,2,720
14857,66922375,66922554,True,1,179
14858,66924161,66924379,True,4,218
14859,66924161,66928258,True,1,4097
14860,66924321,66925938,True,1,1617
14861,66925705,66933360,True,1,7655
14862,66926399,66927235,True,1,836
14863,66928953,66934922,False,1,5969
14864,66928953,66934922,True,3,5969
14865,66935711,66938042,True,4,2331
14866,66935711,66940972,True,1,5261
14867,66940659,66950915,True,3,10256
14868,66949764,66950113,True,2,349
14869,66949764,66950116,True,1,352
14870,66949974,66952346,True,4,2372
14871,66950732,66951272,True,1,540
14872,66955828,66956946,True,2,1118
14873,66973183,66978363,True,1,5180
14874,66973183,66983044,True,1,9861
14875,66981868,66986443,True,1,4575
14876,67002982,67010982,True,1,8000
14877,67009123,67012893,False,1,3770
14878,67032989,67033437,True,4,448
14879,67033404,67034775,True,1,1371
14880,67034170,67035914,True,1,1744
14881,67049103,67053133,True,1,4030
14882,67054757,67062222,True,2,7465
14883,67057508,67057798,False,1,290
14884,67058183,67061112,True,2,2929
14885,67077947,67080880,True,4,2933
14886,67082006,67082131,False,2,125
14887,67082006,67082131,True,3,125
14888,67087513,67089602,True,1,2089
14889,67093608,67093700,True,2,92
14890,67093608,67093703,True,2,95
14891,67093857,67096301,True,1,2444
14892,67093857,67104397,True,1,10540
14893,67095733,67097331,True,4,1598
14894,67096987,67104908,True,1,7921
14895,67103322,67103978,False,2,656
14896,67105355,67105433,True,2,78
14897,67105390,67107444,True,1,2054
14898,67105457,67107444,True,1,1987
14899,67109529,67114654,True,1,5125
14900,67117138,67135195,True,1,18057
14901,67129758,67130187,True,1,429
14902,67129776,67130187,True,1,411
14903,67130917,67131169,True,1,252
14904,67140247,67155753,True,3,15506
14905,67140344,67142849,True,1,2505
14906,67143054,67176652,True,2,33598
14907,67143957,67150823,True,1,6866
14908,67143981,67151863,False,1,7882
14909,67178623,67197414,True,1,18791
14910,67180651,67218102,True,1,37451
14911,67181292,67181417,False,1,125
14912,67181292,67181417,True,4,125
14913,67181967,67218472,True,1,36505
14914,67191930,67193368,True,1,1438
14915,67206473,67368794,True,2,162321
14916,67208653,67209001,True,1,348
14917,67211200,67212420,True,1,1220
14918,67224330,67234854,True,1,10524
14919,67246348,67251578,True,1,5230
14920,67252653,67260126,True,1,7473
14921,67281957,67282545,True,1,588
14922,67285608,67288089,True,1,2481
14923,67288015,67288376,True,1,361
14924,67288552,67289579,True,2,1027
14925,67323073,67334300,False,1,11227
14926,67323073,67334300,True,1,11227
14927,67328283,67329425,True,3,1142
14928,67330064,67332756,True,1,2692
14929,67338319,67346476,False,1,8157
14930,67339671,67342105,True,6,2434
14931,67342548,67350109,True,1,7561
14932,67357118,67358164,True,4,1046
14933,67357486,67357681,True,5,195
14934,67357911,67359602,False,1,1691
14935,67369019,67520777,True,1,151758
14936,67370739,67372104,True,1,1365
14937,67371362,67373232,True,1,1870
14938,67375318,67381387,True,1,6069
14939,67378201,67379513,True,1,1312
14940,67380406,67382658,True,2,2252
14941,67382174,67383424,True,1,1250
14942,67384062,67391900,True,1,7838
14943,67384084,67391900,True,1,7816
14944,67392043,67392280,True,1,237
14945,67399496,67399781,True,2,285
14946,67403094,67438095,True,1,35001
14947,67403192,67404573,True,1,1381
14948,67405795,67405862,True,1,67
14949,67406895,67409558,True,6,2663
14950,67412349,67417518,True,1,5169
14951,67419870,67423035,False,1,3165
14952,67419870,67423035,True,6,3165
14953,67424304,67430539,False,1,6235
14954,67439713,67440738,True,1,1025
14955,67439713,67441442,True,1,1729
14956,67444428,67458259,True,1,13831
14957,67456444,67463469,True,8,7025
14958,67477026,67485371,True,3,8345
14959,67478027,67479016,True,1,989
14960,67479544,67483718,True,3,4174
14961,67501188,67545205,True,1,44017
14962,67501188,67547102,True,1,45914
14963,67501668,67547457,True,1,45789
14964,67502955,67632524,True,1,129569
14965,67519800,67522276,True,1,2476
14966,67520316,67527159,False,1,6843
14967,67525057,67525726,True,1,669
14968,67525060,67525726,True,1,666
14969,67525060,67525747,True,1,687
14970,67526119,67531163,False,1,5044
14971,67526119,67531163,True,3,5044
14972,67530499,67530694,True,5,195
14973,67531313,67532730,True,1,1417
14974,67535123,67542697,True,1,7574
14975,67537156,67538611,True,2,1455
14976,67537541,67538996,False,1,1455
14977,67545420,67550017,True,1,4597
14978,67569082,67569162,True,1,80
14979,67570072,67610369,True,2,40297
14980,67570072,67614654,False,1,44582
14981,67579843,67580617,True,1,774
14982,67579843,67583692,True,4,3849
14983,67591169,67592197,True,1,1028
14984,67604445,67607033,True,2,2588
14985,67619239,67619323,True,4,84
14986,67629325,67649179,True,1,19854
14987,67635113,67704058,True,1,68945
14988,67650308,67654395,True,1,4087
14989,67665745,67666851,True,1,1106
14990,67680491,67693624,True,3,13133
14991,67703523,67705286,False,1,1763
14992,67717515,67717770,False,1,255
14993,67717515,67718641,False,1,1126
14994,67729375,67734622,True,1,5247
14995,67729870,67729945,False,1,75
14996,67729870,67729982,False,1,112
14997,67730948,67735477,True,1,4529
14998,67733717,67734075,False,3,358
14999,67733717,67734075,True,4,358
15000,67740590,67747663,True,1,7073
15001,67748844,67749838,True,1,994
15002,67749308,67749795,True,1,487
15003,67751235,67754890,True,1,3655
15004,67755664,67813201,True,4,57537
15005,67756241,67756648,True,4,407
15006,67760866,67761379,False,1,513
15007,67761243,67766268,True,5,5025
15008,67782240,67784835,True,10,2595
15009,67787226,67793376,False,1,6150
15010,67794017,67918710,True,1,124693
15011,67797901,67846989,False,1,49088
15012,67805013,67805868,True,1,855
15013,67828728,67835306,True,4,6578
15014,67829188,67835597,True,1,6409
15015,67829215,67835558,True,1,6343
15016,67844287,67844373,True,7,86
15017,67846852,67847167,True,1,315
15018,67855784,67861280,True,1,5496
15019,67866994,67886277,True,2,19283
15020,67867113,67869322,True,1,2209
15021,67871195,67876964,True,1,5769
15022,67876519,67883009,True,1,6490
15023,67876543,67883029,True,2,6486
15024,67889278,67889606,True,1,328
15025,67889697,67891986,True,1,2289
15026,67893450,67897628,True,1,4178
15027,67896383,67898152,True,1,1769
15028,67896695,67899727,True,1,3032
15029,67903292,67905974,True,1,2682
15030,67903440,67906122,True,1,2682
15031,67909234,67929089,True,1,19855
15032,67909234,67929978,True,1,20744
15033,67909234,67930942,True,1,21708
15034,67948266,67948563,True,2,297
15035,67949721,67950552,True,3,831
15036,67961778,67964671,True,2,2893
15037,67975556,67976304,True,1,748
15038,67976697,67985834,True,2,9137
15039,67980269,67981616,False,1,1347
15040,67980269,67985517,True,9,5248
15041,67993340,68011524,True,1,18184
15042,67994734,67995855,True,2,1121
15043,68005179,68008237,True,4,3058
15044,68005179,68012284,True,2,7105
15045,68038809,68041974,True,4,3165
15046,68041787,68042474,True,1,687
15047,68043729,68046224,True,1,2495
15048,68086058,68089118,False,1,3060
15049,68086058,68089118,True,1,3060
15050,68086794,68089345,True,1,2551
15051,68086794,68091023,False,1,4229
15052,68095727,68097890,True,1,2163
15053,68098143,68103316,False,1,5173
15054,68109687,68109917,True,1,230
15055,68115495,68123869,True,1,8374
15056,68117575,68120733,True,1,3158
15057,68119236,68160113,True,1,40877
15058,68144959,68145562,True,1,603
15059,68146647,68147195,True,2,548
15060,68148086,68167174,True,1,19088
15061,68149259,68167798,True,1,18539
15062,68166706,68176482,False,1,9776
15063,68174886,68175788,True,1,902
15064,68175888,68178939,True,1,3051
15065,68186788,68187644,True,1,856
15066,68187128,68187205,False,1,77
15067,68203396,68205252,False,1,1856
15068,68203396,68206322,False,1,2926
15069,68211587,68211754,True,1,167
15070,68213587,68215772,False,1,2185
15071,68213587,68215772,True,3,2185
15072,68217540,68218366,False,1,826
15073,68226062,68271531,True,1,45469
15074,68226062,68292940,True,1,66878
15075,68227582,68229206,True,1,1624
15076,68229876,68230858,True,2,982
15077,68242058,68242567,False,3,509
15078,68249163,68280925,True,1,31762
15079,68254449,68256866,True,1,2417
15080,68254449,68260707,True,1,6258
15081,68259711,68259847,True,5,136
15082,68263971,68265034,True,1,1063
15083,68273038,68281176,True,2,8138
15084,68273107,68281205,False,1,8098
15085,68289018,68313682,False,1,24664
15086,68289029,68301516,False,1,12487
15087,68289041,68301516,False,1,12475
15088,68293328,68293430,False,1,102
15089,68293328,68293430,True,1,102
15090,68304455,68304635,True,1,180
15091,68317356,68318121,True,1,765
15092,68329779,68342933,True,1,13154
15093,68329779,68345865,True,1,16086
15094,68329779,68348883,True,1,19104
15095,68346664,68348343,True,1,1679
15096,68349610,68357384,True,1,7774
15097,68350920,68352110,True,1,1190
15098,68351538,68355513,True,1,3975
15099,68358240,68375334,True,1,17094
15100,68358240,68382379,True,1,24139
15101,68358240,68395672,True,1,37432
15102,68358240,68399906,True,3,41666
15103,68358240,68413214,True,1,54974
15104,68359839,68363297,True,1,3458
15105,68364373,68364625,False,1,252
15106,68364373,68364625,True,3,252
15107,68366537,68366910,True,1,373
15108,68377330,68377936,True,1,606
15109,68397963,68404025,True,1,6062
15110,68408037,68408864,True,1,827
15111,68408094,68408940,True,1,846
15112,68409316,68409555,True,3,239
15113,68409316,68413088,True,2,3772
15114,68409387,68409628,True,1,241
15115,68409387,68413161,True,1,3774
15116,68409743,68413161,True,2,3418
15117,68413301,68415079,True,1,1778
15118,68414232,68415581,True,1,1349
15119,68417172,68419003,True,1,1831
15120,68424007,68471565,True,1,47558
15121,68428255,68428439,True,7,184
15122,68428801,68428975,True,4,174
15123,68437537,68437630,True,1,93
15124,68440539,68440669,False,3,130
15125,68440901,68441340,True,1,439
15126,68480112,68483696,True,3,3584
15127,68480112,68489526,True,1,9414
15128,68490531,68492273,False,4,1742
15129,68490531,68492273,True,5,1742
15130,68490531,68497601,True,2,7070
15131,68499160,68501087,True,2,1927
15132,68499160,68501998,True,1,2838
15133,68506895,68507445,True,1,550
15134,68511680,68516198,True,2,4518
15135,68514216,68517284,True,4,3068
15136,68522439,68599827,True,1,77388
15137,68523391,68525279,True,2,1888
15138,68546324,68561994,True,1,15670
15139,68565307,68566797,True,1,1490
15140,68574609,68574784,True,1,175
15141,68574700,68574880,True,1,180
15142,68575642,68577321,True,3,1679
15143,68575642,68577324,True,1,1682
15144,68579076,68580736,True,1,1660
15145,68584033,68584118,True,10,85
15146,68608301,68608711,False,1,410
15147,68608301,68608711,True,1,410
15148,68621093,68665269,True,1,44176
15149,68621375,68631225,True,1,9850
15150,68621615,68622059,False,1,444
15151,68621615,68622063,False,2,448
15152,68621615,68622063,True,2,448
15153,68625386,68626193,False,1,807
15154,68649513,68649931,True,1,418
15155,68652566,68654539,True,1,1973
15156,68659100,68665728,True,1,6628
15157,68659100,68665799,True,1,6699
15158,68659100,68668212,True,1,9112
15159,68659100,68668523,True,1,9423
15160,68659457,68659541,True,1,84
15161,68669206,68669358,False,1,152
15162,68680444,68680878,True,2,434
15163,68719923,68730170,True,1,10247
15164,68719923,68747936,True,1,28013
15165,68719923,68749333,False,1,29410
15166,68719923,68749333,True,2,29410
15167,68720138,68738397,True,1,18259
15168,68733488,68744856,True,1,11368
15169,68733488,68751781,True,1,18293
15170,68733697,68745162,True,1,11465
15171,68741778,68741780,True,1,2
15172,68751081,68752478,True,3,1397
15173,68752910,68756475,True,1,3565
15174,68756552,68758139,True,2,1587
15175,68758195,68758658,True,4,463
15176,68760148,68760384,True,1,236
15177,68770554,68771374,True,3,820
15178,68776582,68843312,False,4,66730
15179,68783411,68789447,True,1,6036
15180,68784607,68787472,True,3,2865
15181,68788548,68789584,True,2,1036
15182,68796549,68797322,True,1,773
15183,68798977,68807026,True,8,8049
15184,68799298,68799843,True,4,545
15185,68799301,68799843,True,3,542
15186,68818238,68823360,True,2,5122
15187,68831710,68832129,True,1,419
15188,68861160,68865764,True,1,4604
15189,68862593,68863138,True,1,545
15190,68862593,68863835,False,1,1242
15191,68867446,68870471,True,1,3025
15192,68867884,68927855,True,1,59971
15193,68877760,68877849,True,1,89
15194,68881541,68885579,True,1,4038
15195,68917861,68942254,True,2,24393
15196,68921097,68931208,True,1,10111
15197,68941648,68943202,False,1,1554
15198,68964237,68965479,False,1,1242
15199,68965493,68976666,True,1,11173
15200,68987003,68987964,True,1,961
15201,68998368,68999109,False,1,741
15202,69002202,69002658,True,4,456
15203,69009870,69031075,True,1,21205
15204,69011807,69012603,True,2,796
15205,69028402,69040317,True,1,11915
15206,69034645,69034979,True,3,334
15207,69042409,69042590,False,1,181
15208,69042893,69043812,True,1,919
15209,69045042,69045462,False,1,420
15210,69045042,69045462,True,1,420
15211,69048369,69049576,False,3,1207
15212,69048369,69049576,True,9,1207
15213,69075772,69078521,True,1,2749
15214,69077086,69077643,False,2,557
15215,69077086,69077643,True,1,557
15216,69077086,69078160,False,1,1074
15217,69077086,69078364,False,1,1278
15218,69078668,69186121,True,1,107453
15219,69083799,69083906,True,2,107
15220,69084574,69088332,True,1,3758
15221,69103498,69103586,True,3,88
15222,69113263,69117077,False,1,3814
15223,69113263,69117077,True,3,3814
15224,69113442,69129395,True,2,15953
15225,69136164,69137517,False,2,1353
15226,69136164,69150340,False,1,14176
15227,69163052,69164032,True,1,980
15228,69163052,69380099,False,1,217047
15229,69163052,69380099,True,2,217047
15230,69195685,69208661,False,1,12976
15231,69196102,69208776,False,1,12674
15232,69202497,69207220,True,4,4723
15233,69204751,69216373,True,3,11622
15234,69204751,69216419,True,2,11668
15235,69212300,69226077,True,3,13777
15236,69212758,69213025,False,1,267
15237,69221566,69221986,False,1,420
15238,69221810,69222336,True,1,526
15239,69221810,69222540,True,1,730
15240,69227415,69227584,True,2,169
15241,69242172,69245978,True,2,3806
15242,69243009,69243469,True,1,460
15243,69248190,69248610,False,1,420
15244,69248190,69248610,True,1,420
15245,69265395,69295447,True,1,30052
15246,69268225,69269135,True,1,910
15247,69270573,69271710,False,1,1137
15248,69270573,69271710,True,3,1137
15249,69270573,69271933,True,1,1360
15250,69270630,69271985,True,1,1355
15251,69271418,69273656,True,1,2238
15252,69271418,69275683,True,1,4265
15253,69276143,69276302,False,1,159
15254,69276301,69278233,True,1,1932
15255,69277483,69279361,True,1,1878
15256,69280218,69280775,False,1,557
15257,69280218,69280775,True,1,557
15258,69280218,69281481,False,1,1263
15259,69280218,69281496,False,1,1278
15260,69281054,69289131,True,1,8077
15261,69285362,69306760,True,2,21398
15262,69286262,69305376,True,1,19114
15263,69287712,69307922,True,1,20210
15264,69293368,69293669,True,2,301
15265,69293642,69293862,True,1,220
15266,69293788,69302542,False,1,8754
15267,69293788,69302542,True,1,8754
15268,69294336,69301541,True,1,7205
15269,69302591,69302876,True,1,285
15270,69302752,69305911,True,1,3159
15271,69304411,69307394,True,1,2983
15272,69307889,69309106,True,2,1217
15273,69308209,69318183,True,1,9974
15274,69310528,69310814,True,1,286
15275,69312653,69313353,True,1,700
15276,69313012,69343407,True,2,30395
15277,69313396,69343570,True,1,30174
15278,69323968,69324171,True,1,203
15279,69327019,69348732,True,3,21713
15280,69345083,69345169,True,2,86
15281,69358959,69379771,True,1,20812
15282,69361366,69380977,True,3,19611
15283,69361366,69382244,True,1,20878
15284,69361366,69442315,True,1,80949
15285,69365801,69451185,False,1,85384
15286,69369431,69369746,True,1,315
15287,69369491,69369746,True,2,255
15288,69375490,69445234,True,1,69744
15289,69379402,69379491,True,1,89
15290,69379402,69379771,False,1,369
15291,69393676,69404561,True,1,10885
15292,69394649,69405041,True,1,10392
15293,69396067,69422058,True,8,25991
15294,69399056,69405127,True,1,6071
15295,69400659,69410856,True,1,10197
15296,69418425,69418496,True,1,71
15297,69424849,69425418,False,1,569
15298,69424849,69426323,False,1,1474
15299,69450034,69451066,True,1,1032
15300,69450198,69450557,True,1,359
15301,69450198,69455240,True,1,5042
15302,69451346,69455985,True,1,4639
15303,69478907,69479209,True,1,302
15304,69479243,69479589,False,1,346
15305,69479243,69480153,False,1,910
15306,69485479,69504345,True,1,18866
15307,69487276,69511812,False,1,24536
15308,69490974,69536037,True,1,45063
15309,69492937,69493899,False,1,962
15310,69492937,69493899,True,3,962
15311,69492937,69544950,True,1,52013
15312,69512988,69547044,True,1,34056
15313,69517893,69518725,False,1,832
15314,69517893,69521367,False,1,3474
15315,69519848,69549331,False,1,29483
15316,69519864,69549221,False,1,29357
15317,69519864,69549221,True,1,29357
15318,69551123,69562394,True,1,11271
15319,69571743,69574573,True,1,2830
15320,69595228,69596189,True,1,961
15321,69609901,69616311,False,1,6410
15322,69637518,69637604,True,2,86
15323,69637518,69637607,True,1,89
15324,69644258,69649120,False,1,4862
15325,69648167,69656735,True,5,8568
15326,69648763,69652079,True,1,3316
15327,69649042,69652079,True,1,3037
15328,69653248,69660900,False,1,7652
15329,69666312,69667324,True,1,1012
15330,69678233,69683641,True,1,5408
15331,69678632,69680036,True,1,1404
15332,69685101,69685249,True,2,148
15333,69685101,69691127,False,2,6026
15334,69692051,69693296,True,1,1245
15335,69692051,69693618,True,1,1567
15336,69692743,69696911,True,1,4168
15337,69703848,69705706,False,1,1858
15338,69703848,69705706,True,2,1858
15339,69704366,69705512,True,1,1146
15340,69711568,69711807,True,2,239
15341,69712324,69713279,True,2,955
15342,69712330,69712438,True,1,108
15343,69713478,69713824,True,1,346
15344,69714413,69785188,True,1,70775
15345,69714413,69792051,False,1,77638
15346,69714413,69792051,True,1,77638
15347,69721968,69723608,True,1,1640
15348,69721968,69724144,True,1,2176
15349,69724741,69725094,False,1,353
15350,69729208,69731536,True,2,2328
15351,69738064,69738186,True,2,122
15352,69752859,69752954,True,4,95
15353,69769142,69771375,True,1,2233
15354,69781727,69783787,True,1,2060
15355,69782851,69784343,True,1,1492
15356,69788736,69889748,True,1,101012
15357,69790745,69790854,True,1,109
15358,69793543,69800934,True,1,7391
15359,69793622,69796786,True,1,3164
15360,69801682,69802202,True,2,520
15361,69806653,69833443,True,1,26790
15362,69808205,69808724,True,1,519
15363,69814418,69814726,True,3,308
15364,69830824,69833866,True,5,3042
15365,69831821,69834286,True,3,2465
15366,69838742,69840746,True,1,2004
15367,69838742,69845038,True,1,6296
15368,69839908,69841259,True,1,1351
15369,69852250,69854013,True,1,1763
15370,69859718,69863615,True,2,3897
15371,69867712,69868769,True,1,1057
15372,69872619,69873677,True,1,1058
15373,69875709,69890625,True,1,14916
15374,69875729,69878142,False,1,2413
15375,69876038,69890625,True,2,14587
15376,69880798,69889843,False,1,9045
15377,69889610,69890286,True,1,676
15378,69891773,69896138,False,1,4365
15379,69895896,69898385,True,1,2489
15380,69896811,69899624,True,1,2813
15381,69900608,69901512,True,3,904
15382,69913969,69915177,True,1,1208
15383,69915214,69928810,True,1,13596
15384,69916589,69929481,True,1,12892
15385,69916805,69917004,True,1,199
15386,69916995,69917370,True,1,375
15387,69922383,69932226,False,1,9843
15388,69923874,69925113,True,1,1239
15389,69935399,69937149,False,1,1750
15390,69936178,69937620,False,2,1442
15391,69936178,69937620,True,1,1442
15392,69939833,69946096,True,1,6263
15393,69946425,69954158,True,1,7733
15394,69962119,69964052,False,1,1933
15395,69970926,69979035,True,1,8109
15396,69977502,69977603,True,1,101
15397,69979465,69980300,True,1,835
15398,69979465,69982832,True,1,3367
15399,69981075,69983461,True,1,2386
15400,69991125,70055494,True,1,64369
15401,69996861,69997131,True,1,270
15402,69997136,70002071,True,2,4935
15403,70019371,70118013,False,1,98642
15404,70024544,70025533,False,1,989
15405,70029802,70105883,False,2,76081
15406,70029802,70105883,True,9,76081
15407,70062998,70067507,True,3,4509
15408,70066773,70068440,True,1,1667
15409,70074278,70082019,True,1,7741
15410,70079041,70080106,True,1,1065
15411,70082254,70083507,True,1,1253
15412,70082254,70083957,True,1,1703
15413,70084599,70085078,True,1,479
15414,70084704,70085078,True,1,374
15415,70090214,70091258,True,1,1044
15416,70094706,70116754,False,1,22048
15417,70098373,70114909,True,1,16536
15418,70098373,70117176,True,2,18803
15419,70098373,70119084,True,2,20711
15420,70113283,70113435,True,2,152
15421,70114899,70116431,True,1,1532
15422,70122005,70124117,True,2,2112
15423,70130668,70131239,True,1,571
15424,70135536,70135806,False,1,270
15425,70136704,70138541,True,1,1837
15426,70148047,70148200,True,2,153
15427,70151212,70151418,True,1,206
15428,70163052,70163609,True,1,557
15429,70168849,70169423,True,1,574
15430,70172126,70172851,True,8,725
15431,70173070,70252104,False,1,79034
15432,70177902,70178059,True,3,157
15433,70178970,70179150,True,1,180
15434,70179754,70214947,True,1,35193
15435,70181143,70215247,True,1,34104
15436,70182262,70184582,False,3,2320
15437,70182262,70184582,True,3,2320
15438,70182263,70182582,True,1,319
15439,70186379,70499782,True,1,313403
15440,70189848,70202239,True,1,12391
15441,70200057,70200481,True,2,424
15442,70209488,70209794,True,4,306
15443,70211532,70211614,True,1,82
15444,70211943,70212184,False,1,241
15445,70242250,70250828,False,2,8578
15446,70242250,70250828,True,1,8578
15447,70242373,70245891,True,1,3518
15448,70244736,70246222,True,1,1486
15449,70253943,70254208,True,1,265
15450,70272781,70273317,False,1,536
15451,70297858,70300792,True,1,2934
15452,70321333,70358536,False,1,37203
15453,70321333,70358536,True,8,37203
15454,70324290,70389998,True,3,65708
15455,70337304,70338206,True,1,902
15456,70337327,70338206,True,3,879
15457,70337745,70338377,True,1,632
15458,70339850,70343146,True,2,3296
15459,70346105,70351512,False,1,5407
15460,70349481,70358010,False,1,8529
15461,70361770,70361851,False,2,81
15462,70361770,70361851,True,3,81
15463,70364469,70377544,True,2,13075
15464,70381346,70382113,True,1,767
15465,70390835,70391745,True,1,910
15466,70402625,70403197,True,1,572
15467,70403802,70409017,True,1,5215
15468,70403930,70409017,True,1,5087
15469,70404157,70409151,True,1,4994
15470,70405994,70410098,True,2,4104
15471,70422993,70431047,True,1,8054
15472,70422993,70439038,True,1,16045
15473,70422993,70442891,False,1,19898
15474,70441443,70443553,True,1,2110
15475,70444846,70445967,True,2,1121
15476,70450730,70451873,True,1,1143
15477,70451430,70455530,True,3,4100
15478,70453848,70475516,True,1,21668
15479,70454778,70476105,True,2,21327
15480,70455127,70476340,True,2,21213
15481,70468604,70470252,False,1,1648
15482,70468604,70470252,True,3,1648
15483,70483312,70483629,True,2,317
15484,70484423,70486121,True,1,1698
15485,70494168,70497126,True,1,2958
15486,70495482,70503509,False,1,8027
15487,70495482,70505000,False,1,9518
15488,70495953,70498247,True,1,2294
15489,70500442,70507197,True,2,6755
15490,70510324,70511997,True,2,1673
15491,70516575,70517966,True,1,1391
15492,70517267,70518394,True,1,1127
15493,70517399,70518300,True,1,901
15494,70531323,70543039,True,3,11716
15495,70539025,70539727,True,1,702
15496,70546232,70550297,True,1,4065
15497,70551699,70551993,True,1,294
15498,70555263,70559823,True,3,4560
15499,70562272,70564929,True,4,2657
15500,70569295,70571344,False,1,2049
15501,70574318,70589425,True,1,15107
15502,70580219,70583269,False,1,3050
15503,70590435,70592356,True,1,1921
15504,70591864,70593341,True,1,1477
15505,70596848,70598252,True,5,1404
15506,70605354,70607744,True,1,2390
15507,70607561,70621627,False,1,14066
15508,70612690,70613686,True,1,996
15509,70615451,70616546,False,1,1095
15510,70620792,70625176,True,5,4384
15511,70637545,70638117,True,1,572
15512,70637545,70641016,True,1,3471
15513,70637545,70641238,True,1,3693
15514,70660381,70660586,False,1,205
15515,70662938,70663683,True,1,745
15516,70677986,70683029,True,1,5043
15517,70707016,70745364,False,1,38348
15518,70707491,70718224,False,1,10733
15519,70757757,70768358,False,1,10601
15520,70761493,70763357,True,7,1864
15521,70766132,70767178,False,1,1046
15522,70793349,70794565,False,1,1216
15523,70804018,70808773,True,1,4755
15524,70812078,70828620,True,1,16542
15525,70813575,70815673,False,4,2098
15526,70827217,70833827,True,1,6610
15527,70831889,70842476,True,1,10587
15528,70831889,70853062,True,3,21173
15529,70831889,70883583,True,1,51694
15530,70831889,70911589,True,2,79700
15531,70832879,70843092,True,1,10213
15532,70832879,70853678,True,1,20799
15533,70835926,70838592,True,3,2666
15534,70835992,70838592,True,1,2600
15535,70840707,70843659,True,2,2952
15536,70853516,70864003,True,2,10487
15537,70872393,70872751,True,1,358
15538,70873225,70873297,True,1,72
15539,70884302,70884829,True,1,527
15540,70884302,70892096,True,1,7794
15541,70884307,70884484,True,3,177
15542,70886300,70887797,True,8,1497
15543,70891867,70912982,True,1,21115
15544,70891867,70943461,True,1,51594
15545,70894846,70896492,True,1,1646
15546,70897732,70898394,True,1,662
15547,70898915,70907200,True,1,8285
15548,70904524,70917984,True,3,13460
15549,70906302,70909599,True,2,3297
15550,70907677,70909598,True,1,1921
15551,70907815,70909433,True,4,1618
15552,70911495,70913413,True,1,1918
15553,70913197,70916585,True,1,3388
15554,70913197,70924281,True,3,11084
15555,70915400,70926979,True,1,11579
15556,70925438,70940638,True,1,15200
15557,70929147,70932329,True,3,3182
15558,70929147,70941640,True,1,12493
15559,70929716,70932604,True,2,2888
15560,70931887,70933406,True,2,1519
15561,70941605,70943282,True,1,1677
15562,70942597,70942675,True,1,78
15563,70946325,70946473,True,1,148
15564,70968053,70968832,True,3,779
15565,70968196,70974431,True,3,6235
15566,70968196,70979875,True,3,11679
15567,70969856,70975206,True,1,5350
15568,70969856,70980650,True,2,10794
15569,70969899,70975206,True,1,5307
15570,70969899,70980650,True,2,10751
15571,70971416,70972583,True,1,1167
15572,70980175,71036431,False,1,56256
15573,70980175,71036431,True,1,56256
15574,70982635,70991266,True,3,8631
15575,70993647,70996833,True,1,3186
15576,71009179,71010869,True,2,1690
15577,71012743,71015965,True,1,3222
15578,71028512,71029304,True,1,792
15579,71031443,71038091,True,1,6648
15580,71033674,71131491,True,2,97817
15581,71041695,71046449,False,1,4754
15582,71041695,71046449,True,1,4754
15583,71043355,71045021,True,3,1666
15584,71062858,71064033,True,2,1175
15585,71072010,71072987,True,1,977
15586,71077733,71085053,True,1,7320
15587,71079003,71283732,True,1,204729
15588,71080469,71080551,True,1,82
15589,71080639,71090794,True,1,10155
15590,71082309,71083162,True,1,853
15591,71085080,71086130,True,4,1050
15592,71090014,71103890,False,1,13876
15593,71090014,71103890,True,1,13876
15594,71090014,71103964,True,1,13950
15595,71090014,71104484,True,3,14470
15596,71090014,71106389,True,1,16375
15597,71100644,71127820,True,1,27176
15598,71103227,71113356,True,1,10129
15599,71106071,71107984,False,1,1913
15600,71106071,71114044,False,1,7973
15601,71109661,71111832,False,1,2171
15602,71109661,71111832,True,3,2171
15603,71123918,71124201,True,4,283
15604,71130784,71134143,False,1,3359
15605,71136458,71147597,True,1,11139
15606,71140816,71144452,False,1,3636
15607,71154315,71155896,True,1,1581
15608,71154786,71156367,True,1,1581
15609,71157201,71158869,True,1,1668
15610,71163478,71165336,True,1,1858
15611,71183367,71183682,False,1,315
15612,71183367,71183682,True,2,315
15613,71183367,71184235,True,1,868
15614,71183873,71187696,True,1,3823
15615,71183873,71188440,True,1,4567
15616,71211115,71211259,True,2,144
15617,71213594,71213897,True,8,303
15618,71220272,71220572,True,2,300
15619,71225678,71228626,True,1,2948
15620,71231827,71232588,True,2,761
15621,71232214,71232534,False,1,320
15622,71232625,71233110,True,1,485
15623,71233256,71233332,True,1,76
15624,71236145,71246548,True,3,10403
15625,71244449,71244681,True,1,232
15626,71251936,71309543,True,1,57607
15627,71251936,71398131,True,2,146195
15628,71251936,71416228,True,1,164292
15629,71253509,71258280,True,1,4771
15630,71259529,71260709,True,1,1180
15631,71260883,71261369,True,1,486
15632,71262273,71263925,True,1,1652
15633,71264245,71267788,True,1,3543
15634,71268421,71273748,True,1,5327
15635,71283609,71288056,False,1,4447
15636,71284052,71284898,False,1,846
15637,71284055,71284898,False,1,843
15638,71291336,71292076,True,2,740
15639,71291443,71292123,True,1,680
15640,71291779,71292296,True,1,517
15641,71292185,71293993,True,1,1808
15642,71299374,71299475,True,2,101
15643,71299394,71301800,True,1,2406
15644,71306994,71311758,True,2,4764
15645,71306994,71312513,True,1,5519
15646,71310085,71311980,True,1,1895
15647,71316768,71316857,True,5,89
15648,71318041,71318960,False,1,919
15649,71321339,71321514,True,1,175
15650,71326459,71327073,True,1,614
15651,71327573,71328889,True,1,1316
15652,71345730,71346189,True,2,459
15653,71348273,71349447,True,1,1174
15654,71362555,71401942,True,1,39387
15655,71364149,71366230,True,1,2081
15656,71365053,71403786,True,1,38733
15657,71366160,71367163,True,2,1003
15658,71367748,71405125,True,1,37377
15659,71369209,71374052,False,1,4843
15660,71369680,71391157,True,1,21477
15661,71370322,71370415,True,1,93
15662,71374477,71383874,False,1,9397
15663,71382496,71383808,True,1,1312
15664,71389448,71390518,False,1,1070
15665,71390638,71409135,True,1,18497
15666,71391769,71409664,False,1,17895
15667,71391769,71409664,True,5,17895
15668,71395246,71395372,True,1,126
15669,71409906,71410660,True,1,754
15670,71409987,71410660,True,1,673
15671,71431818,71434563,True,1,2745
15672,71442299,71442392,True,1,93
15673,71442308,71442392,True,1,84
15674,71442564,71444316,True,1,1752
15675,71442730,71444482,True,1,1752
15676,71445090,71445632,True,1,542
15677,71447189,71447300,True,1,111
15678,71459449,71460693,True,2,1244
15679,71463204,71463927,True,1,723
15680,71465214,71465307,True,1,93
15681,71465441,71465534,True,1,93
15682,71466076,71467799,True,2,1723
15683,71469253,71496093,True,1,26840
15684,71469253,71525526,True,2,56273
15685,71471990,71474377,True,1,2387
15686,71472772,71479086,True,1,6314
15687,71474306,71474605,True,2,299
15688,71474464,71474606,True,2,142
15689,71474799,71474895,True,1,96
15690,71477648,71477745,True,1,97
15691,71479592,71480774,True,5,1182
15692,71479714,71481007,True,1,1293
15693,71488870,71489625,True,2,755
15694,71495614,71499473,False,2,3859
15695,71495614,71499473,True,1,3859
15696,71497816,71503603,True,1,5787
15697,71498681,71499008,True,1,327
15698,71506264,71506642,True,1,378
15699,71514793,71523434,True,2,8641
15700,71519961,71520242,True,4,281
15701,71521085,71521187,True,1,102
15702,71523331,71538771,True,1,15440
15703,71523331,71539691,True,1,16360
15704,71523462,71538854,True,1,15392
15705,71525812,71526264,True,2,452
15706,71525812,71527738,True,1,1926
15707,71526422,71533889,True,1,7467
15708,71534016,71538330,True,1,4314
15709,71534894,71538665,True,2,3771
15710,71546929,71555391,True,1,8462
15711,71546979,71549099,True,1,2120
15712,71548117,71550351,True,1,2234
15713,71554248,71556156,True,1,1908
15714,71566095,71568124,True,4,2029
15715,71567323,71570655,True,1,3332
15716,71582940,71587141,True,1,4201
15717,71585477,71586298,True,2,821
15718,71592316,71592537,True,2,221
15719,71604075,71606922,True,4,2847
15720,71608956,71611135,False,1,2179
15721,71613304,71614902,True,1,1598
15722,71615227,71620036,True,3,4809
15723,71616084,71617180,True,1,1096
15724,71619935,71620048,True,1,113
15725,71626098,71626217,True,1,119
15726,71626952,71642946,True,1,15994
15727,71633129,71636704,True,1,3575
15728,71635516,71635898,False,1,382
15729,71635516,71635898,True,1,382
15730,71638584,71639078,True,1,494
15731,71640204,71642991,True,4,2787
15732,71640224,71643011,True,1,2787
15733,71640967,71646667,True,1,5700
15734,71640967,71649935,True,6,8968
15735,71640967,71702382,True,1,61415
15736,71649572,71649720,True,1,148
15737,71653694,71654250,True,1,556
15738,71657581,71657726,False,1,145
15739,71658537,71659093,True,1,556
15740,71658609,71659093,True,1,484
15741,71659446,71663950,True,1,4504
15742,71659446,71675464,True,1,16018
15743,71677069,71842301,False,1,165232
15744,71681474,71713001,True,2,31527
15745,71681475,71743755,True,1,62280
15746,71699038,71699267,True,1,229
15747,71700014,71720727,True,1,20713
15748,71714137,71717928,False,1,3791
15749,71714137,71717928,True,2,3791
15750,71740846,71742261,True,1,1415
15751,71741981,71742313,True,1,332
15752,71742140,71743440,True,1,1300
15753,71754073,71755179,True,5,1106
15754,71754073,71755538,True,3,1465
15755,71759120,71762100,True,2,2980
15756,71759123,71762100,True,2,2977
15757,71779337,71782578,True,4,3241
15758,71787306,71789183,True,1,1877
15759,71788896,71790841,True,1,1945
15760,71793091,71793993,False,1,902
15761,71799772,71805736,True,2,5964
15762,71803281,71813967,True,1,10686
15763,71809145,71814363,True,2,5218
15764,71810881,71811987,True,1,1106
15765,71819040,71819631,True,1,591
15766,71823407,71830228,False,1,6821
15767,71823407,71830228,True,4,6821
15768,71827377,71834511,True,1,7134
15769,71836139,71843747,False,1,7608
15770,71836139,71845214,True,1,9075
15771,71836139,71847659,True,1,11520
15772,71852008,71854194,False,1,2186
15773,71855976,71857684,True,1,1708
15774,71863975,71868326,True,1,4351
15775,71864504,71872612,True,1,8108
15776,71874898,71880197,True,1,5299
15777,71876015,71881982,False,1,5967
15778,71876015,71881982,True,1,5967
15779,71878483,71879816,True,1,1333
15780,71885947,71890368,True,1,4421
15781,71899912,71919285,False,1,19373
15782,71907770,71908109,False,1,339
15783,71907770,71908935,True,1,1165
15784,71910886,71912208,True,2,1322
15785,71923910,71926343,True,1,2433
15786,71931305,72023262,True,1,91957
15787,71931305,72068812,True,2,137507
15788,71946377,71966692,True,1,20315
15789,71946760,71950697,True,2,3937
15790,71949214,71968161,True,1,18947
15791,71956593,71956837,True,2,244
15792,71976558,71976665,True,1,107
15793,71976558,71977734,True,6,1176
15794,71979282,71979391,True,8,109
15795,71982341,71983895,True,2,1554
15796,71983180,71984168,True,1,988
15797,71988554,71990823,False,2,2269
15798,71988554,71990823,True,4,2269
15799,71991244,71991549,True,1,305
15800,71991503,72015927,True,5,24424
15801,72006300,72009739,True,3,3439
15802,72016453,72025269,True,2,8816
15803,72016453,72025871,False,1,9418
15804,72016453,72025871,True,1,9418
15805,72028703,72029879,True,3,1176
15806,72036755,72058136,True,1,21381
15807,72046743,72054037,False,1,7294
15808,72046876,72047147,True,1,271
15809,72046876,72048098,True,1,1222
15810,72047216,72048098,True,1,882
15811,72048809,72052026,True,1,3217
15812,72064125,72064290,False,1,165
15813,72071194,72073015,True,3,1821
15814,72073219,72073289,True,2,70
15815,72073360,72073927,True,1,567
15816,72074004,72089169,True,4,15165
15817,72075711,72078333,True,1,2622
15818,72078175,72078496,True,1,321
15819,72082639,72082828,True,2,189
15820,72084748,72120010,True,1,35262
15821,72084748,72121263,True,1,36515
15822,72089093,72096847,False,1,7754
15823,72089093,72096847,True,1,7754
15824,72091343,72092181,True,1,838
15825,72093828,72105513,True,3,11685
15826,72093828,72107419,True,1,13591
15827,72093828,72111355,True,1,17527
15828,72098757,72563281,True,1,464524
15829,72101859,72175497,True,1,73638
15830,72102016,72175577,True,1,73561
15831,72104581,72111083,False,1,6502
15832,72120172,72123810,False,1,3638
15833,72130232,72148810,True,1,18578
15834,72134117,72135974,True,3,1857
15835,72137519,72142928,True,1,5409
15836,72173644,72184126,False,1,10482
15837,72182301,72184028,True,1,1727
15838,72192355,72192446,False,1,91
15839,72196738,72197306,False,1,568
15840,72196738,72197306,True,1,568
15841,72207439,72208275,True,1,836
15842,72207621,72208581,True,1,960
15843,72227891,72230531,True,1,2640
15844,72236434,72238197,False,1,1763
15845,72236434,72272541,False,1,36107
15846,72239887,72370584,False,1,130697
15847,72240162,72240399,True,4,237
15848,72252562,72273236,False,1,20674
15849,72265704,72265980,True,3,276
15850,72265704,72266161,True,1,457
15851,72269908,72273518,False,1,3610
15852,72273529,72278582,False,1,5053
15853,72273529,72284522,True,4,10993
15854,72275078,72276750,False,1,1672
15855,72275078,72276750,True,8,1672
15856,72278429,72281257,True,1,2828
15857,72292742,72298447,True,1,5705
15858,72293570,72295537,True,1,1967
15859,72293570,72298595,True,1,5025
15860,72293570,72301792,True,1,8222
15861,72293570,72301849,True,1,8279
15862,72293570,72302011,True,1,8441
15863,72299411,72300364,True,1,953
15864,72299411,72300673,True,1,1262
15865,72304516,72305015,True,3,499
15866,72315512,72317068,True,2,1556
15867,72318436,72322984,True,1,4548
15868,72323996,72324818,True,1,822
15869,72325004,72331693,True,5,6689
15870,72329296,72332621,True,1,3325
15871,72334726,72347703,True,1,12977
15872,72337620,72340506,False,2,2886
15873,72337620,72340506,True,2,2886
15874,72340098,72341305,True,2,1207
15875,72361403,72363782,True,1,2379
15876,72371480,72378735,True,1,7255
15877,72382122,72388398,True,5,6276
15878,72382122,72394915,True,1,12793
15879,72386118,72386575,True,1,457
15880,72387566,72395720,False,1,8154
15881,72387566,72400278,True,1,12712
15882,72388077,72390334,False,1,2257
15883,72388077,72390334,True,4,2257
15884,72399919,72400225,True,2,306
15885,72406910,72407316,False,2,406
15886,72407764,72409252,True,1,1488
15887,72408690,72409757,False,1,1067
15888,72412155,72437026,True,1,24871
15889,72418203,72419289,True,2,1086
15890,72421982,72470039,True,2,48057
15891,72432035,72432616,True,5,581
15892,72460677,72460759,False,1,82
15893,72460677,72460759,True,3,82
15894,72460677,72462073,True,1,1396
15895,72463505,72484482,True,1,20977
15896,72467131,72467481,True,1,350
15897,72467131,72468135,True,2,1004
15898,72468234,72468398,True,1,164
15899,72473094,72473227,False,1,133
15900,72473094,72473227,True,1,133
15901,72473094,72473265,True,1,171
15902,72476525,72481003,False,1,4478
15903,72476677,72497331,True,1,20654
15904,72478920,72482336,True,1,3416
15905,72487714,72487800,True,1,86
15906,72491570,72492529,False,1,959
15907,72492050,72492137,True,1,87
15908,72493836,72500944,True,1,7108
15909,72495540,72498190,False,1,2650
15910,72498170,72499316,True,3,1146
15911,72498902,72500516,True,2,1614
15912,72516422,72519596,False,1,3174
15913,72518532,72524359,False,1,5827
15914,72532982,72534961,True,2,1979
15915,72532982,72535140,True,1,2158
15916,72537130,72537210,True,1,80
15917,72547079,72547160,True,1,81
15918,72547863,72556308,True,1,8445
15919,72559753,72559848,False,1,95
15920,72566887,72575229,True,1,8342
15921,72568074,72569501,False,1,1427
15922,72568074,72569501,True,3,1427
15923,72568702,72570665,True,1,1963
15924,72570406,72570567,True,1,161
15925,72571159,72571320,True,1,161
15926,72571856,72577636,True,1,5780
15927,72582015,72583982,True,1,1967
15928,72590163,72591526,True,2,1363
15929,72591460,72594595,True,1,3135
15930,72591460,72596210,True,1,4750
15931,72596689,72598041,True,1,1352
15932,72610799,72611669,False,1,870
15933,72633820,72638017,True,1,4197
15934,72635712,72740269,True,1,104557
15935,72644002,72644150,False,1,148
15936,72644461,72656647,True,2,12186
15937,72644987,72678135,True,1,33148
15938,72644987,72683712,True,1,38725
15939,72668509,72668620,True,6,111
15940,72670696,72680239,False,1,9543
15941,72670912,72689434,True,1,18522
15942,72676121,72677101,False,1,980
15943,72676121,72677101,True,7,980
15944,72676209,72678718,True,6,2509
15945,72689831,72690312,False,1,481
15946,72691624,72705135,True,3,13511
15947,72691624,72710289,True,1,18665
15948,72695891,72696054,True,3,163
15949,72695891,72697117,True,1,1226
15950,72697856,72702835,True,1,4979
15951,72717979,72726557,True,1,8578
15952,72718312,72719704,True,1,1392
15953,72719085,72719967,True,2,882
15954,72719085,72720049,True,1,964
15955,72721128,72722212,True,1,1084
15956,72721592,72733256,False,1,11664
15957,72729778,72732007,False,1,2229
15958,72730285,72734347,True,5,4062
15959,72746161,72747914,True,1,1753
15960,72757784,72758138,False,1,354
15961,72758656,72759932,True,2,1276
15962,72786919,72787632,True,2,713
15963,72790838,72793420,False,1,2582
15964,72790838,72793420,True,4,2582
15965,72792003,72801115,True,1,9112
15966,72792003,72801327,True,1,9324
15967,72792717,72793146,True,1,429
15968,72793728,72807973,True,2,14245
15969,72795242,72795711,True,1,469
15970,72795242,72838337,True,1,43095
15971,72811493,72811728,True,1,235
15972,72821431,72848370,True,4,26939
15973,72821431,72859880,True,1,38449
15974,72844342,72873088,False,1,28746
15975,72844342,72906950,True,2,62608
15976,72844949,72848670,True,1,3721
15977,72845381,72847392,True,1,2011
15978,72856478,72858331,True,1,1853
15979,72859084,72865304,True,4,6220
15980,72906203,72907401,True,2,1198
15981,72925359,72926154,True,3,795
15982,72968906,72970624,True,1,1718
15983,72988423,72988514,True,5,91
15984,73000476,73001488,True,3,1012
15985,73000615,73001627,True,1,1012
15986,73003138,73003495,True,1,357
15987,73010898,73013122,True,1,2224
15988,73012675,73013368,True,2,693
15989,73016921,73025598,False,1,8677
15990,73016921,73025598,True,2,8677
15991,73017516,73019415,True,2,1899
15992,73052380,73056109,False,1,3729
15993,73052380,73056109,True,2,3729
15994,73052380,73056232,True,1,3852
15995,73063371,73091533,True,1,28162
15996,73074094,73078693,False,1,4599
15997,73074476,73077889,True,6,3413
15998,73079523,73172956,False,1,93433
15999,73091832,73095462,True,4,3630
16000,73099425,73100144,True,1,719
16001,73100055,73100413,True,1,358
16002,73105280,73105281,True,1,1
16003,73105534,73114191,True,2,8657
16004,73109168,73111295,True,1,2127
16005,73124347,73126625,False,1,2278
16006,73124347,73126625,True,2,2278
16007,73125931,73126492,True,1,561
16008,73125931,73126637,True,1,706
16009,73145862,73154497,True,8,8635
16010,73145862,73162389,False,1,16527
16011,73145862,73162389,True,2,16527
16012,73164015,73164120,False,1,105
16013,73167135,73207124,True,1,39989
16014,73169511,73199063,True,1,29552
16015,73173020,73173020,True,2,0
16016,73173133,73176530,True,1,3397
16017,73179234,73184401,True,1,5167
16018,73187377,73188874,True,1,1497
16019,73204439,73205764,True,1,1325
16020,73205092,73205564,True,6,472
16021,73205092,73217105,False,1,12013
16022,73209329,73209525,False,1,196
16023,73209329,73209525,True,1,196
16024,73210477,73227923,True,1,17446
16025,73212463,73212828,True,1,365
16026,73213293,73214885,True,3,1592
16027,73217136,73237980,True,1,20844
16028,73223463,73236197,True,2,12734
16029,73228852,73231492,True,1,2640
16030,73229237,73229847,True,2,610
16031,73229237,73233142,True,1,3905
16032,73232184,73247671,False,1,15487
16033,73232184,73247671,True,2,15487
16034,73232233,73247671,False,1,15438
16035,73232233,73247671,True,2,15438
16036,73232353,73247671,False,1,15318
16037,73232353,73247671,True,2,15318
16038,73232786,73247950,True,1,15164
16039,73243866,73258372,True,3,14506
16040,73245979,73247790,True,1,1811
16041,73246580,73249638,True,3,3058
16042,73261976,73262814,True,2,838
16043,73261976,73262817,True,1,841
16044,73262195,73262928,True,1,733
16045,73274927,73275204,False,1,277
16046,73276292,73277027,True,1,735
16047,73283759,73284185,True,1,426
16048,73283964,73286663,False,1,2699
16049,73283964,73286663,True,1,2699
16050,73286244,73286541,True,1,297
16051,73288537,73289913,True,1,1376
16052,73288537,73296108,True,1,7571
16053,73291297,73297459,True,1,6162
16054,73293030,73298327,True,1,5297
16055,73293202,73298358,True,1,5156
16056,73298381,73298998,True,1,617
16057,73298381,73300058,True,2,1677
16058,73298381,73300097,False,1,1716
16059,73298381,73300097,True,3,1716
16060,73298381,73306756,True,1,8375
16061,73324447,73330782,True,1,6335
16062,73331319,73337626,True,1,6307
16063,73347821,73358319,True,3,10498
16064,73356153,73357459,True,1,1306
16065,73371786,73378605,True,1,6819
16066,73375924,73386314,True,1,10390
16067,73380122,73380586,True,1,464
16068,73380122,73414997,True,1,34875
16069,73389128,73412596,False,1,23468
16070,73392482,73393067,True,1,585
16071,73396889,73397574,True,2,685
16072,73408811,73429328,True,1,20517
16073,73411560,73425151,True,1,13591
16074,73411601,73414525,True,1,2924
16075,73411601,73425151,True,1,13550
16076,73416283,73416596,True,1,313
16077,73418817,73420018,True,4,1201
16078,73436262,73436759,True,1,497
16079,73442245,73443688,True,1,1443
16080,73461462,73463803,True,1,2341
16081,73485535,73487010,True,2,1475
16082,73489895,73579061,False,1,89166
16083,73510924,73513411,True,1,2487
16084,73515634,73516356,True,4,722
16085,73519125,73520234,True,1,1109
16086,73533137,73534162,True,1,1025
16087,73536156,73537752,True,1,1596
16088,73536159,73537752,True,3,1593
16089,73544018,73544190,True,1,172
16090,73545593,73545823,False,1,230
16091,73545593,73545823,True,1,230
16092,73549047,73550112,True,1,1065
16093,73559725,73562227,True,4,2502
16094,73569436,73569530,True,1,94
16095,73575640,73580977,False,1,5337
16096,73575640,73902307,False,2,326667
16097,73575957,73576201,True,2,244
16098,73602696,73623919,True,4,21223
16099,73604938,73605666,False,1,728
16100,73608186,73610819,False,1,2633
16101,73610340,73627652,True,3,17312
16102,73612798,73614187,True,3,1389
16103,73614279,73614689,True,1,410
16104,73616465,73616724,False,1,259
16105,73622279,73622817,False,1,538
16106,73646414,73646965,True,1,551
16107,73657846,73676689,True,2,18843
16108,73679163,73685368,False,3,6205
16109,73679163,73685368,True,7,6205
16110,73679163,73720529,True,2,41366
16111,73679163,73761880,True,2,82717
16112,73679163,73805074,True,1,125911
16113,73679163,73841173,False,1,162010
16114,73679388,73686427,True,1,7039
16115,73681051,73684166,True,1,3115
16116,73681051,73684559,True,3,3508
16117,73707443,73715917,True,2,8474
16118,73707443,73720839,True,1,13396
16119,73708133,73709504,True,1,1371
16120,73709590,73711797,True,1,2207
16121,73718784,73722396,True,1,3612
16122,73723866,73725073,True,3,1207
16123,73727056,73735870,False,1,8814
16124,73727056,73735870,True,1,8814
16125,73738173,73739360,True,1,1187
16126,73743945,73745547,True,1,1602
16127,73743973,73808288,True,1,64315
16128,73750671,73750836,True,1,165
16129,73753903,73755032,True,1,1129
16130,73754140,73830578,True,2,76438
16131,73754543,73762054,True,5,7511
16132,73767362,73768096,True,1,734
16133,73767872,73779340,True,1,11468
16134,73769546,73772910,True,3,3364
16135,73772292,73773825,True,1,1533
16136,73773168,73773520,True,1,352
16137,73774213,73819898,True,1,45685
16138,73774213,73823571,True,1,49358
16139,73777334,73806003,True,1,28669
16140,73782002,73782490,True,1,488
16141,73787866,73793772,False,1,5906
16142,73787866,73793772,True,6,5906
16143,73787976,73791301,True,1,3325
16144,73800894,73803556,True,1,2662
16145,73813943,73814444,True,4,501
16146,73818083,73818402,True,1,319
16147,73832218,73838492,True,1,6274
16148,73841211,73855356,False,1,14145
16149,73841211,73860202,False,1,18991
16150,73842887,73843147,True,1,260
16151,73844915,73849127,True,2,4212
16152,73847948,73867326,True,6,19378
16153,73847967,73848630,True,1,663
16154,73858562,73858886,True,1,324
16155,73863444,73863863,True,1,419
16156,73864071,73864472,True,1,401
16157,73864152,73864472,True,1,320
16158,73864555,73865074,True,1,519
16159,73865306,73868518,True,1,3212
16160,73865665,73869282,True,1,3617
16161,73872660,73873723,False,1,1063
16162,73872660,73873723,True,2,1063
16163,73875391,73875681,True,2,290
16164,73876923,73899831,True,4,22908
16165,73876923,73903469,True,2,26546
16166,73885579,73886366,False,1,787
16167,73885579,73888667,False,1,3088
16168,73885579,73888667,True,1,3088
16169,73915145,73915637,True,2,492
16170,73917848,73919313,True,1,1465
16171,73918066,73921500,False,1,3434
16172,73923270,73923808,True,1,538
16173,73926246,73928970,False,1,2724
16174,73947083,73950030,True,5,2947
16175,73949856,73952762,True,1,2906
16176,73962341,73962536,True,1,195
16177,73972828,73973791,True,3,963
16178,73977404,73979367,False,1,1963
16179,73979463,73982883,True,1,3420
16180,73982939,73984732,True,1,1793
16181,74005417,74009112,False,2,3695
16182,74005417,74017636,False,1,12219
16183,74005417,74023275,True,1,17858
16184,74008189,74009774,True,1,1585
16185,74008189,74010518,True,1,2329
16186,74008189,74017643,True,1,9454
16187,74008189,74017662,True,1,9473
16188,74011569,74012824,True,1,1255
16189,74012269,74013134,True,1,865
16190,74012269,74013137,True,1,868
16191,74012787,74012933,True,1,146
16192,74013274,74013576,False,1,302
16193,74013274,74013576,True,1,302
16194,74013274,74013579,True,1,305
16195,74015336,74015624,True,1,288
16196,74052622,74060448,True,4,7826
16197,74069628,74078410,False,1,8782
16198,74069994,74072948,True,2,2954
16199,74069994,74077284,True,1,7290
16200,74070648,74073375,True,4,2727
16201,74070648,74073380,True,1,2732
16202,74073740,74077293,True,1,3553
16203,74073740,74080086,True,3,6346
16204,74098785,74098889,False,5,104
16205,74099884,74100651,True,1,767
16206,74103032,74103510,True,1,478
16207,74107091,74109422,True,3,2331
16208,74107091,74115300,True,1,8209
16209,74107091,74120627,True,1,13536
16210,74111957,74114917,True,1,2960
16211,74128398,74129692,False,1,1294
16212,74134625,74137400,False,1,2775
16213,74134625,74137400,True,2,2775
16214,74141608,74141695,True,2,87
16215,74144760,74151669,False,1,6909
16216,74150951,74151403,False,1,452
16217,74151593,74152630,False,2,1037
16218,74152669,74154199,False,1,1530
16219,74152669,74154273,False,1,1604
16220,74160425,74166555,False,1,6130
16221,74163564,74164088,False,1,524
16222,74167580,74172766,False,1,5186
16223,74167580,74175733,False,1,8153
16224,74183329,74188077,False,2,4748
16225,74186227,74187508,True,1,1281
16226,74189568,74190016,True,4,448
16227,74192066,74194170,True,1,2104
16228,74192455,74194658,True,2,2203
16229,74199999,74216921,False,1,16922
16230,74200276,74200871,True,1,595
16231,74203197,74218529,True,3,15332
16232,74214209,74214722,False,2,513
16233,74214209,74214722,True,4,513
16234,74234306,74238616,True,1,4310
16235,74241088,74246775,True,1,5687
16236,74241088,74422651,True,1,181563
16237,74241135,74246818,True,1,5683
16238,74241374,74242196,True,1,822
16239,74241374,74246908,True,1,5534
16240,74241523,74246939,True,1,5416
16241,74243347,74247693,True,1,4346
16242,74253877,74257672,True,1,3795
16243,74259227,74262976,True,2,3749
16244,74259227,74275630,True,1,16403
16245,74270411,74270862,False,1,451
16246,74275570,74282552,True,1,6982
16247,74276354,74276468,True,1,114
16248,74280802,74281002,True,1,200
16249,74294814,74296990,True,1,2176
16250,74297049,74300156,True,1,3107
16251,74308698,74313191,True,2,4493
16252,74314334,74316434,True,1,2100
16253,74315490,74317586,False,1,2096
16254,74326409,74326825,True,1,416
16255,74337211,74340162,False,1,2951
16256,74338555,74339033,True,1,478
16257,74357117,74358826,True,1,1709
16258,74357117,74358830,True,1,1713
16259,74357117,74364231,True,1,7114
16260,74360701,74383588,True,1,22887
16261,74360725,74362925,True,1,2200
16262,74360725,74366153,True,1,5428
16263,74360725,74405295,True,1,44570
16264,74366662,74367749,True,1,1087
16265,74367881,74370137,True,6,2256
16266,74367881,74370571,True,6,2690
16267,74372234,74410754,True,1,38520
16268,74374848,74376579,False,1,1731
16269,74389220,74397868,True,1,8648
16270,74393706,74406432,True,2,12726
16271,74417089,74423939,True,2,6850
16272,74417175,74454377,True,1,37202
16273,74417175,74473987,True,2,56812
16274,74417304,74454432,True,1,37128
16275,74417304,74474042,True,1,56738
16276,74419854,74424507,True,1,4653
16277,74426683,74432944,False,1,6261
16278,74434783,74437015,True,1,2232
16279,74443767,74445662,False,4,1895
16280,74443767,74445662,True,2,1895
16281,74451296,74462915,False,1,11619
16282,74451296,74462915,True,1,11619
16283,74461298,74482576,True,1,21278
16284,74470491,74475482,True,1,4991
16285,74476085,74486922,True,1,10837
16286,74476085,74487584,True,1,11499
16287,74491793,74508803,False,1,17010
16288,74493529,74574245,True,1,80716
16289,74496369,74517089,True,1,20720
16290,74514274,74517114,True,2,2840
16291,74528267,74530342,True,1,2075
16292,74528773,74531713,True,1,2940
16293,74541056,74541921,True,1,865
16294,74547582,74554341,True,2,6759
16295,74569794,74577565,True,5,7771
16296,74577164,74580554,False,1,3390
16297,74577164,74581227,False,2,4063
16298,74584080,74584919,True,3,839
16299,74619393,74627750,True,1,8357
16300,74620239,74623408,True,4,3169
16301,74623306,74627103,True,2,3797
16302,74626341,74629988,True,1,3647
16303,74636402,74637361,True,1,959
16304,74640347,74641135,False,1,788
16305,74643798,74649967,True,3,6169
16306,74647345,74651085,True,1,3740
16307,74661618,74663309,True,2,1691
16308,74666821,74666898,True,4,77
16309,74667176,74667623,True,2,447
16310,74682153,74683783,True,1,1630
16311,74682676,74683887,True,1,1211
16312,74683647,74684507,False,1,860
16313,74683647,74684507,True,2,860
16314,74685177,74685282,True,2,105
16315,74685573,74685792,True,1,219
16316,74694383,74700531,True,1,6148
16317,74706861,74709197,True,1,2336
16318,74713137,74713999,True,1,862
16319,74722842,74723717,False,1,875
16320,74735437,74736034,True,2,597
16321,74754592,74755747,True,1,1155
16322,74758905,74759000,True,2,95
16323,74762398,74777854,True,2,15456
16324,74774476,74774679,True,2,203
16325,74787432,74792901,True,1,5469
16326,74790170,74793537,False,1,3367
16327,74790170,74793537,True,1,3367
16328,74795273,74795580,True,1,307
16329,74802059,74804304,True,2,2245
16330,74814265,74821076,True,3,6811
16331,74814723,74815709,True,7,986
16332,74815096,74815219,False,1,123
16333,74815096,74815219,True,1,123
16334,74815389,74817286,True,2,1897
16335,74826716,74829322,True,2,2606
16336,74829720,74833603,True,2,3883
16337,74831309,74833917,False,1,2608
16338,74831309,74833981,False,2,2672
16339,74831309,74838788,False,1,7479
16340,74831309,74839276,False,1,7967
16341,74831497,74835473,True,1,3976
16342,74831497,74835913,True,1,4416
16343,74831703,74835581,True,1,3878
16344,74831703,74836021,True,1,4318
16345,74832235,74833859,True,3,1624
16346,74841923,74846521,True,3,4598
16347,74842973,74863243,False,1,20270
16348,74845482,74847520,False,1,2038
16349,74845482,74847520,True,2,2038
16350,74845536,74847546,True,1,2010
16351,74847297,74849269,True,1,1972
16352,74847297,74850479,True,1,3182
16353,74855660,74865870,False,1,10210
16354,74855660,74868765,False,1,13105
16355,74857820,74858699,True,1,879
16356,74858367,74859040,True,2,673
16357,74862517,74945760,True,2,83243
16358,74868782,74892331,False,1,23549
16359,74868782,74898813,True,2,30031
16360,74876265,74893494,False,1,17229
16361,74880651,74903309,True,1,22658
16362,74882117,74893594,True,2,11477
16363,74884722,74889116,False,1,4394
16364,74884986,74885530,True,3,544
16365,74895767,74896916,True,3,1149
16366,74901761,74903280,True,1,1519
16367,74911213,75015198,True,1,103985
16368,74917676,74918020,False,1,344
16369,74917676,74918020,True,4,344
16370,74923756,74924342,True,2,586
16371,74928769,74929434,True,2,665
16372,74937500,74938496,False,1,996
16373,74958138,74958990,True,1,852
16374,74960423,74960744,True,1,321
16375,74964702,74969171,True,1,4469
16376,74967876,74970528,True,1,2652
16377,74972064,74972642,True,3,578
16378,74972952,74974007,True,1,1055
16379,74987862,75006308,True,2,18446
16380,74991540,74994231,True,1,2691
16381,75009436,75010047,False,1,611
16382,75009436,75022616,False,1,13180
16383,75015041,75017383,True,1,2342
16384,75023606,75026787,True,3,3181
16385,75027937,75032245,False,1,4308
16386,75046767,75050301,True,1,3534
16387,75048101,75050556,False,1,2455
16388,75048101,75050556,True,2,2455
16389,75073729,75073842,True,1,113
16390,75074174,75108371,True,1,34197
16391,75090591,75098669,True,1,8078
16392,75107040,75107961,True,1,921
16393,75110522,75125554,True,2,15032
16394,75122103,75127374,True,1,5271
16395,75127511,75131814,True,2,4303
16396,75138853,75140626,True,1,1773
16397,75143746,75151682,True,1,7936
16398,75149636,75150561,False,1,925
16399,75149636,75151085,True,1,1449
16400,75150610,75159772,False,1,9162
16401,75153112,75154395,False,1,1283
16402,75153112,75154395,True,1,1283
16403,75154980,75157461,True,2,2481
16404,75167396,75168137,True,3,741
16405,75167396,75169777,True,6,2381
16406,75167889,75168675,False,1,786
16407,75171864,75176320,True,1,4456
16408,75177340,75180659,True,1,3319
16409,75177340,75180716,True,1,3376
16410,75177340,75180818,True,1,3478
16411,75182030,75188702,True,4,6672
16412,75185260,75225426,True,1,40166
16413,75186594,75187173,True,1,579
16414,75188292,75189520,True,3,1228
16415,75188721,75189620,True,2,899
16416,75194006,75194995,True,1,989
16417,75196015,75196160,True,1,145
16418,75205518,75206262,True,1,744
16419,75206122,75208827,True,1,2705
16420,75206122,75210107,True,1,3985
16421,75210779,75211001,True,1,222
16422,75227219,75245260,True,1,18041
16423,75236320,75237158,True,1,838
16424,75237108,75244868,True,2,7760
16425,75237108,75244871,True,1,7763
16426,75240376,75243142,True,1,2766
16427,75243388,75244018,True,1,630
16428,75278644,75280608,False,1,1964
16429,75278644,75280608,True,1,1964
16430,75278644,75282010,True,1,3366
16431,75285508,75287765,True,3,2257
16432,75285595,75293968,True,1,8373
16433,75293320,75296570,False,1,3250
16434,75302142,75343684,True,1,41542
16435,75309452,75326812,True,3,17360
16436,75334426,75348550,True,2,14124
16437,75334426,75355873,True,1,21447
16438,75334426,75364046,True,1,29620
16439,75334426,75383423,False,1,48997
16440,75334426,75383423,True,1,48997
16441,75334426,75421638,True,1,87212
16442,75336591,75360634,True,1,24043
16443,75350626,75353041,True,1,2415
16444,75353553,75353722,True,1,169
16445,75357123,75367135,True,1,10012
16446,75357123,75367154,True,3,10031
16447,75385087,75398428,True,1,13341
16448,75397992,75398367,True,1,375
16449,75404128,75405767,True,1,1639
16450,75418003,75424545,True,1,6542
16451,75418415,75419360,True,1,945
16452,75431320,75434705,True,1,3385
16453,75431379,75433888,True,1,2509
16454,75434943,75438674,True,1,3731
16455,75437095,75444400,True,3,7305
16456,75446884,75448439,False,1,1555
16457,75451880,75452628,True,1,748
16458,75451880,75455865,True,1,3985
16459,75485911,75489626,False,1,3715
16460,75496710,75497394,False,1,684
16461,75507650,75515699,False,1,8049
16462,75507650,75515699,True,5,8049
16463,75513827,75514554,False,1,727
16464,75515437,75516044,True,1,607
16465,75522877,75523999,True,1,1122
16466,75535531,75535795,False,1,264
16467,75536035,75577805,True,1,41770
16468,75560587,75561691,True,1,1104
16469,75560587,75563619,True,1,3032
16470,75566902,75568597,True,2,1695
16471,75569625,75570171,True,1,546
16472,75569709,75570171,True,1,462
16473,75575098,75685039,True,1,109941
16474,75580451,75589874,False,1,9423
16475,75583803,75584388,True,1,585
16476,75586816,75603064,False,1,16248
16477,75586816,75603064,True,4,16248
16478,75601194,75619833,True,1,18639
16479,75602191,75620072,True,1,17881
16480,75607952,75618171,False,1,10219
16481,75617900,75621897,True,1,3997
16482,75618761,75619082,True,1,321
16483,75629015,75636888,True,1,7873
16484,75629015,75647524,True,2,18509
16485,75629015,75647602,True,3,18587
16486,75642270,75643294,True,1,1024
16487,75643320,75643565,True,1,245
16488,75648556,75650113,True,1,1557
16489,75649635,75650585,True,1,950
16490,75651263,75651648,True,4,385
16491,75651263,75651679,True,1,416
16492,75651263,75663669,True,1,12406
16493,75656493,75656676,False,1,183
16494,75656493,75656676,True,3,183
16495,75656493,75668222,True,1,11729
16496,75656716,75659865,True,3,3149
16497,75666993,75671582,True,1,4589
16498,75666993,75682589,True,1,15596
16499,75666993,75684710,True,1,17717
16500,75666993,75715578,True,2,48585
16501,75674592,75675288,True,1,696
16502,75681214,75712991,False,1,31777
16503,75685884,75686611,False,1,727
16504,75688923,75689339,False,1,416
16505,75688923,75689339,True,3,416
16506,75697704,75709836,False,1,12132
16507,75709755,75714819,True,1,5064
16508,75712817,75719494,True,4,6677
16509,75712817,75724432,True,1,11615
16510,75724186,75727116,False,1,2930
16511,75724186,75727116,True,3,2930
16512,75731167,75733579,True,3,2412
16513,75731755,75756085,True,1,24330
16514,75731755,75758619,True,1,26864
16515,75742989,75767591,True,1,24602
16516,75742989,75768226,True,1,25237
16517,75742989,75768250,True,1,25261
16518,75742989,75768518,True,1,25529
16519,75747894,75748327,True,1,433
16520,75750918,75751615,False,1,697
16521,75758316,75759084,False,2,768
16522,75771266,75771344,True,1,78
16523,75773318,75773647,True,5,329
16524,75776182,75787417,True,1,11235
16525,75776255,75802616,True,1,26361
16526,75776528,75776622,True,1,94
16527,75785673,75796326,True,2,10653
16528,75786047,75806250,True,1,20203
16529,75788547,75792664,True,1,4117
16530,75789220,75793078,True,1,3858
16531,75790200,75793526,True,1,3326
16532,75792653,75794722,True,1,2069
16533,75797213,75797321,True,1,108
16534,75807380,75818827,True,2,11447
16535,75807380,75837866,True,1,30486
16536,75807437,75892214,True,2,84777
16537,75807639,75925920,True,1,118281
16538,75835895,75864524,True,1,28629
16539,75836713,75847869,False,1,11156
16540,75836713,75847869,True,11,11156
16541,75836713,75858476,True,1,21763
16542,75836713,75861634,True,1,24921
16543,75836713,75862891,True,1,26178
16544,75836713,75899605,True,1,62892
16545,75841992,75842445,False,1,453
16546,75880348,75881176,True,1,828
16547,75891780,75892950,True,1,1170
16548,75892800,75894751,True,1,1951
16549,75913065,75918547,True,1,5482
16550,75914975,75922963,True,1,7988
16551,75915268,75917044,False,3,1776
16552,75915268,75917044,True,3,1776
16553,75917501,75919050,True,1,1549
16554,75920440,75921185,True,1,745
16555,75920440,75926762,True,1,6322
16556,75920972,75948602,True,1,27630
16557,75920972,75949962,True,1,28990
16558,75921973,75949360,True,1,27387
16559,75926266,75926904,True,2,638
16560,75926967,75927204,True,2,237
16561,75932671,75932833,True,1,162
16562,75958179,75995157,True,1,36978
16563,75995708,75997005,True,1,1297
16564,75995832,75997048,True,1,1216
16565,75996328,75997284,True,1,956
16566,76002121,76002955,True,1,834
16567,76003662,76005805,False,1,2143
16568,76003662,76005805,True,1,2143
16569,76009390,76014675,True,4,5285
16570,76010409,76014084,True,1,3675
16571,76017734,76022300,True,3,4566
16572,76017734,76024734,True,1,7000
16573,76042196,76048156,False,1,5960
16574,76042196,76048156,True,1,5960
16575,76042196,76050319,False,1,8123
16576,76045195,76045721,True,2,526
16577,76049113,76049254,True,1,141
16578,76049113,76051399,True,1,2286
16579,76059258,76064605,True,1,5347
16580,76061520,76065715,False,1,4195
16581,76064607,76064910,True,1,303
16582,76065020,76065684,True,1,664
16583,76068762,76084309,True,1,15547
16584,76068762,76099133,True,1,30371
16585,76070300,76070464,True,1,164
16586,76070909,76072187,True,3,1278
16587,76070909,76072435,True,1,1526
16588,76071600,76072871,True,1,1271
16589,76073567,76073771,True,1,204
16590,76076809,76077470,False,1,661
16591,76079907,76081612,False,1,1705
16592,76079907,76096781,False,1,16874
16593,76084185,76089850,True,1,5665
16594,76084839,76099203,False,1,14364
16595,76084839,76103022,False,1,18183
16596,76084839,76131547,True,1,46708
16597,76092746,76120553,True,1,27807
16598,76098335,76098489,True,2,154
16599,76098709,76105480,True,1,6771
16600,76108410,76109463,False,1,1053
16601,76110099,76116296,True,1,6197
16602,76112347,76130024,True,2,17677
16603,76120672,76122035,True,1,1363
16604,76120672,76122860,True,1,2188
16605,76122064,76122524,False,2,460
16606,76122064,76122524,True,7,460
16607,76130956,76187404,True,1,56448
16608,76143330,76144603,True,1,1273
16609,76144211,76153456,True,3,9245
16610,76154298,76154369,True,4,71
16611,76156233,76156658,False,1,425
16612,76156233,76156658,True,2,425
16613,76161021,76171708,False,1,10687
16614,76161822,76167727,True,3,5905
16615,76164825,76166258,False,1,1433
16616,76164825,76166258,True,3,1433
16617,76171726,76175005,True,2,3279
16618,76178385,76179511,True,2,1126
16619,76179132,76179973,True,1,841
16620,76181236,76182414,True,1,1178
16621,76183317,76210604,True,1,27287
16622,76184381,76184520,False,1,139
16623,76186090,76186587,True,1,497
16624,76187297,76190905,True,2,3608
16625,76195528,76197910,True,1,2382
16626,76208363,76209401,False,1,1038
16627,76208363,76209401,True,1,1038
16628,76209730,76211601,True,1,1871
16629,76218177,76219026,False,1,849
16630,76224156,76229130,True,1,4974
16631,76227244,76230851,True,1,3607
16632,76237932,76239643,True,2,1711
16633,76238563,76241159,True,1,2596
16634,76239736,76244235,True,2,4499
16635,76242771,76244306,True,2,1535
16636,76243303,76248155,True,1,4852
16637,76244064,76244421,True,1,357
16638,76244724,76245914,True,1,1190
16639,76249406,76249910,True,1,504
16640,76249906,76252029,True,3,2123
16641,76250594,76257552,True,4,6958
16642,76257507,76261059,False,2,3552
16643,76257507,76261059,True,1,3552
16644,76265960,76266372,True,4,412
16645,76270353,76271463,True,1,1110
16646,76274225,76275372,True,5,1147
16647,76274431,76277798,False,1,3367
16648,76274463,76277565,True,1,3102
16649,76274542,76277712,True,1,3170
16650,76276287,76276730,False,1,443
16651,76277352,76282090,True,2,4738
16652,76277352,76282534,True,1,5182
16653,76279184,76296519,False,1,17335
16654,76279184,76296519,True,4,17335
16655,76284667,76290017,True,2,5350
16656,76290199,76290813,True,1,614
16657,76296073,76296230,False,1,157
16658,76296073,76296230,True,3,157
16659,76304068,76307272,True,1,3204
16660,76305029,76308864,True,2,3835
16661,76306861,76307361,True,1,500
16662,76307764,76308778,True,2,1014
16663,76311980,76312304,True,1,324
16664,76313241,76314743,False,1,1502
16665,76316322,76316418,True,1,96
16666,76316528,76316647,True,1,119
16667,76317230,76320105,True,1,2875
16668,76317635,76317828,True,1,193
16669,76320106,76325817,True,1,5711
16670,76320106,76335999,True,1,15893
16671,76328813,76331254,True,2,2441
16672,76343380,76343555,True,4,175
16673,76343711,76344097,True,1,386
16674,76343711,76344349,True,1,638
16675,76349490,76350345,True,1,855
16676,76351247,76351385,False,1,138
16677,76351247,76351385,True,8,138
16678,76355156,76367709,False,1,12553
16679,76355333,76355969,True,1,636
16680,76355333,76378776,True,1,23443
16681,76356514,76356852,True,1,338
16682,76359031,76361790,True,1,2759
16683,76359254,76359960,False,2,706
16684,76359321,76359953,False,2,632
16685,76360487,76361321,True,4,834
16686,76360487,76361845,True,1,1358
16687,76360487,76362214,True,1,1727
16688,76365803,76365976,True,1,173
16689,76366395,76366742,True,1,347
16690,76377916,76378208,True,3,292
16691,76378059,76386076,True,2,8017
16692,76378817,76378954,True,1,137
16693,76408081,76409865,True,1,1784
16694,76408081,76409943,True,1,1862
16695,76414462,76431517,True,3,17055
16696,76422134,76423970,True,1,1836
16697,76422140,76422391,True,2,251
16698,76422534,76423947,True,4,1413
16699,76423761,76438277,True,1,14516
16700,76435829,76464853,True,1,29024
16701,76436377,76448605,True,1,12228
16702,76437149,76448888,True,1,11739
16703,76438412,76449510,True,3,11098
16704,76439160,76440116,True,1,956
16705,76453699,76454399,True,1,700
16706,76453721,76454282,True,1,561
16707,76454885,76455503,True,2,618
16708,76455006,76455970,True,2,964
16709,76460297,76478316,True,1,18019
16710,76460297,76489845,True,4,29548
16711,76460297,76491404,True,1,31107
16712,76480917,76481415,True,2,498
16713,76483362,76506060,True,1,22698
16714,76488044,76489424,True,5,1380
16715,76489348,76490114,True,1,766
16716,76490867,76491398,True,2,531
16717,76491557,76492772,True,1,1215
16718,76498571,76499199,False,1,628
16719,76498571,76499199,True,1,628
16720,76500539,76501350,True,1,811
16721,76517463,76596130,True,2,78667
16722,76520177,76521180,True,2,1003
16723,76522677,76526396,True,1,3719
16724,76529031,76529971,False,1,940
16725,76529031,76529971,True,1,940
16726,76538282,76538585,True,1,303
16727,76539977,76540089,False,1,112
16728,76539977,76540089,True,9,112
16729,76547450,76547673,True,1,223
16730,76547583,76547673,True,1,90
16731,76554002,76562567,False,1,8565
16732,76554303,76556363,False,1,2060
16733,76554303,76556363,True,1,2060
16734,76554309,76559081,True,1,4772
16735,76556476,76558327,True,1,1851
16736,76557802,76558325,True,1,523
16737,76558624,76561190,True,1,2566
16738,76558947,76561207,True,3,2260
16739,76559082,76561883,True,1,2801
16740,76563067,76564488,True,2,1421
16741,76565073,76566393,False,1,1320
16742,76565094,76567931,True,1,2837
16743,76567402,76569076,False,1,1674
16744,76575090,76575538,True,1,448
16745,76576180,76577172,True,1,992
16746,76577999,76584762,False,1,6763
16747,76578016,76584779,False,3,6763
16748,76593198,76596232,True,1,3034
16749,76593538,76593964,True,3,426
16750,76599074,76601013,True,5,1939
16751,76599288,76600801,True,11,1513
16752,76599288,76605374,True,1,6086
16753,76604729,76610111,True,1,5382
16754,76605283,76611297,True,1,6014
16755,76610228,76618135,False,4,7907
16756,76610228,76636263,False,1,26035
16757,76611682,76611956,True,1,274
16758,76615026,76623058,False,1,8032
16759,76615026,76623058,True,2,8032
16760,76616391,76618185,False,2,1794
16761,76629719,76630069,True,1,350
16762,76647618,76671304,True,1,23686
16763,76654470,76656350,True,2,1880
16764,76654470,76664968,True,1,10498
16765,76668874,76672107,True,1,3233
16766,76679309,76679478,True,2,169
16767,76679491,76680940,False,1,1449
16768,76685572,76685833,False,1,261
16769,76690019,76690247,True,1,228
16770,76695477,76696187,False,1,710
16771,76695477,76696187,True,2,710
16772,76699487,76702451,False,1,2964
16773,76699487,76702451,True,2,2964
16774,76716578,76716897,False,1,319
16775,76733879,76736483,True,1,2604
16776,76738508,76742276,True,1,3768
16777,76738523,76742190,True,2,3667
16778,76740201,76740325,True,1,124
16779,76740201,76744257,False,1,4056
16780,76751317,76788214,True,3,36897
16781,76751317,76792358,True,1,41041
16782,76751377,76788249,True,2,36872
16783,76752213,76788682,True,1,36469
16784,76756387,76757661,True,2,1274
16785,76756982,76758904,True,2,1922
16786,76758038,76759317,True,1,1279
16787,76758879,76759348,True,1,469
16788,76762577,76766797,False,1,4220
16789,76766681,76767120,True,1,439
16790,76766681,76767727,True,2,1046
16791,76776666,76778289,True,2,1623
16792,76777976,76778091,True,1,115
16793,76785464,76788395,True,1,2931
16794,76791936,76800569,True,1,8633
16795,76795865,76917594,True,1,121729
16796,76795957,76796070,True,1,113
16797,76800023,76801839,False,1,1816
16798,76802735,76804051,False,1,1316
16799,76803728,76806255,True,1,2527
16800,76805235,76805345,True,1,110
16801,76807626,76809859,True,1,2233
16802,76807626,76816237,True,1,8611
16803,76815738,76817910,True,1,2172
16804,76841610,76842937,True,1,1327
16805,76841610,76926243,True,1,84633
16806,76841610,76946103,True,1,104493
16807,76846586,76848441,True,2,1855
16808,76847822,76852699,True,3,4877
16809,76862966,76864951,False,1,1985
16810,76862966,76864951,True,1,1985
16811,76865744,76866743,False,1,999
16812,76875675,76877223,True,3,1548
16813,76888487,76889803,True,1,1316
16814,76891234,76905115,True,1,13881
16815,76891234,76926260,True,1,35026
16816,76891347,76905119,True,1,13772
16817,76891347,76926264,True,1,34917
16818,76891381,76893978,True,1,2597
16819,76906704,76907019,True,1,315
16820,76906757,76907019,True,1,262
16821,76906855,76907019,True,1,164
16822,76907609,76908991,True,1,1382
16823,76911877,76914791,True,1,2914
16824,76917790,76918220,True,2,430
16825,76925672,76925795,True,2,123
16826,76925804,76926623,True,1,819
16827,76927212,76928052,True,1,840
16828,76929486,76931425,False,1,1939
16829,76930960,76952529,True,1,21569
16830,76948854,76950988,True,1,2134
16831,76949172,76961579,True,2,12407
16832,76956920,76960412,False,1,3492
16833,76956920,76960412,True,1,3492
16834,76956920,76961721,True,1,4801
16835,76957384,76957753,True,2,369
16836,76960783,76974152,True,1,13369
16837,76962277,76962586,True,1,309
16838,76962277,76963142,False,1,865
16839,76974756,76991674,True,1,16918
16840,76987233,76988509,False,1,1276
16841,76991654,77014565,True,2,22911
16842,76995506,77002205,True,1,6699
16843,76997389,77002836,True,1,5447
16844,77015813,77016010,True,5,197
16845,77017094,77018002,False,1,908
16846,77034295,77036239,True,1,1944
16847,77045283,77047312,True,3,2029
16848,77045760,77045854,True,2,94
16849,77045760,77047312,True,1,1552
16850,77046613,77047422,True,1,809
16851,77058164,77060955,True,1,2791
16852,77075783,77076094,True,3,311
16853,77075783,77076880,False,1,1097
16854,77075783,77076880,True,4,1097
16855,77075783,77080606,True,1,4823
16856,77082124,77082872,False,2,748
16857,77086595,77086691,True,1,96
16858,77090469,77136623,True,1,46154
16859,77090671,77090987,True,1,316
16860,77116694,77152437,False,1,35743
16861,77128594,77128960,True,1,366
16862,77143416,77146831,True,1,3415
16863,77144485,77146830,True,1,2345
16864,77161648,77161756,False,4,108
16865,77161648,77161756,True,1,108
16866,77171892,77185570,True,2,13678
16867,77171892,77231923,True,2,60031
16868,77171892,77262741,True,1,90849
16869,77171892,77268527,True,1,96635
16870,77182601,77185320,True,12,2719
16871,77182601,77185416,True,2,2815
16872,77191882,77196608,True,1,4726
16873,77193652,77195678,False,1,2026
16874,77193652,77195678,True,5,2026
16875,77196000,77199567,True,1,3567
16876,77196157,77207766,True,1,11609
16877,77196157,77208363,True,1,12206
16878,77196183,77207766,True,1,11583
16879,77198117,77208854,True,1,10737
16880,77200011,77208910,True,1,8899
16881,77219254,77219369,True,1,115
16882,77229201,77230565,False,1,1364
16883,77229683,77296262,True,1,66579
16884,77229683,77297580,True,2,67897
16885,77233014,77236087,True,3,3073
16886,77241749,77242557,False,1,808
16887,77242446,77242911,True,1,465
16888,77243030,77244239,False,1,1209
16889,77249971,77260484,False,1,10513
16890,77257748,77260144,False,1,2396
16891,77266060,77266636,True,2,576
16892,77288860,77293487,True,1,4627
16893,77289982,77290941,True,1,959
16894,77289982,77327545,True,1,37563
16895,77290335,77291294,True,1,959
16896,77290724,77292545,False,2,1821
16897,77290724,77292545,True,3,1821
16898,77291387,77291843,True,1,456
16899,77302679,77306688,True,1,4009
16900,77321424,77324245,True,1,2821
16901,77321424,77324618,True,1,3194
16902,77326131,77340007,True,1,13876
16903,77326738,77327006,True,1,268
16904,77331871,77347995,True,2,16124
16905,77344180,77351764,False,1,7584
16906,77349375,77361705,True,1,12330
16907,77351199,77352109,True,1,910
16908,77354512,77354849,True,1,337
16909,77355192,77358545,True,2,3353
16910,77355192,77361723,False,1,6531
16911,77366307,77373666,True,1,7359
16912,77374640,77375955,True,3,1315
16913,77381526,77381662,True,1,136
16914,77397879,77398006,False,1,127
16915,77404421,77404566,True,4,145
16916,77416546,77417241,True,1,695
16917,77421422,77422617,True,1,1195
16918,77422091,77425164,True,1,3073
16919,77434297,77441129,False,1,6832
16920,77450757,77450853,True,1,96
16921,77478889,77482164,True,1,3275
16922,77479788,77522728,True,1,42940
16923,77479788,77527648,False,1,47860
16924,77479788,77532457,False,1,52669
16925,77479788,77584842,True,1,105054
16926,77481415,77498071,False,1,16656
16927,77483962,77484820,True,2,858
16928,77486529,77500341,True,1,13812
16929,77492760,77502558,True,2,9798
16930,77510735,77529362,True,1,18627
16931,77510735,77533611,True,1,22876
16932,77512296,77512825,False,1,529
16933,77517715,77534175,True,1,16460
16934,77517715,77552262,True,1,34547
16935,77529468,77530049,False,1,581
16936,77529468,77530049,True,3,581
16937,77551035,77551588,True,1,553
16938,77551132,77551253,True,2,121
16939,77551132,77551588,True,1,456
16940,77551132,77558399,True,1,7267
16941,77563190,77566882,False,1,3692
16942,77563190,77566882,True,2,3692
16943,77563190,77571294,True,1,8104
16944,77563190,77572603,True,1,9413
16945,77569220,77570433,True,2,1213
16946,77569220,77570939,True,4,1719
16947,77581706,77585666,True,3,3960
16948,77583892,77636190,True,1,52298
16949,77584536,77584827,True,1,291
16950,77585286,77586674,True,1,1388
16951,77585286,77637584,True,2,52298
16952,77589726,77589816,True,2,90
16953,77590346,77591751,True,1,1405
16954,77590346,77592265,True,6,1919
16955,77595130,77595566,True,1,436
16956,77595636,77598651,True,1,3015
16957,77598394,77600351,True,1,1957
16958,77621395,77627714,True,1,6319
16959,77624753,77625473,True,2,720
16960,77627462,77629697,True,1,2235
16961,77632413,77633427,True,1,1014
16962,77646508,77662306,True,1,15798
16963,77646508,77673316,True,1,26808
16964,77652957,77654301,True,3,1344
16965,77656486,77683708,True,1,27222
16966,77663915,77664215,True,1,300
16967,77668652,77668919,False,1,267
16968,77692187,77715091,True,1,22904
16969,77692589,77715232,True,1,22643
16970,77695390,77697388,True,4,1998
16971,77708834,77709030,True,1,196
16972,77709183,77719907,False,3,10724
16973,77709183,77719907,True,2,10724
16974,77722251,77723561,True,1,1310
16975,77728411,77734608,True,2,6197
16976,77730790,77731987,True,1,1197
16977,77738808,77739370,True,1,562
16978,77738808,77749043,True,1,10235
16979,77738808,77762715,True,1,23907
16980,77749883,77765129,False,1,15246
16981,77750160,77751050,False,1,890
16982,77750160,77751050,True,1,890
16983,77752200,77752345,True,1,145
16984,77761887,77763318,True,2,1431
16985,77761887,77763324,True,1,1437
16986,77761957,77763515,True,1,1558
16987,77761958,77763423,True,2,1465
16988,77772758,77774376,True,1,1618
16989,77776492,77779229,True,1,2737
16990,77783017,77795459,True,1,12442
16991,77786544,77796103,True,1,9559
16992,77787632,77787750,True,3,118
16993,77794728,77796871,True,1,2143
16994,77799707,77800290,False,2,583
16995,77800433,77801221,True,7,788
16996,77808910,77809780,True,1,870
16997,77831047,77832564,True,2,1517
16998,77835371,77836587,True,1,1216
16999,77843054,77846162,True,1,3108
17000,77845407,77846325,True,1,918
17001,77847999,77848075,True,3,76
17002,77848853,77855722,True,2,6869
17003,77861673,77863789,True,1,2116
17004,77866449,77866562,True,1,113
17005,77876311,77878163,False,1,1852
17006,77880501,77880954,True,3,453
17007,77891368,77894035,True,1,2667
17008,77897268,77897852,True,1,584
17009,77930401,77940652,True,2,10251
17010,77930401,77959223,True,1,28822
17011,77930689,77931340,False,1,651
17012,77937702,77941090,True,2,3388
17013,77941849,77945425,True,1,3576
17014,77943069,77944024,False,1,955
17015,77943069,77944024,True,1,955
17016,77943069,77944574,True,1,1505
17017,77949102,77949405,True,1,303
17018,77950765,77964708,True,1,13943
17019,77950833,77964738,True,1,13905
17020,77950967,77964801,True,1,13834
17021,77956328,77961562,True,1,5234
17022,77957635,77973920,False,1,16285
17023,77964062,77972973,True,1,8911
17024,77973823,77973901,False,1,78
17025,77977738,77979135,True,1,1397
17026,77991694,77997025,True,1,5331
17027,77994570,78083296,True,2,88726
17028,78004450,78005083,True,1,633
17029,78010680,78011369,True,1,689
17030,78033250,78040727,False,2,7477
17031,78033250,78040727,True,1,7477
17032,78035266,78063963,True,2,28697
17033,78035439,78036244,True,1,805
17034,78047854,78048324,False,1,470
17035,78050459,78054730,True,3,4271
17036,78064850,78065770,True,1,920
17037,78093166,78110627,True,1,17461
17038,78093166,78124033,True,1,30867
17039,78093873,78110530,True,2,16657
17040,78105412,78114206,True,1,8794
17041,78105412,78116677,True,1,11265
17042,78105839,78178138,True,1,72299
17043,78121466,78122079,False,1,613
17044,78128506,78141434,True,2,12928
17045,78128506,78146572,True,1,18066
17046,78134174,78144201,False,1,10027
17047,78145391,78148927,False,1,3536
17048,78145391,78154496,True,1,9105
17049,78146771,78151143,False,1,4372
17050,78146771,78151143,True,2,4372
17051,78156053,78156279,True,1,226
17052,78156737,78158096,True,1,1359
17053,78156737,78162200,True,1,5463
17054,78157674,78159010,True,1,1336
17055,78158286,78159673,True,3,1387
17056,78162580,78163666,True,1,1086
17057,78163238,78165900,True,1,2662
17058,78165553,78166485,True,1,932
17059,78169556,78170887,True,1,1331
17060,78171814,78173386,True,1,1572
17061,78176221,78178702,True,1,2481
17062,78187070,78198045,False,1,10975
17063,78187070,78198045,True,3,10975
17064,78187070,78209721,True,1,22651
17065,78203958,78206654,True,1,2696
17066,78206353,78210420,True,1,4067
17067,78212920,78213684,True,4,764
17068,78219688,78220696,True,2,1008
17069,78229779,78231199,True,2,1420
17070,78236175,78250846,True,1,14671
17071,78263103,78264894,True,6,1791
17072,78268515,78269021,False,1,506
17073,78268515,78269021,True,1,506
17074,78276813,78329504,True,2,52691
17075,78276813,78343373,True,1,66560
17076,78278070,78278320,False,3,250
17077,78278070,78278320,True,3,250
17078,78283792,78292653,False,1,8861
17079,78293116,78295016,True,1,1900
17080,78298506,78299725,False,1,1219
17081,78298506,78299725,True,5,1219
17082,78316277,78318689,True,1,2412
17083,78329630,78331103,False,1,1473
17084,78344417,78345153,False,8,736
17085,78344417,78352259,False,1,7842
17086,78346148,78347552,True,1,1404
17087,78348942,78349918,True,2,976
17088,78350130,78351441,True,1,1311
17089,78368206,78371367,True,4,3161
17090,78368876,78368967,True,2,91
17091,78422145,78423301,True,2,1156
17092,78433293,78433541,True,1,248
17093,78435093,78435174,True,1,81
17094,78437400,78447926,False,1,10526
17095,78437400,78449846,False,1,12446
17096,78437400,78522975,False,2,85575
17097,78442349,78442434,True,3,85
17098,78451857,78452283,True,1,426
17099,78451857,78458640,True,1,6783
17100,78455722,78458641,True,1,2919
17101,78478276,78489811,False,1,11535
17102,78497451,78498234,True,1,783
17103,78500076,78500859,False,1,783
17104,78523386,78524074,True,1,688
17105,78523453,78527730,True,1,4277
17106,78527826,78533005,True,1,5179
17107,78533127,78533271,True,1,144
17108,78534289,78534923,True,1,634
17109,78534289,78538507,True,1,4218
17110,78559721,78560103,True,1,382
17111,78565378,78566549,True,1,1171
17112,78565378,78567029,True,1,1651
17113,78565680,78567029,True,1,1349
17114,78568164,78568502,True,1,338
17115,78569712,78573200,True,1,3488
17116,78579532,78580534,True,2,1002
17117,78584860,78584940,True,1,80
17118,78588206,78590770,True,1,2564
17119,78607199,78614358,True,6,7159
17120,78609244,78615477,True,3,6233
17121,78612418,78612556,True,1,138
17122,78612993,78626427,True,1,13434
17123,78612993,78626722,True,1,13729
17124,78612993,78627516,True,1,14523
17125,78612993,78628082,True,1,15089
17126,78615789,78629290,True,1,13501
17127,78616305,78629806,True,1,13501
17128,78616305,78636112,True,1,19807
17129,78617243,78620130,False,2,2887
17130,78617243,78620130,True,3,2887
17131,78644291,78644907,True,1,616
17132,78654447,78655049,True,4,602
17133,78655147,78655260,True,1,113
17134,78658547,78660711,True,2,2164
17135,78658946,78660025,True,1,1079
17136,78661751,78661861,True,1,110
17137,78664252,78664968,False,1,716
17138,78681155,78681211,True,1,56
17139,78682434,78703915,False,1,21481
17140,78687659,78700919,True,1,13260
17141,78693095,78694185,False,1,1090
17142,78703833,78705111,True,2,1278
17143,78703833,78710312,True,1,6479
17144,78707251,78709071,True,2,1820
17145,78707251,78709125,True,1,1874
17146,78711614,78712825,True,1,1211
17147,78718277,78718356,True,2,79
17148,78739144,78739266,True,6,122
17149,78742516,78745003,True,2,2487
17150,78745302,78746889,True,2,1587
17151,78756878,78758481,False,1,1603
17152,78756878,78758481,True,2,1603
17153,78762556,78765811,True,1,3255
17154,78780718,78785992,True,1,5274
17155,78781420,78786222,True,2,4802
17156,78781420,78786278,True,1,4858
17157,78799584,78800820,True,1,1236
17158,78811587,78812013,True,1,426
17159,78812149,78817417,True,1,5268
17160,78812292,78812382,True,4,90
17161,78816836,78816922,False,1,86
17162,78817866,78844300,True,2,26434
17163,78820648,78821862,True,1,1214
17164,78825182,78829118,True,1,3936
17165,78834658,78835942,True,4,1284
17166,78841275,78844853,False,1,3578
17167,78842985,78843261,True,1,276
17168,78843404,78843507,True,1,103
17169,78843576,78844564,True,1,988
17170,78850098,78855798,True,1,5700
17171,78853387,78918711,True,1,65324
17172,78865432,78867648,True,2,2216
17173,78873654,78875612,True,3,1958
17174,78873654,78911607,True,1,37953
17175,78884282,78884879,False,1,597
17176,78884282,78884879,True,3,597
17177,78888579,78888721,False,1,142
17178,78891264,78900320,True,2,9056
17179,78896458,78897313,True,2,855
17180,78911589,78911895,False,1,306
17181,78911589,78911895,True,2,306
17182,78914187,78920756,True,2,6569
17183,78914187,78923557,True,1,9370
17184,78915588,78916634,True,1,1046
17185,78918587,78919036,True,1,449
17186,78921446,78923072,True,4,1626
17187,78922324,78923149,False,1,825
17188,78946392,78947944,True,1,1552
17189,78952898,78953140,True,1,242
17190,78954252,78955375,True,3,1123
17191,78984036,78986359,True,1,2323
17192,78984040,78986359,True,1,2319
17193,78986576,78989503,True,4,2927
17194,78987239,78987948,False,3,709
17195,78987239,78987948,True,2,709
17196,79002247,79005867,True,3,3620
17197,79003654,79009355,True,3,5701
17198,79004832,79005042,True,1,210
17199,79018294,79030592,False,3,12298
17200,79018294,79030592,True,3,12298
17201,79030856,79032170,True,1,1314
17202,79039950,79040774,True,1,824
17203,79043144,79065085,True,1,21941
17204,79048850,79055369,True,1,6519
17205,79056831,79057182,True,2,351
17206,79059416,79063045,False,1,3629
17207,79068318,79069126,True,1,808
17208,79070522,79072731,True,2,2209
17209,79070522,79077650,True,1,7128
17210,79081247,79082596,True,2,1349
17211,79085948,79087031,True,1,1083
17212,79087322,79087580,True,1,258
17213,79094303,79096925,True,1,2622
17214,79099948,79246690,True,3,146742
17215,79100397,79101033,True,1,636
17216,79100397,79101074,True,1,677
17217,79106323,79110591,True,1,4268
17218,79106323,79126578,False,1,20255
17219,79117427,79123338,False,1,5911
17220,79129577,79129693,False,1,116
17221,79149984,79150674,True,1,690
17222,79151761,79164827,True,1,13066
17223,79154046,79154425,True,1,379
17224,79156703,79156813,False,1,110
17225,79167166,79167518,False,1,352
17226,79167166,79167518,True,3,352
17227,79169625,79170219,True,1,594
17228,79176052,79284836,True,1,108784
17229,79186413,79186963,True,1,550
17230,79202837,79203601,True,4,764
17231,79203781,79230802,True,1,27021
17232,79203781,79230860,True,1,27079
17233,79203781,79270682,True,1,66901
17234,79212148,79216105,True,1,3957
17235,79212806,79214581,True,1,1775
17236,79225049,79225718,True,1,669
17237,79225307,79225718,True,2,411
17238,79232255,79234844,True,1,2589
17239,79232978,79275287,True,4,42309
17240,79232978,79276589,True,2,43611
17241,79235439,79236398,True,1,959
17242,79236599,79237962,False,1,1363
17243,79236599,79237962,True,3,1363
17244,79241002,79241382,True,2,380
17245,79257328,79257585,True,3,257
17246,79257832,79297571,True,1,39739
17247,79266134,79266240,True,1,106
17248,79269360,79287080,False,1,17720
17249,79281673,79284071,False,1,2398
17250,79285210,79285587,True,1,377
17251,79288820,79313187,True,1,24367
17252,79288982,79289666,True,1,684
17253,79314846,79315201,True,1,355
17254,79314846,79315856,True,1,1010
17255,79315201,79315530,False,1,329
17256,79315201,79315530,True,2,329
17257,79317322,79317413,True,2,91
17258,79317391,79340219,False,1,22828
17259,79317471,79317562,True,1,91
17260,79326575,79389379,True,1,62804
17261,79327606,79344755,False,1,17149
17262,79329232,79345534,False,1,16302
17263,79340368,79340895,True,3,527
17264,79341225,79367274,True,1,26049
17265,79341941,79342132,True,1,191
17266,79351727,79353538,False,1,1811
17267,79360117,79360261,True,2,144
17268,79375348,79382309,True,8,6961
17269,79375562,79376294,True,1,732
17270,79387197,79388059,True,1,862
17271,79399673,79438701,True,3,39028
17272,79399673,79447033,False,1,47360
17273,79399673,79456938,True,1,57265
17274,79399680,79438796,True,1,39116
17275,79406557,79409248,True,2,2691
17276,79412974,79413980,False,1,1006
17277,79417875,79418080,True,3,205
17278,79426645,79427414,True,1,769
17279,79444497,79445576,True,1,1079
17280,79454432,79456264,False,1,1832
17281,79468641,79468733,True,2,92
17282,79469100,79480611,True,3,11511
17283,79471232,79481637,True,3,10405
17284,79472270,79482013,True,1,9743
17285,79473053,79482463,True,5,9410
17286,79474824,79474980,False,3,156
17287,79476409,79476665,True,1,256
17288,79476594,79476665,True,1,71
17289,79477314,79477874,True,1,560
17290,79478752,79502097,True,1,23345
17291,79483772,79484839,False,1,1067
17292,79491698,79493968,True,1,2270
17293,79492067,79516272,True,3,24205
17294,79507794,79514864,True,7,7070
17295,79518374,79518471,True,1,97
17296,79520399,79584179,True,2,63780
17297,79520475,79530493,True,1,10018
17298,79521691,79584793,True,1,63102
17299,79528237,79559201,True,1,30964
17300,79528663,79539723,False,1,11060
17301,79531915,79534475,True,1,2560
17302,79531915,79541121,True,1,9206
17303,79532311,79532470,True,1,159
17304,79532658,79554404,True,2,21746
17305,79533359,79558959,False,5,25600
17306,79533359,79572559,True,1,39200
17307,79542855,79546719,True,1,3864
17308,79544561,79546471,True,1,1910
17309,79546809,79580167,False,1,33358
17310,79551631,79552477,True,1,846
17311,79558032,79559076,True,1,1044
17312,79565461,79565618,False,2,157
17313,79574196,79574407,True,1,211
17314,79585210,79599139,False,1,13929
17315,79585210,79599139,True,1,13929
17316,79585561,79586291,True,1,730
17317,79589867,79589947,True,1,80
17318,79591598,79606641,True,1,15043
17319,79591598,79606767,True,2,15169
17320,79596638,79602025,True,1,5387
17321,79599180,79599707,True,1,527
17322,79612007,79612714,False,1,707
17323,79620929,79637012,True,1,16083
17324,79620929,79637783,True,3,16854
17325,79620929,79638009,True,1,17080
17326,79633053,79640362,True,1,7309
17327,79638186,79638636,True,1,450
17328,79638711,79639180,True,1,469
17329,79651590,79663956,True,1,12366
17330,79656832,79656984,False,1,152
17331,79664628,79714148,True,1,49520
17332,79664628,79728539,True,1,63911
17333,79666323,79672033,True,1,5710
17334,79666323,79680434,True,1,14111
17335,79672333,79672654,True,1,321
17336,79686702,79688647,False,1,1945
17337,79690447,79691154,True,1,707
17338,79690447,79691464,False,1,1017
17339,79690750,79692499,True,1,1749
17340,79702709,79793578,False,1,90869
17341,79702709,79793578,True,3,90869
17342,79704183,79794253,True,1,90070
17343,79706886,79736674,True,1,29788
17344,79734567,79735954,True,1,1387
17345,79737216,79740259,True,1,3043
17346,79737582,79737797,False,1,215
17347,79746708,79747307,True,1,599
17348,79746926,79748847,True,2,1921
17349,79746926,79748862,True,1,1936
17350,79746926,79749610,True,1,2684
17351,79753128,79753389,True,1,261
17352,79753312,79753389,False,1,77
17353,79753312,79753389,True,1,77
17354,79760296,79760999,True,4,703
17355,79762087,79762201,True,1,114
17356,79764240,79765064,True,1,824
17357,79764240,79766153,True,1,1913
17358,79770166,79771352,True,1,1186
17359,79785358,79802165,True,1,16807
17360,79785417,79823856,True,1,38439
17361,79786548,79824253,True,2,37705
17362,79792366,79796310,True,1,3944
17363,79795054,79795867,True,1,813
17364,79796725,79798489,True,3,1764
17365,79799738,79799985,True,1,247
17366,79801090,79806340,True,1,5250
17367,79807128,79808392,True,1,1264
17368,79807801,79808452,True,2,651
17369,79808949,79809121,True,1,172
17370,79811708,79811785,True,1,77
17371,79822151,79823587,True,1,1436
17372,79822151,79823635,True,4,1484
17373,79822542,79822838,True,2,296
17374,79823005,79823283,True,1,278
17375,79833324,79833925,True,2,601
17376,79834244,79834344,True,1,100
17377,79835219,79869591,True,1,34372
17378,79847904,79848006,True,3,102
17379,79850725,79850920,True,1,195
17380,79855263,79856836,True,1,1573
17381,79865608,79866880,True,1,1272
17382,79868668,79879732,True,1,11064
17383,79868690,79879754,True,1,11064
17384,79872462,79872627,True,3,165
17385,79872462,79872702,True,1,240
17386,79872462,79872705,True,1,243
17387,79872892,79880281,True,1,7389
17388,79892954,79912537,True,1,19583
17389,79915314,79934161,True,1,18847
17390,79917435,79917741,True,2,306
17391,79917594,79917810,True,1,216
17392,79924614,79925291,True,1,677
17393,79927398,79934707,False,1,7309
17394,79927398,79934707,True,2,7309
17395,79933750,79960911,True,2,27161
17396,79938492,79942269,True,1,3777
17397,79939201,79943993,False,1,4792
17398,79939201,79943993,True,2,4792
17399,79942652,79943572,True,2,920
17400,79951112,79951241,True,1,129
17401,79953161,79953265,True,1,104
17402,79963242,79965009,True,3,1767
17403,79976128,79977183,False,1,1055
17404,79976128,79982676,False,1,6548
17405,79977028,79981665,True,1,4637
17406,79979239,79979386,True,3,147
17407,79980299,79980881,True,1,582
17408,79981409,80017154,True,2,35745
17409,79988392,79992105,True,1,3713
17410,79988392,79992149,True,1,3757
17411,79988420,79992115,True,1,3695
17412,79988422,79990678,True,2,2256
17413,80012413,80014998,True,1,2585
17414,80021371,80030875,True,1,9504
17415,80040132,80054726,False,1,14594
17416,80040132,80054726,True,1,14594
17417,80047335,80048138,True,5,803
17418,80053278,80053839,True,3,561
17419,80055054,80064288,True,1,9234
17420,80065298,80071951,True,2,6653
17421,80090340,80091119,True,1,779
17422,80117173,80133596,True,2,16423
17423,80130638,80133302,True,1,2664
17424,80166641,80167703,True,1,1062
17425,80173977,80178355,True,2,4378
17426,80181954,80184999,True,2,3045
17427,80185677,80190427,True,3,4750
17428,80186391,80188408,True,1,2017
17429,80202944,80203038,True,1,94
17430,80208532,80212212,True,1,3680
17431,80222131,80223116,False,3,985
17432,80237663,80238842,True,2,1179
17433,80237663,80238847,True,1,1184
17434,80237663,80242666,True,1,5003
17435,80249950,80251541,True,1,1591
17436,80252314,80253381,True,1,1067
17437,80257226,80257715,True,4,489
17438,80259932,80260436,False,1,504
17439,80264681,80265572,True,1,891
17440,80273634,80298099,True,3,24465
17441,80273634,80449491,True,1,175857
17442,80279336,80300274,True,1,20938
17443,80279406,80279529,False,1,123
17444,80283242,80334038,True,1,50796
17445,80289572,80294760,False,1,5188
17446,80293049,80294251,True,1,1202
17447,80293049,80294756,True,1,1707
17448,80293173,80295078,True,1,1905
17449,80302876,80307082,True,1,4206
17450,80339237,80343173,True,1,3936
17451,80340087,80342084,False,1,1997
17452,80340087,80342649,True,1,2562
17453,80344308,80345647,True,1,1339
17454,80344308,80345666,True,3,1358
17455,80344411,80345704,True,1,1293
17456,80345199,80346167,True,1,968
17457,80349293,80395118,True,3,45825
17458,80354770,80355123,True,1,353
17459,80355798,80359711,True,1,3913
17460,80356744,80357227,True,2,483
17461,80390128,80391288,True,1,1160
17462,80390128,80392180,True,1,2052
17463,80397446,80442858,True,1,45412
17464,80409111,80410351,False,1,1240
17465,80409111,80410351,True,2,1240
17466,80409119,80410351,True,3,1232
17467,80417145,80417670,True,1,525
17468,80430850,80557363,False,1,126513
17469,80444037,80446813,True,1,2776
17470,80447355,80481887,True,1,34532
17471,80450142,80452664,True,1,2522
17472,80452886,80458050,True,2,5164
17473,80458685,80459515,True,1,830
17474,80459779,80460724,True,1,945
17475,80459779,80463262,True,2,3483
17476,80495789,80501803,True,1,6014
17477,80507385,80507653,False,1,268
17478,80507385,80507653,True,1,268
17479,80511046,80512012,True,1,966
17480,80530988,80531144,True,1,156
17481,80534548,80542398,True,1,7850
17482,80554909,80555764,True,3,855
17483,80568415,80572529,True,1,4114
17484,80589832,80590235,True,1,403
17485,80594419,80640180,True,1,45761
17486,80594419,80653142,True,1,58723
17487,80594419,80659077,True,1,64658
17488,80598482,80599442,False,1,960
17489,80614290,80616476,False,4,2186
17490,80614290,80616476,True,12,2186
17491,80614290,80655693,False,1,41403
17492,80618045,80620656,True,1,2611
17493,80618704,80619493,False,1,789
17494,80624578,80625831,False,1,1253
17495,80632715,80632807,True,3,92
17496,80637749,80647477,False,1,9728
17497,80642048,80642147,True,1,99
17498,80645466,80665704,True,3,20238
17499,80645466,80678666,True,1,33200
17500,80646867,80823842,True,1,176975
17501,80646867,80826717,True,1,179850
17502,80650294,80650398,True,1,104
17503,80650550,80652291,True,1,1741
17504,80650760,80652501,True,1,1741
17505,80656591,80657075,True,2,484
17506,80658745,80659771,True,1,1026
17507,80663160,80669671,False,3,6511
17508,80663302,80669671,False,1,6369
17509,80672623,80673438,True,1,815
17510,80674893,80675187,True,1,294
17511,80682054,80705824,True,6,23770
17512,80683043,80683305,True,5,262
17513,80686043,80694676,True,1,8633
17514,80688459,80765393,True,1,76934
17515,80689018,80689180,False,1,162
17516,80692798,80693181,False,1,383
17517,80702635,80703554,True,1,919
17518,80705076,80705550,True,1,474
17519,80708098,80708221,True,1,123
17520,80720023,80758823,True,1,38800
17521,80724737,80727704,True,2,2967
17522,80732398,80732761,True,1,363
17523,80740072,80740463,True,1,391
17524,80764179,80776469,True,2,12290
17525,80764179,80776532,True,1,12353
17526,80764179,80778084,True,1,13905
17527,80777867,80826792,True,2,48925
17528,80782487,80806122,True,1,23635
17529,80841840,80843540,False,1,1700
17530,80841840,80843540,True,2,1700
17531,80841840,80843651,True,1,1811
17532,80841840,80851664,True,1,9824
17533,80853431,80859937,False,1,6506
17534,80853431,80859937,True,3,6506
17535,80857424,80858207,True,1,783
17536,80857632,80858285,True,1,653
17537,80866501,80873404,False,1,6903
17538,80879217,80879636,True,1,419
17539,80880500,80881302,True,1,802
17540,80880569,80888451,False,1,7882
17541,80880569,80888451,True,3,7882
17542,80880569,80890699,True,1,10130
17543,80880689,80881491,True,2,802
17544,80880728,80908379,True,1,27651
17545,80881822,80953877,True,1,72055
17546,80883069,80954534,True,1,71465
17547,80906665,80910461,True,1,3796
17548,80913694,80914709,True,1,1015
17549,80916598,80917551,True,2,953
17550,80933160,80934147,True,5,987
17551,80937551,80944590,True,1,7039
17552,80954056,80954962,True,2,906
17553,80975586,80976036,False,1,450
17554,80975586,80976036,True,1,450
17555,80978309,80984067,True,2,5758
17556,80997636,80998161,True,1,525
17557,80997794,80998208,True,1,414
17558,80998712,81000144,True,1,1432
17559,81006006,81006708,True,2,702
17560,81012709,81031258,True,2,18549
17561,81012709,81031261,False,1,18552
17562,81012709,81031261,True,1,18552
17563,81012727,81031258,True,1,18531
17564,81012727,81031261,True,1,18534
17565,81019496,81042426,True,1,22930
17566,81019496,81055005,True,1,35509
17567,81019925,81022408,True,1,2483
17568,81026931,81027308,True,1,377
17569,81037451,81038010,True,5,559
17570,81046860,81047430,True,1,570
17571,81063294,81064089,True,1,795
17572,81064293,81064795,True,1,502
17573,81076699,81087446,True,1,10747
17574,81076699,81087477,True,1,10778
17575,81078236,81080893,False,1,2657
17576,81078236,81080893,True,2,2657
17577,81078236,81082611,True,1,4375
17578,81087605,81087722,True,1,117
17579,81090868,81102358,True,1,11490
17580,81094961,81096730,True,4,1769
17581,81095158,81095322,True,2,164
17582,81095292,81095394,True,1,102
17583,81111872,81129109,True,2,17237
17584,81116746,81125825,True,2,9079
17585,81126744,81128090,True,1,1346
17586,81132904,81133643,True,1,739
17587,81133140,81133643,True,2,503
17588,81134624,81138253,True,1,3629
17589,81137310,81137828,True,1,518
17590,81148072,81215945,True,2,67873
17591,81148721,81152282,True,1,3561
17592,81153614,81153800,True,1,186
17593,81161014,81166622,True,3,5608
17594,81161216,81161568,True,4,352
17595,81186679,81187025,True,1,346
17596,81189693,81192094,True,1,2401
17597,81217230,81218923,False,3,1693
17598,81217230,81218923,True,2,1693
17599,81221842,81223725,True,7,1883
17600,81237896,81238167,True,1,271
17601,81244343,81251762,True,1,7419
17602,81251553,81251635,True,2,82
17603,81254348,81281765,True,1,27417
17604,81258407,81258683,True,1,276
17605,81286496,81288664,True,1,2168
17606,81290612,81291976,True,1,1364
17607,81290926,81292002,True,1,1076
17608,81301074,81306257,True,1,5183
17609,81313056,81329165,True,1,16109
17610,81313056,81335911,True,1,22855
17611,81318997,81325229,True,1,6232
17612,81323731,81326815,True,1,3084
17613,81338870,81353127,True,1,14257
17614,81344729,81345494,False,1,765
17615,81345031,81345395,True,1,364
17616,81350166,81350348,False,2,182
17617,81350166,81350348,True,3,182
17618,81360611,81361082,True,1,471
17619,81375373,81376601,True,1,1228
17620,81376623,81377364,True,1,741
17621,81378674,81381271,True,1,2597
17622,81393274,81394338,True,1,1064
17623,81393805,81397937,True,1,4132
17624,81395857,81397520,True,1,1663
17625,81395857,81397821,True,1,1964
17626,81396270,81401930,True,1,5660
17627,81400798,81401998,True,1,1200
17628,81409031,81409123,False,1,92
17629,81409031,81409123,True,1,92
17630,81410260,81410406,True,1,146
17631,81410963,81411911,True,3,948
17632,81415025,81415619,True,1,594
17633,81427474,81430525,True,1,3051
17634,81428277,81440122,True,2,11845
17635,81428277,81458575,True,1,30298
17636,81428328,81428463,True,1,135
17637,81428328,81428719,True,1,391
17638,81429325,81431310,False,1,1985
17639,81429325,81431310,True,1,1985
17640,81429431,81430068,True,1,637
17641,81431834,81437106,False,1,5272
17642,81431919,81432049,True,1,130
17643,81438261,81438712,True,2,451
17644,81438423,81438712,True,1,289
17645,81444143,81445056,True,1,913
17646,81447787,81450230,True,1,2443
17647,81449369,81449450,False,2,81
17648,81449369,81449450,True,5,81
17649,81457324,81457407,False,1,83
17650,81457324,81457407,True,1,83
17651,81464083,81482567,True,1,18484
17652,81465813,81466215,True,2,402
17653,81466877,81484058,True,2,17181
17654,81467344,81467746,True,2,402
17655,81476081,81477173,True,5,1092
17656,81481458,81481572,True,1,114
17657,81485218,81488337,True,2,3119
17658,81491513,81493339,True,1,1826
17659,81502744,81504758,True,1,2014
17660,81504230,81504531,True,3,301
17661,81504624,81514834,False,2,10210
17662,81504624,81514834,True,2,10210
17663,81509906,81510129,False,1,223
17664,81511944,81516226,False,1,4282
17665,81519472,81522313,False,1,2841
17666,81519472,81522313,True,1,2841
17667,81521515,81529201,True,1,7686
17668,81522604,81524094,True,2,1490
17669,81523161,81523481,True,1,320
17670,81533215,81533644,True,2,429
17671,81533286,81563292,True,4,30006
17672,81539173,81540048,False,1,875
17673,81546437,81555506,True,2,9069
17674,81556307,81559672,True,2,3365
17675,81574496,81578874,False,1,4378
17676,81574496,81578874,True,18,4378
17677,81588900,81593580,True,1,4680
17678,81588900,81594539,True,1,5639
17679,81589831,81593339,False,1,3508
17680,81614202,81619269,True,1,5067
17681,81614202,81619279,True,3,5077
17682,81622835,81623115,True,1,280
17683,81623288,81623489,True,1,201
17684,81630132,81630647,False,1,515
17685,81630319,81635929,True,6,5610
17686,81635651,81652095,True,1,16444
17687,81640252,81641377,False,2,1125
17688,81640252,81641377,True,1,1125
17689,81642328,81642523,True,1,195
17690,81647846,81658078,True,1,10232
17691,81648038,81672950,True,1,24912
17692,81655249,81656877,True,4,1628
17693,81664054,81665235,True,1,1181
17694,81664104,81665710,True,1,1606
17695,81666155,81732968,False,1,66813
17696,81669545,81670468,False,1,923
17697,81669545,81670468,True,1,923
17698,81679272,81711783,True,2,32511
17699,81680684,81712710,True,1,32026
17700,81683176,81684661,True,1,1485
17701,81691623,81694710,True,3,3087
17702,81698390,81703788,True,1,5398
17703,81698469,81699531,False,1,1062
17704,81698469,81699531,True,2,1062
17705,81706902,81707185,True,6,283
17706,81708962,81725789,True,1,16827
17707,81709006,81725954,True,1,16948
17708,81709006,81726655,True,1,17649
17709,81711278,81712058,True,3,780
17710,81718192,81731422,True,1,13230
17711,81718514,81807332,False,1,88818
17712,81720076,81720867,True,1,791
17713,81723489,81725331,True,1,1842
17714,81723678,81725337,True,1,1659
17715,81725033,81734877,True,1,9844
17716,81730633,81735218,True,1,4585
17717,81731150,81737171,True,1,6021
17718,81744742,81744840,True,1,98
17719,81759556,81760586,True,1,1030
17720,81770853,81771405,True,1,552
17721,81773036,81781557,True,4,8521
17722,81784833,81787605,True,1,2772
17723,81803547,81804195,True,2,648
17724,81804393,81809281,True,1,4888
17725,81812194,81812482,False,1,288
17726,81814343,81817701,False,1,3358
17727,81819316,81838278,False,1,18962
17728,81819316,81838278,True,1,18962
17729,81826587,81827061,True,2,474
17730,81827768,81828464,False,1,696
17731,81831620,81832099,True,1,479
17732,81831620,81832108,True,1,488
17733,81833096,81836209,True,1,3113
17734,81845709,81946339,False,1,100630
17735,81845709,81955687,False,1,109978
17736,81850999,81851202,True,1,203
17737,81856805,81905387,True,1,48582
17738,81857861,81860180,True,1,2319
17739,81865982,81867422,True,2,1440
17740,81871801,81872064,True,1,263
17741,81874783,81876577,True,1,1794
17742,81877750,81877987,False,1,237
17743,81877750,81877987,True,1,237
17744,81886867,81888007,True,1,1140
17745,81886867,81888304,True,2,1437
17746,81890249,81927609,True,2,37360
17747,81894740,81894979,True,1,239
17748,81894740,81896867,True,1,2127
17749,81895335,81895801,True,1,466
17750,81899820,81900119,True,1,299
17751,81901940,81906540,True,1,4600
17752,81902107,81906489,True,1,4382
17753,81907643,81910959,True,1,3316
17754,81918659,81918746,False,1,87
17755,81925095,81925820,True,3,725
17756,81925095,81928113,True,1,3018
17757,81938990,81950582,True,1,11592
17758,81944365,81950659,True,2,6294
17759,81946337,81951637,True,1,5300
17760,81948981,81949553,True,1,572
17761,81948981,81949835,True,1,854
17762,81949922,81954645,True,1,4723
17763,81953329,81954215,True,1,886
17764,81955807,81959041,False,1,3234
17765,81969965,81972119,False,1,2154
17766,81969965,82016649,True,1,46684
17767,81970848,81970949,True,1,101
17768,81970848,81971517,False,1,669
17769,81970848,81971517,True,3,669
17770,81972945,81973160,False,1,215
17771,81974896,81978330,True,1,3434
17772,81974949,81978279,True,3,3330
17773,81986660,81987263,True,1,603
17774,81986660,81994482,False,1,7822
17775,81990973,81992764,True,1,1791
17776,81994691,81996045,True,1,1354
17777,81994839,81997709,True,2,2870
17778,81996381,81996833,True,2,452
17779,82003285,82003792,True,1,507
17780,82004634,82020534,False,1,15900
17781,82004634,82033895,False,1,29261
17782,82008160,82009663,True,2,1503
17783,82008160,82009752,False,1,1592
17784,82010640,82011722,True,1,1082
17785,82020753,82020939,True,2,186
17786,82021003,82021159,True,1,156
17787,82028714,82032628,False,1,3914
17788,82028714,82045989,False,1,17275
17789,82037973,82039728,True,1,1755
17790,82040140,82040552,True,1,412
17791,82042156,82050004,True,1,7848
17792,82042156,82050173,False,1,8017
17793,82050410,82056719,False,1,6309
17794,82053570,82056680,False,2,3110
17795,82056877,82057405,True,3,528
17796,82058646,82060931,True,1,2285
17797,82058779,82058963,True,2,184
17798,82058779,82060931,True,1,2152
17799,82062378,82067153,True,1,4775
17800,82062378,82077124,True,1,14746
17801,82069706,82071108,True,2,1402
17802,82069706,82072343,True,1,2637
17803,82072891,82074924,True,2,2033
17804,82073435,82075202,True,1,1767
17805,82074649,82075645,True,1,996
17806,82081529,82087472,True,2,5943
17807,82082290,82087726,True,1,5436
17808,82093670,82095318,True,1,1648
17809,82096362,82181774,True,1,85412
17810,82105936,82108759,True,2,2823
17811,82112698,82114307,True,1,1609
17812,82112698,82114340,True,1,1642
17813,82114447,82114535,True,1,88
17814,82120326,82125989,True,1,5663
17815,82131959,82132476,False,1,517
17816,82133187,82133717,False,1,530
17817,82133187,82133780,False,1,593
17818,82137689,82138519,False,1,830
17819,82150684,82152227,True,1,1543
17820,82150919,82152132,True,1,1213
17821,82154330,82155647,False,1,1317
17822,82155735,82158764,True,1,3029
17823,82165647,82165891,True,2,244
17824,82166253,82166363,True,1,110
17825,82166483,82166597,True,1,114
17826,82168815,82170595,True,1,1780
17827,82170618,82171080,False,1,462
17828,82172545,82172624,True,1,79
17829,82172637,82388400,True,2,215763
17830,82178752,82180831,True,2,2079
17831,82198158,82204172,True,1,6014
17832,82198884,82199724,True,1,840
17833,82199142,82200588,True,1,1446
17834,82199339,82200588,True,2,1249
17835,82200284,82200644,True,1,360
17836,82205287,82206357,True,3,1070
17837,82206426,82208241,True,1,1815
17838,82211174,82211439,False,1,265
17839,82214819,82218215,True,1,3396
17840,82215601,82215800,True,2,199
17841,82216240,82216322,True,1,82
17842,82231428,82232087,True,1,659
17843,82232636,82233836,True,1,1200
17844,82234654,82234995,True,2,341
17845,82234654,82235553,True,1,899
17846,82234786,82235474,True,1,688
17847,82235654,82235741,True,1,87
17848,82239445,82239720,True,1,275
17849,82239765,82240040,False,1,275
17850,82240368,82245266,True,1,4898
17851,82241307,82242408,True,3,1101
17852,82242483,82280453,True,1,37970
17853,82252761,82252852,True,2,91
17854,82252761,82253771,True,1,1010
17855,82262971,82263444,True,1,473
17856,82265672,82271852,True,1,6180
17857,82272629,82272931,True,2,302
17858,82273869,82281962,True,1,8093
17859,82273914,82282007,True,1,8093
17860,82285355,82291588,True,2,6233
17861,82300933,82301209,True,1,276
17862,82314780,82335598,True,1,20818
17863,82314780,82361747,True,5,46967
17864,82315551,82318955,True,1,3404
17865,82317726,82322935,True,1,5209
17866,82317795,82318088,True,1,293
17867,82330110,82330291,True,1,181
17868,82332623,82335577,False,2,2954
17869,82332623,82335577,True,3,2954
17870,82334782,82334943,True,3,161
17871,82345854,82347612,True,4,1758
17872,82350325,82379543,True,1,29218
17873,82353183,82353626,False,1,443
17874,82354723,82355232,True,1,509
17875,82373684,82374761,True,1,1077
17876,82386200,82389309,False,2,3109
17877,82386200,82389309,True,6,3109
17878,82387865,82390502,False,1,2637
17879,82392289,82392511,True,1,222
17880,82393233,82393708,False,1,475
17881,82394130,82395969,True,10,1839
17882,82395711,82396287,True,3,576
17883,82398091,82400033,False,1,1942
17884,82409127,82417711,True,1,8584
17885,82421424,82426034,True,1,4610
17886,82430739,82431238,True,3,499
17887,82443270,82443698,True,2,428
17888,82443462,82443573,True,1,111
17889,82443842,82523896,True,1,80054
17890,82444455,82445442,False,1,987
17891,82447202,82454250,True,1,7048
17892,82472832,82473520,True,1,688
17893,82478782,82509745,True,1,30963
17894,82482102,82506451,True,5,24349
17895,82486966,82491695,True,1,4729
17896,82486966,82493129,True,1,6163
17897,82489993,82490977,True,1,984
17898,82490328,82491312,True,4,984
17899,82490328,82495241,True,1,4913
17900,82490328,82520737,True,1,30409
17901,82491647,82492059,True,2,412
17902,82494110,82494363,False,1,253
17903,82495367,82495574,False,1,207
17904,82495367,82495574,True,1,207
17905,82495435,82496568,True,2,1133
17906,82496167,82497407,True,1,1240
17907,82499762,82532618,True,2,32856
17908,82506333,82509764,True,1,3431
17909,82506333,82510704,False,1,4371
17910,82506333,82518085,True,3,11752
17911,82514144,82519993,True,1,5849
17912,82516943,82523261,False,2,6318
17913,82517923,82518027,True,2,104
17914,82525467,82528429,True,1,2962
17915,82540471,82544050,True,1,3579
17916,82543716,82546136,False,1,2420
17917,82543716,82546136,True,1,2420
17918,82554496,82555000,True,1,504
17919,82555386,82560822,False,3,5436
17920,82555386,82568271,False,1,12885
17921,82555520,82558992,False,1,3472
17922,82562197,82562521,True,1,324
17923,82562855,82562936,True,1,81
17924,82563015,82563096,False,1,81
17925,82568419,82570045,False,1,1626
17926,82568419,82570045,True,2,1626
17927,82570955,82571239,True,1,284
17928,82576572,82579067,False,1,2495
17929,82576572,82579067,True,1,2495
17930,82601187,82611528,False,1,10341
17931,82604453,82614597,True,1,10144
17932,82607168,82626703,True,1,19535
17933,82607193,82607350,True,3,157
17934,82610214,82611289,True,1,1075
17935,82610876,82611575,True,1,699
17936,82612769,82617907,True,1,5138
17937,82613481,82613812,True,1,331
17938,82613891,82639454,True,1,25563
17939,82620919,82688973,True,1,68054
17940,82628593,82628705,False,1,112
17941,82630748,82630836,True,1,88
17942,82633028,82635194,False,1,2166
17943,82645125,82650303,True,1,5178
17944,82645470,82650316,True,1,4846
17945,82646101,82646355,True,1,254
17946,82646564,82651051,True,3,4487
17947,82684723,82685317,True,1,594
17948,82694830,82696907,True,1,2077
17949,82696216,82696430,True,2,214
17950,82696656,82703198,True,1,6542
17951,82699324,82699976,True,1,652
17952,82702212,82702685,True,1,473
17953,82703862,82704638,False,1,776
17954,82725756,82859354,True,5,133598
17955,82725756,82889227,True,1,163471
17956,82727345,82730838,True,2,3493
17957,82727834,82728115,True,1,281
17958,82727834,82728137,True,2,303
17959,82727834,82728931,True,1,1097
17960,82745980,82750284,False,1,4304
17961,82745980,82771760,False,2,25780
17962,82747053,82749013,False,1,1960
17963,82754037,82757390,True,5,3353
17964,82763122,82763773,True,3,651
17965,82769601,82798638,True,1,29037
17966,82769655,82798638,False,1,28983
17967,82769655,82798638,True,1,28983
17968,82773639,82774425,True,2,786
17969,82775730,82884370,True,1,108640
17970,82794787,82796307,False,1,1520
17971,82848072,82855908,False,1,7836
17972,82860517,82872169,False,1,11652
17973,82860517,82872169,True,2,11652
17974,82871503,82891515,True,1,20012
17975,82890507,82893954,True,1,3447
17976,82890507,82901841,True,1,11334
17977,82895266,82896548,True,1,1282
17978,82895619,82895825,False,1,206
17979,82897960,82899323,True,1,1363
17980,82908476,82909784,False,2,1308
17981,82908476,82911934,False,1,3458
17982,82908572,82911025,True,1,2453
17983,82940530,82940720,False,1,190
17984,82951721,82957063,True,3,5342
17985,82952813,82953379,True,1,566
17986,82963168,82964172,True,3,1004
17987,82963168,82964573,True,1,1405
17988,82964334,82974464,False,1,10130
17989,82972883,82981632,False,1,8749
17990,82977715,83001802,True,1,24087
17991,82986861,82987124,True,7,263
17992,82988653,82993908,False,1,5255
17993,82994584,83007107,True,1,12523
17994,83001574,83002771,True,1,1197
17995,83008041,83008539,True,2,498
17996,83014218,83021109,True,3,6891
17997,83019918,83020050,True,1,132
17998,83024015,83029689,True,3,5674
17999,83024015,83030060,True,3,6045
18000,83024015,83030135,True,3,6120
18001,83024015,83031918,True,1,7903
18002,83028768,83047644,True,3,18876
18003,83032712,83037554,False,1,4842
18004,83032712,83037966,False,1,5254
18005,83047083,83059299,False,1,12216
18006,83047083,83059299,True,1,12216
18007,83047083,83072542,False,1,25459
18008,83060513,83061674,False,1,1161
18009,83080557,83141125,True,2,60568
18010,83096562,83097219,True,3,657
18011,83096562,83097222,True,1,660
18012,83122886,83128148,True,2,5262
18013,83122886,83129090,True,1,6204
18014,83152508,83153621,False,1,1113
18015,83163545,83172702,False,1,9157
18016,83165154,83167507,True,1,2353
18017,83166949,83169431,False,1,2482
18018,83166949,83169431,True,1,2482
18019,83181302,83190357,True,1,9055
18020,83188911,83189187,True,1,276
18021,83202702,83207010,False,1,4308
18022,83202702,83207010,True,2,4308
18023,83203512,83206934,True,1,3422
18024,83211080,83214757,False,1,3677
18025,83211321,83211711,True,7,390
18026,83212584,83212669,True,1,85
18027,83212760,83220059,True,1,7299
18028,83221270,83221779,True,1,509
18029,83230033,83230399,True,3,366
18030,83230039,83230399,True,1,360
18031,83231160,83236685,True,1,5525
18032,83240749,83242430,True,1,1681
18033,83240749,83242433,False,1,1684
18034,83240749,83242433,True,1,1684
18035,83240749,83242710,True,1,1961
18036,83250139,83259473,True,5,9334
18037,83250139,83266185,True,1,16046
18038,83251247,83256660,True,2,5413
18039,83269235,83275877,True,1,6642
18040,83271507,83272474,True,2,967
18041,83284290,83286946,True,4,2656
18042,83304531,83305541,True,6,1010
18043,83309173,83309755,True,1,582
18044,83310629,83310726,True,1,97
18045,83317055,83317137,True,2,82
18046,83317711,83332391,False,1,14680
18047,83317711,83349935,True,1,32224
18048,83317711,83360138,False,1,42427
18049,83317711,83361374,False,1,43663
18050,83329820,83333395,True,1,3575
18051,83359337,83360190,False,1,853
18052,83359337,83360190,True,1,853
18053,83372800,83373299,True,1,499
18054,83390335,83394146,False,1,3811
18055,83395282,83414163,True,2,18881
18056,83398460,83399561,False,1,1101
18057,83398460,83399561,True,1,1101
18058,83409190,83409914,True,1,724
18059,83414265,83427635,False,1,13370
18060,83417540,83418107,True,1,567
18061,83418812,83439818,True,1,21006
18062,83437157,83438611,True,2,1454
18063,83437157,83456189,True,1,19032
18064,83450489,83451646,True,3,1157
18065,83458740,83468183,True,2,9443
18066,83462038,83469656,True,3,7618
18067,83467199,83483707,False,2,16508
18068,83477184,83477465,True,1,281
18069,83494437,83495462,True,1,1025
18070,83497063,83497585,False,1,522
18071,83497063,83497585,True,1,522
18072,83509740,83511145,False,1,1405
18073,83510062,83511467,True,1,1405
18074,83510345,83510441,False,1,96
18075,83510391,83510586,False,1,195
18076,83510391,83511513,False,1,1122
18077,83510520,83511513,False,1,993
18078,83526939,83546689,True,1,19750
18079,83532049,83532948,True,1,899
18080,83536877,83542516,True,2,5639
18081,83537487,83542692,True,1,5205
18082,83540786,83540914,True,1,128
18083,83540822,83544245,True,2,3423
18084,83540923,83544452,True,1,3529
18085,83540923,83581905,True,1,40982
18086,83541342,83544765,True,1,3423
18087,83542274,83545152,True,1,2878
18088,83556126,83557871,True,1,1745
18089,83556137,83561270,True,1,5133
18090,83556137,83561285,True,1,5148
18091,83556137,83568030,True,1,11893
18092,83572669,83579714,True,1,7045
18093,83579381,83581768,True,3,2387
18094,83581879,83585186,True,1,3307
18095,83581879,83587905,True,3,6026
18096,83592281,83592377,True,4,96
18097,83600084,83600830,True,1,746
18098,83616168,83622420,True,1,6252
18099,83617151,83618172,True,1,1021
18100,83619263,83619368,True,1,105
18101,83628270,83628783,True,1,513
18102,83632354,83638380,True,1,6026
18103,83662283,83672570,True,1,10287
18104,83662902,83671872,True,1,8970
18105,83663355,83685291,True,1,21936
18106,83663355,83731796,True,1,68441
18107,83664229,83666986,True,1,2757
18108,83673926,83674842,True,1,916
18109,83690670,83694828,True,1,4158
18110,83690670,83695566,False,1,4896
18111,83690670,83695566,True,1,4896
18112,83702798,83704542,True,1,1744
18113,83712211,83719170,True,1,6959
18114,83713922,83740999,True,1,27077
18115,83715756,83716287,True,1,531
18116,83721239,83724121,True,1,2882
18117,83730314,83760856,True,1,30542
18118,83739870,83754054,True,1,14184
18119,83748116,83750096,True,3,1980
18120,83748116,83750172,True,1,2056
18121,83748116,83757612,True,1,9496
18122,83757411,83764488,False,1,7077
18123,83757411,83764488,True,2,7077
18124,83764368,83766033,False,1,1665
18125,83765196,83766621,True,5,1425
18126,83766396,83767352,True,1,956
18127,83771058,83776320,False,1,5262
18128,83771058,83776320,True,3,5262
18129,83778532,83784074,True,1,5542
18130,83784905,83785692,True,1,787
18131,83790764,83793514,True,1,2750
18132,83790891,83793641,True,1,2750
18133,83806515,83806965,True,5,450
18134,83807067,83849808,True,1,42741
18135,83807516,83820282,True,1,12766
18136,83807533,83820233,True,3,12700
18137,83807968,83808514,False,1,546
18138,83809038,83812305,True,1,3267
18139,83809653,83812627,True,1,2974
18140,83809653,83813709,True,1,4056
18141,83814557,83815692,True,1,1135
18142,83827550,83874787,True,1,47237
18143,83847142,83848491,True,3,1349
18144,83847413,83849005,True,1,1592
18145,83849142,83850439,True,5,1297
18146,83850955,83852468,True,2,1513
18147,83862710,83864741,False,1,2031
18148,83863978,83864450,True,1,472
18149,83871960,83875154,True,1,3194
18150,83874682,83877753,False,1,3071
18151,83874682,83877753,True,1,3071
18152,83875535,83876397,False,1,862
18153,83875535,83876397,True,3,862
18154,83875535,83876662,True,3,1127
18155,83877711,83877812,True,3,101
18156,83889618,83890815,True,1,1197
18157,83889618,83891209,False,2,1591
18158,83889618,83891209,True,1,1591
18159,83889618,83892580,False,2,2962
18160,83889618,83894161,False,1,4543
18161,83897390,83903015,False,1,5625
18162,83898310,83898971,True,1,661
18163,83905332,83913633,True,2,8301
18164,83906491,83907214,True,1,723
18165,83907028,83907142,True,1,114
18166,83907049,83907145,True,1,96
18167,83908077,83909367,True,6,1290
18168,83914200,83924858,True,1,10658
18169,83919530,83919920,True,1,390
18170,83921548,83922638,False,1,1090
18171,83922465,83945060,False,2,22595
18172,83922465,83966565,False,1,44100
18173,83927780,83972687,True,1,44907
18174,83946333,83946699,True,1,366
18175,83948969,83950520,True,1,1551
18176,83948972,83950520,False,1,1548
18177,83948972,83950520,True,1,1548
18178,83981226,83983611,False,1,2385
18179,83985299,83996153,True,2,10854
18180,83991225,83993292,False,1,2067
18181,83991225,83993292,True,1,2067
18182,84006786,84007739,True,2,953
18183,84009167,84009450,False,1,283
18184,84021086,84022457,True,1,1371
18185,84021086,84022595,False,1,1509
18186,84021086,84022595,True,1,1509
18187,84024611,84025628,True,1,1017
18188,84034643,84035286,True,3,643
18189,84035443,84041473,True,1,6030
18190,84036491,84036680,True,1,189
18191,84036574,84037343,True,5,769
18192,84037546,84037750,True,1,204
18193,84038186,84038300,True,1,114
18194,84053511,84055096,True,1,1585
18195,84060454,84060581,True,1,127
18196,84060665,84060770,True,1,105
18197,84063433,84063960,True,1,527
18198,84065904,84068648,True,6,2744
18199,84081959,84082141,True,1,182
18200,84111805,84126919,False,1,15114
18201,84133439,84133994,True,5,555
18202,84134951,84159383,True,1,24432
18203,84140472,84141055,True,1,583
18204,84141135,84146182,True,2,5047
18205,84154528,84312818,True,1,158290
18206,84164488,84165034,True,2,546
18207,84165220,84166080,False,1,860
18208,84165220,84166080,True,2,860
18209,84166996,84167286,True,1,290
18210,84173283,84173502,True,2,219
18211,84173393,84176011,True,1,2618
18212,84178159,84178930,True,2,771
18213,84191233,84194850,False,1,3617
18214,84191233,84194850,True,2,3617
18215,84201286,84201830,False,1,544
18216,84209564,84209828,True,1,264
18217,84209612,84222183,False,1,12571
18218,84209612,84224361,False,1,14749
18219,84225670,84226780,True,2,1110
18220,84229685,84232292,False,1,2607
18221,84232621,84234938,True,1,2317
18222,84232621,84235009,True,1,2388
18223,84240668,84241582,False,1,914
18224,84240668,84247218,True,3,6550
18225,84240668,84247372,True,1,6704
18226,84240719,84474575,True,1,233856
18227,84244285,84249572,True,1,5287
18228,84246474,84253799,True,2,7325
18229,84246474,84264212,True,1,17738
18230,84251111,84251384,True,1,273
18231,84252001,84252499,True,1,498
18232,84254028,84254111,True,1,83
18233,84257806,84258418,False,3,612
18234,84257806,84258418,True,6,612
18235,84257806,84274969,True,1,17163
18236,84258116,84258242,True,1,126
18237,84262130,84263364,True,1,1234
18238,84265797,84299655,True,3,33858
18239,84271515,84271754,True,1,239
18240,84272703,84278516,True,1,5813
18241,84281169,84282408,True,1,1239
18242,84283401,84285562,True,1,2161
18243,84286491,84286722,True,3,231
18244,84296648,84297091,True,1,443
18245,84296648,84299623,True,1,2975
18246,84296707,84299623,True,1,2916
18247,84296717,84298013,True,3,1296
18248,84303701,84304437,True,1,736
18249,84308905,84321056,True,1,12151
18250,84309903,84309986,True,4,83
18251,84313447,84315371,False,1,1924
18252,84314681,84315198,True,1,517
18253,84318978,84319069,True,2,91
18254,84321172,84321588,True,1,416
18255,84328260,84337140,True,1,8880
18256,84337168,84337611,True,1,443
18257,84337738,84338181,True,1,443
18258,84339378,84369167,True,1,29789
18259,84340686,84342288,False,1,1602
18260,84344321,84346760,False,1,2439
18261,84350648,84351132,True,2,484
18262,84355217,84357709,True,3,2492
18263,84355921,84358536,True,1,2615
18264,84356836,84359471,True,1,2635
18265,84362734,84372091,True,1,9357
18266,84366742,84369767,True,1,3025
18267,84375433,84382745,False,1,7312
18268,84375433,84382745,True,2,7312
18269,84381817,84409030,True,2,27213
18270,84385017,84393533,True,1,8516
18271,84387680,84388865,True,1,1185
18272,84389075,84393085,True,5,4010
18273,84389907,84390442,True,1,535
18274,84392175,84392500,True,3,325
18275,84392175,84398441,True,1,6266
18276,84393447,84401554,True,2,8107
18277,84403625,84419964,True,1,16339
18278,84418620,84419386,True,1,766
18279,84425243,84426126,True,3,883
18280,84438786,84441842,True,3,3056
18281,84439252,84442914,False,1,3662
18282,84439252,84442914,True,1,3662
18283,84439272,84442909,False,1,3637
18284,84439272,84442909,True,1,3637
18285,84451620,84457147,False,1,5527
18286,84458467,84491938,True,1,33471
18287,84463462,84463862,True,1,400
18288,84469163,84479761,True,1,10598
18289,84474822,84505610,False,1,30788
18290,84496531,84497485,False,1,954
18291,84496531,84497485,True,1,954
18292,84498724,84500639,False,1,1915
18293,84498724,84500639,True,1,1915
18294,84503523,84504327,True,1,804
18295,84507351,84512330,False,1,4979
18296,84508525,84512330,False,1,3805
18297,84519007,84519903,True,1,896
18298,84520497,84541275,True,1,20778
18299,84521848,84542000,True,1,20152
18300,84528830,84529395,True,2,565
18301,84528830,84530741,True,2,1911
18302,84529684,84530874,True,1,1190
18303,84530154,84531344,True,1,1190
18304,84533056,84533179,False,1,123
18305,84533931,84536692,False,1,2761
18306,84540951,84541055,True,3,104
18307,84549464,84560253,True,4,10789
18308,84549951,84550411,True,3,460
18309,84551138,84555537,True,1,4399
18310,84567135,84567220,True,4,85
18311,84573628,84573730,True,1,102
18312,84587350,84588976,True,1,1626
18313,84591651,84598152,True,2,6501
18314,84599040,84604224,True,2,5184
18315,84601194,84602040,False,1,846
18316,84601194,84602040,True,2,846
18317,84609370,84610433,True,1,1063
18318,84611708,84611967,True,1,259
18319,84626975,84627399,False,1,424
18320,84642593,84643138,True,2,545
18321,84653663,84654282,True,2,619
18322,84669940,84670881,True,1,941
18323,84669940,84674352,True,1,4412
18324,84669940,84675967,True,1,6027
18325,84681488,84682095,True,1,607
18326,84682568,84683156,True,2,588
18327,84696615,84701864,False,1,5249
18328,84698089,84700514,True,1,2425
18329,84698249,84700576,True,2,2327
18330,84709780,84709854,True,1,74
18331,84721019,84721985,True,1,966
18332,84728346,84728830,True,1,484
18333,84736919,84740225,True,2,3306
18334,84746008,84750577,True,3,4569
18335,84746008,84754916,True,1,8908
18336,84758514,84759286,False,1,772
18337,84762642,84764247,True,2,1605
18338,84772233,84775872,True,3,3639
18339,84774622,84779399,True,4,4777
18340,84777005,84780578,True,2,3573
18341,84789612,84810041,False,1,20429
18342,84789612,84810041,True,1,20429
18343,84789612,84810734,True,1,21122
18344,84792639,84797907,True,1,5268
18345,84793265,84869132,True,3,75867
18346,84793565,84798327,True,1,4762
18347,84794236,84798548,True,1,4312
18348,84794280,84798374,True,1,4094
18349,84794476,84794554,True,3,78
18350,84796922,84797062,True,2,140
18351,84798980,84799869,True,1,889
18352,84800205,84802882,True,1,2677
18353,84803828,84807127,True,1,3299
18354,84825421,84827033,True,3,1612
18355,84831472,84831671,False,1,199
18356,84845192,84849014,True,1,3822
18357,84847933,84989840,True,1,141907
18358,84849253,84938733,True,1,89480
18359,84849253,84990517,True,1,141264
18360,84850233,84908430,True,1,58197
18361,84863659,84864181,True,1,522
18362,84867733,84868055,True,6,322
18363,84877400,84884110,True,1,6710
18364,84899340,84901269,True,1,1929
18365,84903925,84904776,True,3,851
18366,84904375,84904490,True,1,115
18367,84910754,84911263,True,1,509
18368,84921918,84922000,True,1,82
18369,84936136,84936794,False,1,658
18370,84937691,84938155,False,1,464
18371,84940599,84941827,True,1,1228
18372,84941850,84942132,True,4,282
18373,84942225,84942545,True,1,320
18374,84951465,84955931,True,3,4466
18375,84951652,84953621,True,1,1969
18376,84957396,84966889,True,2,9493
18377,84963847,84964591,True,1,744
18378,84969547,84970575,False,1,1028
18379,84974121,84974235,False,2,114
18380,85001850,85005888,False,1,4038
18381,85005918,85009949,True,2,4031
18382,85006672,85012724,True,1,6052
18383,85026581,85028427,True,1,1846
18384,85028768,85033313,False,1,4545
18385,85045254,85045351,True,3,97
18386,85046847,85048798,True,1,1951
18387,85050580,85053592,True,1,3012
18388,85051078,85051549,True,1,471
18389,85056912,85058622,True,2,1710
18390,85061960,85085031,True,1,23071
18391,85063894,85073229,True,2,9335
18392,85071674,85077839,False,1,6165
18393,85072680,85072777,False,1,97
18394,85072680,85072777,True,3,97
18395,85073272,85073725,False,1,453
18396,85074846,85075037,True,1,191
18397,85080229,85137918,True,3,57689
18398,85087121,85145496,False,1,58375
18399,85087121,85145496,True,2,58375
18400,85088379,85099359,True,1,10980
18401,85088408,85099342,True,1,10934
18402,85088408,85104816,True,2,16408
18403,85089629,85128567,True,1,38938
18404,85089629,85146786,True,1,57157
18405,85091936,85096961,True,1,5025
18406,85096397,85114108,True,1,17711
18407,85096945,85114278,True,1,17333
18408,85099456,85115621,True,1,16165
18409,85100399,85116145,True,1,15746
18410,85101323,85103289,True,1,1966
18411,85105302,85116419,True,1,11117
18412,85105534,85106319,True,4,785
18413,85113382,85120631,True,1,7249
18414,85113382,85121869,True,1,8487
18415,85131608,85194700,True,1,63092
18416,85132011,85195103,True,3,63092
18417,85132011,85254955,True,1,122944
18418,85132097,85132219,True,1,122
18419,85133073,85134909,True,2,1836
18420,85145741,85155365,True,1,9624
18421,85146646,85147017,True,1,371
18422,85149213,85176540,True,1,27327
18423,85156143,85157994,False,1,1851
18424,85156143,85157994,True,1,1851
18425,85160727,85163026,True,1,2299
18426,85165724,85166546,True,1,822
18427,85169807,85169999,False,1,192
18428,85169928,85185140,True,1,15212
18429,85179607,85186878,True,3,7271
18430,85179607,85188526,True,1,8919
18431,85184398,85186878,True,1,2480
18432,85186004,85186480,True,3,476
18433,85192401,85193958,True,1,1557
18434,85216232,85218766,True,2,2534
18435,85228433,85237067,True,1,8634
18436,85235878,85265184,False,1,29306
18437,85238302,85239440,True,1,1138
18438,85245943,85324439,True,2,78496
18439,85254824,85256424,True,1,1600
18440,85257002,85257433,True,1,431
18441,85264755,85265312,True,1,557
18442,85273693,85273835,False,1,142
18443,85280714,85281879,True,2,1165
18444,85282599,85282836,True,1,237
18445,85284416,85284620,True,5,204
18446,85287705,85289795,True,4,2090
18447,85293188,85323216,True,2,30028
18448,85301629,85303310,False,1,1681
18449,85304009,85328376,True,3,24367
18450,85311412,85312593,True,1,1181
18451,85313578,85316577,False,1,2999
18452,85324163,85333191,True,1,9028
18453,85330577,85336433,True,1,5856
18454,85331789,85335656,False,1,3867
18455,85335512,85347587,True,1,12075
18456,85339261,85341205,False,1,1944
18457,85340875,85389131,True,1,48256
18458,85340875,85389164,True,1,48289
18459,85341485,85342768,True,2,1283
18460,85352413,85367559,False,1,15146
18461,85352413,85371024,True,1,18611
18462,85377485,85383508,True,1,6023
18463,85377485,85398963,True,1,21478
18464,85385295,85386143,True,1,848
18465,85385295,85389981,True,1,4686
18466,85389343,85389577,True,1,234
18467,85390550,85394940,True,1,4390
18468,85394129,85395098,True,1,969
18469,85394129,85397383,True,1,3254
18470,85394129,85398475,True,2,4346
18471,85401316,85412852,False,1,11536
18472,85406725,85408883,True,1,2158
18473,85406725,85408945,True,1,2220
18474,85406725,85411356,False,1,4631
18475,85406725,85416594,False,3,9869
18476,85406725,85416594,True,3,9869
18477,85406725,85422027,True,1,15302
18478,85410919,85425336,True,1,14417
18479,85412887,85413377,True,1,490
18480,85414578,85415021,True,4,443
18481,85420008,85425323,True,5,5315
18482,85424462,85426708,False,1,2246
18483,85424462,85441602,False,1,17140
18484,85424462,85441602,True,3,17140
18485,85433484,85437043,True,1,3559
18486,85439977,85443569,True,1,3592
18487,85439977,85446406,False,1,6429
18488,85439977,85446406,True,4,6429
18489,85439977,85449629,True,7,9652
18490,85443854,85444009,True,1,155
18491,85449030,85452856,True,1,3826
18492,85455272,85456642,True,1,1370
18493,85467811,85468254,True,1,443
18494,85467931,85469143,False,1,1212
18495,85467931,85482710,True,1,14779
18496,85468521,85468721,True,2,200
18497,85469356,85470544,True,2,1188
18498,85477642,85479054,True,1,1412
18499,85482479,85483756,True,1,1277
18500,85484287,85490772,False,1,6485
18501,85484990,85485235,False,1,245
18502,85484990,85486227,True,1,1237
18503,85485341,85486227,True,1,886
18504,85486120,85491122,True,1,5002
18505,85496145,85509117,True,1,12972
18506,85499628,85527831,True,1,28203
18507,85499628,85539543,True,2,39915
18508,85500504,85501047,True,1,543
18509,85504363,85513346,True,2,8983
18510,85505606,85505693,True,2,87
18511,85511215,85512755,False,1,1540
18512,85511215,85512755,True,1,1540
18513,85511215,85514173,True,1,2958
18514,85513906,85516139,True,2,2233
18515,85521684,85525253,True,1,3569
18516,85524099,85528981,True,1,4882
18517,85541769,85544718,True,1,2949
18518,85543496,85550613,False,1,7117
18519,85548216,85556531,False,1,8315
18520,85557639,85559406,True,1,1767
18521,85562528,85568561,True,1,6033
18522,85572182,85572645,False,1,463
18523,85572182,85572645,True,3,463
18524,85572535,85572899,True,1,364
18525,85575414,85591532,True,2,16118
18526,85577150,85581711,True,1,4561
18527,85577613,85580056,True,1,2443
18528,85577739,85579737,True,1,1998
18529,85577744,85578547,True,2,803
18530,85585263,85586282,True,1,1019
18531,85586102,85856142,True,1,270040
18532,85590550,85592759,True,1,2209
18533,85591583,85593245,True,1,1662
18534,85596167,85597108,True,1,941
18535,85596167,85597657,True,1,1490
18536,85601414,85604737,False,1,3323
18537,85601414,85604737,True,3,3323
18538,85602701,85605304,True,3,2603
18539,85612068,85620421,True,1,8353
18540,85612938,85620012,True,2,7074
18541,85627262,85627346,True,1,84
18542,85635124,85635898,True,1,774
18543,85650959,85656179,True,1,5220
18544,85651211,85651917,True,3,706
18545,85660342,85667515,True,2,7173
18546,85661001,85663260,False,1,2259
18547,85671041,85671992,True,2,951
18548,85673195,85673655,True,2,460
18549,85674557,85676136,True,2,1579
18550,85679316,85683125,False,1,3809
18551,85679473,85679981,True,1,508
18552,85679717,85683247,False,1,3530
18553,85679717,85693180,False,1,13463
18554,85679856,85683251,False,1,3395
18555,85682173,85691404,True,1,9231
18556,85682173,85692545,True,2,10372
18557,85690428,85698043,False,1,7615
18558,85692443,85694548,False,1,2105
18559,85692581,85693000,False,1,419
18560,85692652,85706408,True,1,13756
18561,85693235,85711540,True,1,18305
18562,85695359,85696267,True,5,908
18563,85695359,85698857,True,2,3498
18564,85701988,85712085,False,1,10097
18565,85701988,85712085,True,1,10097
18566,85701988,85756920,True,1,54932
18567,85706606,85710334,True,4,3728
18568,85709808,85709900,True,1,92
18569,85716370,85717468,False,1,1098
18570,85726640,85727297,True,1,657
18571,85735816,85743398,True,1,7582
18572,85747557,85748021,True,1,464
18573,85751580,85761529,True,1,9949
18574,85752051,85761688,True,5,9637
18575,85752051,85767765,True,1,15714
18576,85759020,85760575,True,3,1555
18577,85767591,85773680,True,2,6089
18578,85767591,85774489,True,2,6898
18579,85767591,85774607,True,1,7016
18580,85767591,85775691,True,1,8100
18581,85782564,85782660,True,2,96
18582,85790949,85860189,True,1,69240
18583,85792529,85794812,True,2,2283
18584,85793282,85794213,False,2,931
18585,85794318,85794442,False,1,124
18586,85794318,85799070,True,1,4752
18587,85794318,85800169,True,1,5851
18588,85802675,85890545,False,1,87870
18589,85809262,85810766,False,1,1504
18590,85811892,85812422,True,1,530
18591,85813341,85814450,True,2,1109
18592,85823130,85825674,True,1,2544
18593,85823130,85830683,False,1,7553
18594,85823130,85830683,True,1,7553
18595,85824400,85824509,True,1,109
18596,85844471,85845088,True,1,617
18597,85844916,85845088,True,1,172
18598,85845883,85847818,True,1,1935
18599,85847514,85849146,True,1,1632
18600,85850889,85851889,True,1,1000
18601,85856391,85856730,True,4,339
18602,85857210,85858447,True,1,1237
18603,85857262,85917152,False,1,59890
18604,85857262,85917191,False,1,59929
18605,85857262,86083143,False,1,225881
18606,85858352,85867815,True,1,9463
18607,85863819,85864136,False,1,317
18608,85863819,85864136,True,1,317
18609,85865827,85869820,True,1,3993
18610,85871076,85874810,True,1,3734
18611,85895061,85896913,True,1,1852
18612,85895590,85897169,True,2,1579
18613,85896662,85928743,True,1,32081
18614,85897354,85901313,True,2,3959
18615,85899386,85900383,True,1,997
18616,85899391,85900383,True,2,992
18617,85899972,85900866,False,2,894
18618,85899972,85900866,True,2,894
18619,85899972,85901160,True,1,1188
18620,85903908,85921912,False,1,18004
18621,85904678,85909583,True,4,4905
18622,85904678,85926906,True,1,22228
18623,85911499,85918366,True,1,6867
18624,85913750,85913836,True,1,86
18625,85919215,85920607,True,1,1392
18626,85925652,85927255,False,1,1603
18627,85931855,85935631,True,1,3776
18628,85940089,85941200,False,1,1111
18629,85942266,85943645,False,2,1379
18630,85942487,85943782,False,1,1295
18631,85944053,85946490,False,1,2437
18632,85944053,85946490,True,1,2437
18633,85948654,85948884,True,1,230
18634,85954276,85955435,True,1,1159
18635,85954290,85955435,True,2,1145
18636,85954306,85955435,True,3,1129
18637,85955780,85958173,True,1,2393
18638,85960325,85960628,True,1,303
18639,85960605,85962898,True,1,2293
18640,85961700,85963236,False,1,1536
18641,85961700,85963236,True,3,1536
18642,85961700,85967685,False,1,5985
18643,85961700,85967685,True,1,5985
18644,85962853,85962969,False,1,116
18645,85963926,85966710,False,1,2784
18646,85963926,85966710,True,2,2784
18647,85967749,85968423,True,1,674
18648,85968933,86003536,True,1,34603
18649,85968933,86019136,True,3,50203
18650,85969806,85970311,True,1,505
18651,85971266,85976441,False,1,5175
18652,85974662,85975015,True,1,353
18653,85975060,85975636,True,1,576
18654,85977427,85977641,False,1,214
18655,85978906,85982105,True,1,3199
18656,85988883,85988961,True,1,78
18657,85991348,85997680,True,1,6332
18658,85991657,85995694,False,1,4037
18659,85994748,86007478,True,1,12730
18660,86001219,86002704,True,1,1485
18661,86003155,86014667,False,1,11512
18662,86004418,86034111,True,1,29693
18663,86005632,86005858,True,1,226
18664,86005945,86006433,True,2,488
18665,86011103,86011357,True,3,254
18666,86012906,86019543,False,1,6637
18667,86017376,86019308,False,1,1932
18668,86024837,86026496,False,1,1659
18669,86024837,86026496,True,7,1659
18670,86025535,86027588,False,3,2053
18671,86029796,86033638,True,5,3842
18672,86030082,86031292,False,1,1210
18673,86030082,86032004,False,1,1922
18674,86032573,86033099,False,1,526
18675,86032573,86033099,True,2,526
18676,86036460,86045369,False,1,8909
18677,86041660,86094561,True,1,52901
18678,86041895,86094515,False,1,52620
18679,86041895,86094515,True,1,52620
18680,86041895,86115769,True,1,73874
18681,86043990,86045047,True,1,1057
18682,86045918,86048082,True,1,2164
18683,86046052,86048082,True,1,2030
18684,86047291,86047400,True,1,109
18685,86049136,86049823,False,1,687
18686,86050364,86050765,True,1,401
18687,86051279,86052224,True,1,945
18688,86051279,86052330,True,1,1051
18689,86054565,86056189,True,3,1624
18690,86055552,86056679,True,1,1127
18691,86055604,86056675,True,1,1071
18692,86055627,86058100,False,1,2473
18693,86055627,86058815,False,1,3188
18694,86055646,86055886,True,1,240
18695,86056524,86057228,True,1,704
18696,86060022,86061087,True,1,1065
18697,86060022,86064591,True,3,4569
18698,86064373,86064810,False,1,437
18699,86072696,86086081,False,1,13385
18700,86074795,86081878,True,1,7083
18701,86074996,86080711,True,2,5715
18702,86083652,86085248,False,1,1596
18703,86085904,86086778,False,1,874
18704,86088310,86140718,False,2,52408
18705,86088310,86140718,True,5,52408
18706,86089275,86141264,True,1,51989
18707,86126730,86135334,False,1,8604
18708,86135012,86135194,False,1,182
18709,86138555,86144730,True,1,6175
18710,86139756,86159671,False,1,19915
18711,86155612,86167082,False,1,11470
18712,86155612,86167082,True,1,11470
18713,86169899,86171750,True,1,1851
18714,86174701,86194282,True,1,19581
18715,86174701,86211929,True,1,37228
18716,86178129,86179621,True,2,1492
18717,86178129,86179705,True,1,1576
18718,86178129,86204927,True,1,26798
18719,86181324,86184205,True,1,2881
18720,86182297,86183466,True,2,1169
18721,86199131,86207942,False,1,8811
18722,86200583,86206743,True,1,6160
18723,86202797,86208163,True,3,5366
18724,86209156,86211787,True,1,2631
18725,86209156,86213148,True,2,3992
18726,86217692,86223842,True,1,6150
18727,86222632,86222775,True,1,143
18728,86228843,86231052,False,1,2209
18729,86242209,86243123,True,2,914
18730,86243239,86243748,True,1,509
18731,86243311,86243780,False,2,469
18732,86243311,86243780,True,1,469
18733,86243311,86243785,True,1,474
18734,86243748,86252698,True,1,8950
18735,86243748,86268046,True,1,24298
18736,86244424,86245454,True,1,1030
18737,86248230,86248560,True,2,330
18738,86249628,86249778,True,1,150
18739,86249859,86253760,True,1,3901
18740,86256975,86257612,True,3,637
18741,86264839,86265388,False,1,549
18742,86264839,86265388,True,1,549
18743,86273299,86273754,False,1,455
18744,86273970,86277626,True,1,3656
18745,86277507,86297689,True,1,20182
18746,86277507,86302553,False,1,25046
18747,86278826,86280502,True,1,1676
18748,86280316,86281710,True,1,1394
18749,86281343,86283163,False,1,1820
18750,86288896,86291219,False,1,2323
18751,86295510,86299745,True,2,4235
18752,86296467,86297137,True,1,670
18753,86296948,86303550,True,1,6602
18754,86299908,86301959,True,4,2051
18755,86304733,86305951,True,1,1218
18756,86304733,86435669,True,1,130936
18757,86307329,86504699,True,1,197370
18758,86309498,86310114,True,1,616
18759,86315668,86316038,False,1,370
18760,86321054,86371659,True,2,50605
18761,86321054,86378871,True,1,57817
18762,86321685,86323568,True,1,1883
18763,86338812,86347811,False,1,8999
18764,86360807,86361393,True,1,586
18765,86363184,86364349,True,1,1165
18766,86379079,86379236,True,1,157
18767,86384682,86437351,True,1,52669
18768,86386142,86387574,True,2,1432
18769,86386711,86438135,True,1,51424
18770,86386985,86387135,True,1,150
18771,86387247,86387429,True,1,182
18772,86390312,86399359,True,1,9047
18773,86399568,86400310,True,1,742
18774,86400464,86402661,True,1,2197
18775,86400464,86402853,True,1,2389
18776,86419996,86422672,True,1,2676
18777,86422667,86425564,True,1,2897
18778,86424528,86424927,True,1,399
18779,86424528,86424946,True,1,418
18780,86425088,86425397,True,1,309
18781,86426333,86426486,True,4,153
18782,86426417,86426880,True,1,463
18783,86426612,86426878,True,1,266
18784,86440266,86441254,True,2,988
18785,86443035,86444023,True,2,988
18786,86452035,86453885,False,1,1850
18787,86452035,86453885,True,1,1850
18788,86453816,86457846,True,1,4030
18789,86461614,86467905,True,1,6291
18790,86465976,86466093,True,1,117
18791,86466803,86606180,True,1,139377
18792,86472765,86477555,True,1,4790
18793,86476573,86478116,True,1,1543
18794,86476573,86478378,True,1,1805
18795,86478567,86479376,True,1,809
18796,86478681,86479398,True,1,717
18797,86493868,86494500,False,1,632
18798,86496650,86497100,True,1,450
18799,86502514,86503180,True,1,666
18800,86507395,86508597,True,1,1202
18801,86514366,86515321,True,3,955
18802,86514366,86605347,False,1,90981
18803,86517123,86517522,True,1,399
18804,86532486,86532825,True,1,339
18805,86532486,86533123,True,3,637
18806,86533246,86537912,True,3,4666
18807,86545893,86554822,True,1,8929
18808,86546823,86547013,True,1,190
18809,86547565,86547658,True,1,93
18810,86556231,86557761,True,1,1530
18811,86557864,86564908,False,1,7044
18812,86565699,86572992,False,1,7293
18813,86565699,86574067,True,1,8368
18814,86565699,86574115,True,1,8416
18815,86567883,86573866,True,1,5983
18816,86570783,86572725,False,1,1942
18817,86578893,86580145,True,3,1252
18818,86581412,86586441,False,1,5029
18819,86582657,86587361,True,1,4704
18820,86592177,86593269,False,1,1092
18821,86592371,86596292,True,1,3921
18822,86598911,86607260,True,1,8349
18823,86608329,86609004,False,1,675
18824,86608329,86609004,True,6,675
18825,86612047,86612333,True,1,286
18826,86614300,86617180,True,1,2880
18827,86614671,86624378,True,5,9707
18828,86615920,86617144,True,1,1224
18829,86616024,86617702,True,1,1678
18830,86619429,86619971,True,1,542
18831,86620700,86621242,True,1,542
18832,86620892,86621241,True,1,349
18833,86624571,86627203,True,2,2632
18834,86624571,86628862,True,1,4291
18835,86630045,86631580,True,1,1535
18836,86637092,86637242,True,1,150
18837,86638726,86638919,False,1,193
18838,86641171,86641640,True,1,469
18839,86642919,86646892,True,1,3973
18840,86646671,86659046,False,1,12375
18841,86650672,86669780,False,1,19108
18842,86652079,86652977,False,1,898
18843,86656170,86659233,True,1,3063
18844,86656170,86669247,True,1,13077
18845,86656170,86672591,True,1,16421
18846,86656170,86701662,True,1,45492
18847,86663639,86664239,True,2,600
18848,86667250,86673473,True,1,6223
18849,86667250,86673692,True,3,6442
18850,86667250,86675873,True,1,8623
18851,86679267,86683172,False,1,3905
18852,86679267,86684035,False,1,4768
18853,86680540,86682558,True,1,2018
18854,86682654,86683015,False,1,361
18855,86682654,86683015,True,3,361
18856,86682682,86684593,False,1,1911
18857,86687975,86692420,True,2,4445
18858,86689873,86718248,True,1,28375
18859,86711485,86713873,True,1,2388
18860,86711485,86713879,True,1,2394
18861,86741828,86742863,True,2,1035
18862,86741914,86742863,True,2,949
18863,86743864,86744263,True,1,399
18864,86749321,86753255,True,1,3934
18865,86753737,86758648,False,1,4911
18866,86754333,86758648,False,1,4315
18867,86761097,86781215,True,2,20118
18868,86763753,86770049,True,2,6296
18869,86764056,86765967,True,1,1911
18870,86765437,86765981,True,2,544
18871,86779879,86781231,False,1,1352
18872,86783957,86784319,True,1,362
18873,86790786,86790995,True,1,209
18874,86800586,86801845,True,1,1259
18875,86801654,86811982,True,1,10328
18876,86807133,86807362,True,1,229
18877,86811289,86822536,True,1,11247
18878,86812831,86817305,True,2,4474
18879,86815640,86818839,True,1,3199
18880,86816283,86822035,True,1,5752
18881,86816283,86881918,True,4,65635
18882,86818203,86826047,False,1,7844
18883,86818937,86819539,True,1,602
18884,86821156,86829396,True,1,8240
18885,86821156,86829943,True,1,8787
18886,86821156,86837298,True,1,16142
18887,86826818,86835058,True,1,8240
18888,86826818,86835605,True,1,8787
18889,86836053,86836580,True,1,527
18890,86837101,86837765,True,2,664
18891,86849967,86860637,False,1,10670
18892,86851901,86852174,True,1,273
18893,86853020,86854162,True,1,1142
18894,86857259,86858206,True,2,947
18895,86860187,86863109,True,1,2922
18896,86870860,86871805,False,1,945
18897,86871433,86877936,True,4,6503
18898,86875819,86876315,False,2,496
18899,86875819,86876315,True,2,496
18900,86890626,86891083,True,4,457
18901,86890626,86910877,True,2,20251
18902,86891012,86898111,True,3,7099
18903,86902431,86902942,True,1,511
18904,86914862,86922938,True,2,8076
18905,86914980,86922831,True,1,7851
18906,86916456,86917824,False,1,1368
18907,86916456,86917824,True,3,1368
18908,86923161,86923868,True,1,707
18909,86923161,86929666,True,1,6505
18910,86938688,86939282,True,1,594
18911,86939872,86940109,True,1,237
18912,86941943,86942882,True,1,939
18913,86944266,86944375,True,2,109
18914,86949748,86949894,True,3,146
18915,86950292,86954957,True,1,4665
18916,86955270,86955481,False,1,211
18917,86955270,86955481,True,5,211
18918,86955270,86958860,True,1,3590
18919,86956448,86959412,True,1,2964
18920,86959617,86959740,True,2,123
18921,86966390,86979179,True,2,12789
18922,86969692,86969818,True,2,126
18923,86974015,86974811,True,1,796
18924,86975875,86978313,True,1,2438
18925,86979087,86983465,True,4,4378
18926,86981810,86982274,True,1,464
18927,86982926,86987537,True,2,4611
18928,87010922,87012038,True,1,1116
18929,87010922,87013802,False,3,2880
18930,87010922,87015806,True,1,4884
18931,87010996,87013814,True,1,2818
18932,87012147,87014328,True,1,2181
18933,87013562,87026773,True,1,13211
18934,87014380,87015702,True,1,1322
18935,87024002,87025916,True,2,1914
18936,87024070,87025916,True,1,1846
18937,87028600,87030106,False,1,1506
18938,87028600,87030106,True,2,1506
18939,87028870,87030630,True,1,1760
18940,87028870,87044513,True,1,15643
18941,87029816,87031262,True,1,1446
18942,87029816,87056913,True,1,27097
18943,87034066,87034549,True,1,483
18944,87046388,87050647,True,1,4259
18945,87050334,87050542,True,3,208
18946,87053940,87056255,True,3,2315
18947,87057703,87061296,True,1,3593
18948,87057703,87065377,False,1,7674
18949,87057703,87065377,True,1,7674
18950,87061941,87067050,True,1,5109
18951,87077679,87080001,False,1,2322
18952,87077679,87080001,True,1,2322
18953,87081689,87081823,True,1,134
18954,87088054,87093928,True,1,5874
18955,87088054,87094619,False,1,6565
18956,87088054,87094619,True,1,6565
18957,87095129,87102733,True,1,7604
18958,87095129,87104575,True,1,9446
18959,87095722,87095893,True,1,171
18960,87096071,87103152,True,1,7081
18961,87096166,87103154,True,1,6988
18962,87098172,87098906,False,1,734
18963,87105690,87111892,False,1,6202
18964,87109750,87119955,True,1,10205
18965,87122645,87124849,True,2,2204
18966,87126792,87127405,False,1,613
18967,87126792,87127405,True,2,613
18968,87128917,87132167,True,2,3250
18969,87130099,87136284,False,1,6185
18970,87137114,87139028,True,1,1914
18971,87137290,87137536,True,1,246
18972,87141523,87195255,True,1,53732
18973,87142624,87142862,True,1,238
18974,87145295,87168421,True,2,23126
18975,87149323,87156853,False,1,7530
18976,87158079,87164269,False,1,6190
18977,87161516,87203793,True,1,42277
18978,87171761,87196614,False,1,24853
18979,87177744,87177955,True,2,211
18980,87181978,87182170,True,1,192
18981,87185459,87209241,True,1,23782
18982,87185459,87212842,True,1,27383
18983,87185459,87215683,False,1,30224
18984,87185459,87217805,False,1,32346
18985,87186528,87186640,False,1,112
18986,87189155,87189732,False,1,577
18987,87190363,87195836,True,4,5473
18988,87193445,87195378,True,2,1933
18989,87193445,87213234,True,2,19789
18990,87193445,87216835,True,1,23390
18991,87193591,87195378,True,3,1787
18992,87193591,87213234,True,1,19643
18993,87193591,87219676,True,1,26085
18994,87194784,87198207,True,1,3423
18995,87195231,87237181,True,1,41950
18996,87197459,87218796,True,1,21337
18997,87199383,87202766,True,1,3383
18998,87201004,87202185,True,1,1181
18999,87205782,87212033,True,1,6251
19000,87206624,87212471,True,1,5847
19001,87207234,87207692,True,1,458
19002,87225828,87230876,True,2,5048
19003,87227348,87230023,True,1,2675
19004,87239757,87241483,True,2,1726
19005,87245739,87258189,True,1,12450
19006,87245928,87246967,True,1,1039
19007,87245928,87248378,True,1,2450
19008,87246480,87246559,False,1,79
19009,87250387,87280346,True,1,29959
19010,87252721,87253755,True,3,1034
19011,87252879,87253133,True,1,254
19012,87254790,87255366,False,2,576
19013,87260008,87260156,True,3,148
19014,87265012,87267652,True,1,2640
19015,87267907,87284235,True,2,16328
19016,87268541,87285073,True,1,16532
19017,87272484,87281965,True,1,9481
19018,87276124,87276401,True,2,277
19019,87276124,87276404,True,2,280
19020,87278576,87281870,True,2,3294
19021,87278576,87282162,True,1,3586
19022,87278680,87285045,True,2,6365
19023,87280163,87285786,True,2,5623
19024,87291903,87294365,True,1,2462
19025,87297294,87318835,False,1,21541
19026,87297294,87327100,False,1,29806
19027,87304508,87306480,False,1,1972
19028,87304508,87306480,True,2,1972
19029,87304508,87306691,True,1,2183
19030,87304508,87311488,True,1,6980
19031,87310608,87312588,True,1,1980
19032,87312637,87314258,True,1,1621
19033,87326942,87331606,True,2,4664
19034,87328438,87328577,True,5,139
19035,87337523,87337910,False,1,387
19036,87339092,87339181,True,1,89
19037,87343757,87349796,False,1,6039
19038,87343977,87349901,False,1,5924
19039,87344181,87346099,True,1,1918
19040,87344249,87346099,True,1,1850
19041,87358125,87359015,True,3,890
19042,87368704,87369455,True,2,751
19043,87370263,87394532,False,1,24269
19044,87370263,87394532,True,1,24269
19045,87381699,87381905,True,2,206
19046,87393724,87394597,True,1,873
19047,87394393,87395343,True,3,950
19048,87395447,87396981,False,1,1534
19049,87395447,87396981,True,1,1534
19050,87396498,87397252,False,1,754
19051,87398680,87406541,True,1,7861
19052,87399179,87399550,True,5,371
19053,87404679,87474601,False,1,69922
19054,87404679,87474601,True,1,69922
19055,87412093,87413986,True,1,1893
19056,87415426,87415840,True,1,414
19057,87432569,87435345,False,1,2776
19058,87433226,87434093,False,2,867
19059,87444930,87447250,True,2,2320
19060,87464155,87465369,True,1,1214
19061,87464905,87473140,True,1,8235
19062,87471420,87471919,True,1,499
19063,87471420,87472014,True,1,594
19064,87476746,87477131,True,1,385
19065,87476994,87480021,True,10,3027
19066,87491732,87492083,False,1,351
19067,87496112,87498296,True,1,2184
19068,87496334,87496477,True,2,143
19069,87504650,87504812,True,1,162
19070,87508283,87549762,True,2,41479
19071,87515232,87519786,True,4,4554
19072,87523919,87527321,True,1,3402
19073,87533121,87534059,True,1,938
19074,87533365,87537085,True,6,3720
19075,87533365,87537168,True,1,3803
19076,87541440,87541506,True,1,66
19077,87545756,87545913,True,1,157
19078,87558684,87562688,True,1,4004
19079,87564994,87565752,True,1,758
19080,87566925,87570602,True,1,3677
19081,87573860,87573945,False,1,85
19082,87575922,87585852,True,3,9930
19083,87583317,87586882,True,1,3565
19084,87584883,87587818,True,5,2935
19085,87596604,87597885,True,1,1281
19086,87596604,87609006,True,1,12402
19087,87604327,87605124,True,1,797
19088,87607072,87607242,True,2,170
19089,87607072,87607263,True,1,191
19090,87607181,87608039,True,1,858
19091,87616183,87628931,True,1,12748
19092,87616183,87638971,True,1,22788
19093,87616183,87678633,True,1,62450
19094,87617295,87625739,True,1,8444
19095,87619703,87622642,True,1,2939
19096,87625780,87633672,True,1,7892
19097,87626166,87629103,False,1,2937
19098,87627882,87634672,True,1,6790
19099,87634348,87635936,True,1,1588
19100,87644377,87644479,True,1,102
19101,87648137,87650385,False,2,2248
19102,87648137,87650385,True,3,2248
19103,87649302,87649461,True,1,159
19104,87649845,87649937,True,1,92
19105,87653333,87653990,True,1,657
19106,87653333,87657325,True,3,3992
19107,87653461,87677066,True,1,23605
19108,87658875,87659060,False,1,185
19109,87658875,87659060,True,4,185
19110,87671407,87671650,True,2,243
19111,87671407,87685985,True,1,14578
19112,87699801,87700293,True,1,492
19113,87700115,87700357,True,2,242
19114,87700355,87701225,True,2,870
19115,87704398,87706416,False,1,2018
19116,87711221,87724401,False,1,13180
19117,87711221,87724401,True,3,13180
19118,87712663,87713363,True,1,700
19119,87714254,87717723,True,1,3469
19120,87715742,87715827,False,2,85
19121,87715742,87715827,True,2,85
19122,87717966,87762863,False,1,44897
19123,87723588,87746019,True,7,22431
19124,87728956,87736246,True,3,7290
19125,87730040,87730196,True,1,156
19126,87730992,87731315,True,1,323
19127,87734236,87735264,True,1,1028
19128,87761938,87762519,True,1,581
19129,87764448,87771140,True,6,6692
19130,87768838,87778202,True,1,9364
19131,87770720,87771492,True,2,772
19132,87772781,87773107,True,1,326
19133,87772781,87773131,True,1,350
19134,87772781,87773786,True,2,1005
19135,87772795,87773303,False,1,508
19136,87772807,87773410,False,1,603
19137,87772807,87773410,True,1,603
19138,87774537,87774739,False,1,202
19139,87783718,87783916,True,3,198
19140,87785576,87788602,True,1,3026
19141,87785643,87798408,True,1,12765
19142,87790221,87791504,True,1,1283
19143,87805085,87806487,False,2,1402
19144,87805085,87806487,True,1,1402
19145,87811431,87813005,True,1,1574
19146,87812737,87814716,True,2,1979
19147,87812903,87813003,False,1,100
19148,87813682,87919923,True,1,106241
19149,87813939,87814384,True,1,445
19150,87816212,87816978,True,1,766
19151,87822577,87822770,True,1,193
19152,87824389,87826488,False,1,2099
19153,87828484,87830035,False,1,1551
19154,87828484,87927337,True,1,98853
19155,87828484,87941710,True,1,113226
19156,87833655,87833752,True,2,97
19157,87833655,87833770,True,3,115
19158,87834359,87834765,True,1,406
19159,87834359,87836756,True,6,2397
19160,87838224,87839065,True,1,841
19161,87839594,87842145,True,1,2551
19162,87842248,87893565,False,1,51317
19163,87844551,87844632,True,3,81
19164,87845202,87849103,True,2,3901
19165,87845701,87847166,False,1,1465
19166,87845701,87847166,True,3,1465
19167,87849478,87851316,True,4,1838
19168,87862901,87864649,False,1,1748
19169,87864327,87870879,True,1,6552
19170,87865283,87903740,True,1,38457
19171,87868850,87872408,True,1,3558
19172,87871074,87872271,True,2,1197
19173,87872477,87886801,True,1,14324
19174,87879156,87896105,False,1,16949
19175,87909983,87912932,True,2,2949
19176,87913356,87916839,True,1,3483
19177,87929221,87931129,False,1,1908
19178,87930122,87930445,True,1,323
19179,87930944,87932221,True,1,1277
19180,87932189,87944062,True,2,11873
19181,87932562,87933936,False,1,1374
19182,87933238,87933792,True,1,554
19183,87936773,87937045,True,1,272
19184,87936773,87937088,True,1,315
19185,87943799,88011432,True,8,67633
19186,87958950,87961451,True,2,2501
19187,87965040,87966224,False,1,1184
19188,87970384,87971156,True,2,772
19189,87972454,87973459,True,1,1005
19190,87972459,87972967,False,1,508
19191,87981245,87982383,True,1,1138
19192,87983694,87983906,True,2,212
19193,87983763,87983975,False,1,212
19194,87983763,87983975,True,1,212
19195,87993307,88000413,True,3,7106
19196,88001614,88002081,True,1,467
19197,88002462,88005096,True,5,2634
19198,88005170,88006196,True,1,1026
19199,88005646,88005828,True,1,182
19200,88007816,88014568,True,1,6752
19201,88007958,88014577,True,1,6619
19202,88011827,88011927,False,1,100
19203,88011856,88018089,True,1,6233
19204,88015136,88015902,True,1,766
19205,88015269,88030293,True,2,15024
19206,88021924,88022964,True,1,1040
19207,88023991,88024704,True,1,713
19208,88040471,88054474,False,1,14003
19209,88044885,88050309,False,1,5424
19210,88057351,88064736,False,1,7385
19211,88060038,88060225,True,1,187
19212,88069293,88071730,True,1,2437
19213,88069504,88071752,True,2,2248
19214,88069715,88071918,True,1,2203
19215,88070110,88071831,True,1,1721
19216,88070599,88072325,True,2,1726
19217,88072796,88073248,False,1,452
19218,88073874,88074067,True,2,193
19219,88075012,88075284,True,1,272
19220,88077320,88084719,True,1,7399
19221,88077493,88082369,True,1,4876
19222,88077493,88084609,True,1,7116
19223,88078312,88092798,False,1,14486
19224,88080058,88081224,True,4,1166
19225,88081371,88082675,True,1,1304
19226,88088578,88090429,False,1,1851
19227,88089689,88089861,False,3,172
19228,88089689,88089861,True,9,172
19229,88089689,88092196,True,2,2507
19230,88089689,88092639,True,1,2950
19231,88089689,88092848,True,1,3159
19232,88094847,88094954,True,1,107
19233,88095120,88095225,True,2,105
19234,88097408,88097515,True,1,107
19235,88105411,88115137,True,3,9726
19236,88105411,88121778,True,1,16367
19237,88106438,88107363,False,1,925
19238,88113866,88114123,True,3,257
19239,88114117,88114535,True,2,418
19240,88114117,88114549,True,1,432
19241,88115131,88120764,True,3,5633
19242,88128328,88132829,True,1,4501
19243,88130221,88130297,True,2,76
19244,88130235,88130314,True,1,79
19245,88132357,88137746,True,2,5389
19246,88137539,88137649,False,2,110
19247,88137539,88137649,True,1,110
19248,88138956,88139075,False,1,119
19249,88138993,88146899,True,1,7906
19250,88139620,88141093,True,1,1473
19251,88139620,88141140,True,1,1520
19252,88147854,88180161,True,7,32307
19253,88147854,88181886,True,5,34032
19254,88147854,88192937,True,5,45083
19255,88147854,88225739,True,1,77885
19256,88147854,88226039,True,1,78185
19257,88147854,88227325,True,2,79471
19258,88147918,88181228,True,1,33310
19259,88157395,88158138,False,1,743
19260,88157529,88158138,False,3,609
19261,88158419,88158612,False,1,193
19262,88159278,88162892,True,1,3614
19263,88162022,88162216,True,1,194
19264,88162679,88164006,True,1,1327
19265,88163318,88165648,True,1,2330
19266,88168620,88169210,True,1,590
19267,88168657,88174060,True,7,5403
19268,88168657,88176702,True,1,8045
19269,88168754,88169344,False,1,590
19270,88168754,88169344,True,3,590
19271,88168765,88174122,True,1,5357
19272,88169383,88169745,True,1,362
19273,88169434,88170057,True,1,623
19274,88169610,88170151,True,1,541
19275,88173782,88173955,False,1,173
19276,88173782,88173955,True,3,173
19277,88175036,88176650,True,1,1614
19278,88175600,88176904,True,1,1304
19279,88176062,88176987,True,2,925
19280,88179307,88187619,True,1,8312
19281,88184537,88184883,True,1,346
19282,88184537,88185269,True,1,732
19283,88185005,88188819,True,1,3814
19284,88185674,88186406,True,1,732
19285,88186037,88187477,True,2,1440
19286,88190790,88197530,True,1,6740
19287,88190790,88197671,True,1,6881
19288,88191059,88197752,True,1,6693
19289,88194206,88194304,True,1,98
19290,88194217,88226306,True,1,32089
19291,88196893,88197420,False,1,527
19292,88196893,88197420,True,1,527
19293,88196893,88206973,True,1,10080
19294,88201280,88201787,True,1,507
19295,88201632,88201981,True,2,349
19296,88203848,88204297,True,2,449
19297,88204854,88206754,True,1,1900
19298,88205586,88206837,True,1,1251
19299,88214940,88215431,False,1,491
19300,88216350,88216692,True,5,342
19301,88217218,88218493,True,1,1275
19302,88218433,88222262,False,1,3829
19303,88223634,88229754,True,1,6120
19304,88224822,88225068,False,1,246
19305,88224822,88225068,True,2,246
19306,88224877,88225070,True,1,193
19307,88225402,88240127,True,1,14725
19308,88229157,88230233,True,1,1076
19309,88231562,88233687,True,1,2125
19310,88231719,88234602,True,2,2883
19311,88234500,88246329,True,2,11829
19312,88235617,88246977,True,1,11360
19313,88236359,88237117,True,2,758
19314,88238401,88239272,True,1,871
19315,88238401,88239382,True,1,981
19316,88246914,88247915,True,4,1001
19317,88248690,88290831,False,1,42141
19318,88253148,88261040,True,1,7892
19319,88254112,88254785,True,1,673
19320,88257121,88261287,True,1,4166
19321,88278874,88279615,False,1,741
19322,88279555,88280816,True,2,1261
19323,88282584,88285271,True,1,2687
19324,88283134,88283947,False,1,813
19325,88288476,88290102,True,1,1626
19326,88288709,88288890,True,1,181
19327,88300946,88306621,True,1,5675
19328,88301167,88301433,True,1,266
19329,88301590,88301856,True,1,266
19330,88305565,88307472,True,3,1907
19331,88305565,88314650,True,3,9085
19332,88305565,88318727,True,1,13162
19333,88306017,88309097,True,2,3080
19334,88308822,88309170,True,3,348
19335,88325979,88329436,True,1,3457
19336,88327452,88327557,True,1,105
19337,88331089,88333680,True,1,2591
19338,88331107,88331519,True,1,412
19339,88331610,88331788,True,2,178
19340,88331831,88333733,True,1,1902
19341,88332389,88341628,True,4,9239
19342,88340057,88340601,True,1,544
19343,88343161,88373396,False,1,30235
19344,88344892,88346387,True,1,1495
19345,88346567,88375105,False,6,28538
19346,88346567,88375105,True,20,28538
19347,88353186,88625497,True,1,272311
19348,88357083,88357580,True,1,497
19349,88360041,88360450,True,1,409
19350,88361204,88362173,True,1,969
19351,88368748,88368963,True,3,215
19352,88374760,88376562,True,1,1802
19353,88374760,88381037,True,1,6277
19354,88374760,88382236,True,1,7476
19355,88374760,88382239,True,1,7479
19356,88374760,88384366,True,1,9606
19357,88377083,88378302,True,3,1219
19358,88382618,88385036,True,1,2418
19359,88382618,88386238,True,2,3620
19360,88383054,88385158,True,1,2104
19361,88383298,88385432,True,1,2134
19362,88402722,88403039,True,1,317
19363,88403954,88459674,True,1,55720
19364,88427983,88430267,True,1,2284
19365,88429626,88431046,True,1,1420
19366,88429626,88431059,True,3,1433
19367,88435638,88435773,True,1,135
19368,88440507,88442856,True,1,2349
19369,88442379,88443778,False,1,1399
19370,88442379,88445324,True,3,2945
19371,88445218,88445914,True,1,696
19372,88445218,88446257,True,1,1039
19373,88445218,88446972,True,1,1754
19374,88452923,88453680,True,1,757
19375,88459960,88468386,True,3,8426
19376,88471126,88472308,True,1,1182
19377,88473356,88473877,True,1,521
19378,88473575,88473895,True,1,320
19379,88477093,88479280,True,2,2187
19380,88481415,88484742,True,2,3327
19381,88482045,88515480,False,1,33435
19382,88484370,88486258,True,1,1888
19383,88496023,88497741,True,1,1718
19384,88514082,88516405,True,1,2323
19385,88515869,88516405,True,8,536
19386,88516927,88517891,True,1,964
19387,88519553,88521013,True,4,1460
19388,88526580,88533338,True,1,6758
19389,88534910,88535353,True,1,443
19390,88539687,88541698,True,6,2011
19391,88541925,88542374,True,1,449
19392,88542042,88544670,False,1,2628
19393,88543630,88555945,True,1,12315
19394,88552322,88552993,True,5,671
19395,88554579,88555095,True,1,516
19396,88567268,88567720,True,1,452
19397,88569010,88571319,True,1,2309
19398,88599728,88603467,True,1,3739
19399,88602059,88602683,True,2,624
19400,88610390,88615623,True,1,5233
19401,88620893,88621227,True,1,334
19402,88621647,88621828,True,1,181
19403,88621647,88631137,True,1,9490
19404,88626868,88630412,True,2,3544
19405,88626888,88627828,True,1,940
19406,88626888,88646423,True,1,19535
19407,88639596,88642431,True,1,2835
19408,88639596,88642436,False,1,2840
19409,88654274,88657357,False,1,3083
19410,88661504,88663735,True,1,2231
19411,88663068,88663398,True,1,330
19412,88663068,88663824,True,1,756
19413,88664786,88667821,True,1,3035
19414,88676313,88682366,True,1,6053
19415,88681608,88681732,False,1,124
19416,88702108,88703504,True,1,1396
19417,88702738,88710424,True,2,7686
19418,88710666,88712183,False,1,1517
19419,88710855,88713253,True,1,2398
19420,88728192,88740751,False,1,12559
19421,88742537,88743102,True,1,565
19422,88747604,88749654,True,15,2050
19423,88747604,88780310,True,1,32706
19424,88753310,88753389,True,1,79
19425,88754743,88760674,True,3,5931
19426,88759421,88775839,True,2,16418
19427,88760269,88776172,True,3,15903
19428,88766405,88769365,True,1,2960
19429,88774869,88775152,False,1,283
19430,88782597,88785295,True,2,2698
19431,88789416,88819076,True,3,29660
19432,88790381,88790502,True,1,121
19433,88792412,88824322,True,5,31910
19434,88792412,88832346,True,1,39934
19435,88793247,88800973,False,1,7726
19436,88794082,88796566,True,2,2484
19437,88798548,88798773,True,2,225
19438,88798548,88800251,True,1,1703
19439,88800697,88806060,True,1,5363
19440,88802418,88802793,True,1,375
19441,88803556,88803625,True,1,69
19442,88805929,88806900,False,4,971
19443,88805929,88806900,True,1,971
19444,88809568,88809740,False,1,172
19445,88815814,88817416,True,1,1602
19446,88816075,88816644,True,1,569
19447,88817162,88817731,True,1,569
19448,88822053,88843403,True,1,21350
19449,88825833,88827564,True,1,1731
19450,88829407,88842451,True,1,13044
19451,88832688,88840223,True,1,7535
19452,88836127,88839795,True,2,3668
19453,88840487,88909962,True,1,69475
19454,88841323,88841889,True,1,566
19455,88844439,88911989,True,1,67550
19456,88847684,88853858,False,1,6174
19457,88847684,88853858,True,1,6174
19458,88848977,88852034,True,1,3057
19459,88860126,88865444,True,1,5318
19460,88861086,88863243,True,1,2157
19461,88863923,88864004,True,1,81
19462,88870440,88870618,False,1,178
19463,88871623,88871947,True,1,324
19464,88871646,88871918,True,3,272
19465,88881380,88882071,True,1,691
19466,88881380,88882361,True,1,981
19467,88882162,88882402,True,1,240
19468,88882689,88883328,True,4,639
19469,88883357,88884275,True,1,918
19470,88883600,88883745,True,1,145
19471,88890056,88891652,True,2,1596
19472,88891325,88892386,True,1,1061
19473,88892462,88892955,True,1,493
19474,88900410,88934206,True,1,33796
19475,88903872,88904482,True,1,610
19476,88907289,88908505,True,1,1216
19477,88908223,88909054,True,1,831
19478,88910948,88919733,True,1,8785
19479,88910948,88922271,True,1,11323
19480,88914697,88914796,True,1,99
19481,88914835,88923608,True,2,8773
19482,88915194,88915508,True,1,314
19483,88925048,88925307,True,5,259
19484,88925565,88925679,False,1,114
19485,88925565,88925679,True,5,114
19486,88925913,88926402,True,1,489
19487,88926970,88932300,True,1,5330
19488,88928846,88930312,True,1,1466
19489,88930038,88954802,True,1,24764
19490,88932977,88933064,False,1,87
19491,88940954,88942523,True,1,1569
19492,88943422,88943549,True,1,127
19493,88943720,88947748,True,2,4028
19494,88947057,88947270,True,1,213
19495,88947393,88950211,True,4,2818
19496,88971492,88972264,True,3,772
19497,88972838,88987527,True,1,14689
19498,88972838,88991570,True,1,18732
19499,88976704,88980930,True,1,4226
19500,88976718,88980930,True,2,4212
19501,88976795,88980930,True,1,4135
19502,88976821,88980930,True,1,4109
19503,88995445,89023574,True,1,28129
19504,89005700,89010449,True,5,4749
19505,89005934,89009324,False,1,3390
19506,89014335,89018237,True,1,3902
19507,89019747,89021017,True,1,1270
19508,89025517,89039329,True,1,13812
19509,89026424,89027644,True,4,1220
19510,89027745,89027835,True,1,90
19511,89028187,89030649,True,1,2462
19512,89030913,89031302,True,1,389
19513,89034622,89035997,True,1,1375
19514,89039291,89042172,True,1,2881
19515,89039608,89039796,False,1,188
19516,89039608,89039796,True,2,188
19517,89039654,89039796,True,1,142
19518,89053672,89106035,True,1,52363
19519,89054960,89055357,True,6,397
19520,89059123,89059669,True,2,546
19521,89059123,89060666,False,1,1543
19522,89059123,89060666,True,1,1543
19523,89062421,89070667,True,1,8246
19524,89082587,89084493,True,1,1906
19525,89083144,89085047,True,1,1903
19526,89093331,89093711,True,7,380
19527,89105382,89107534,True,3,2152
19528,89105382,89108938,True,1,3556
19529,89112511,89115423,True,1,2912
19530,89126759,89129371,True,1,2612
19531,89137906,89146455,True,1,8549
19532,89137906,89148031,True,1,10125
19533,89145982,89146869,True,1,887
19534,89147175,89147854,True,1,679
19535,89152740,89156769,True,1,4029
19536,89153834,89154389,False,1,555
19537,89153834,89154389,True,1,555
19538,89154465,89154835,False,1,370
19539,89154465,89154835,True,1,370
19540,89155010,89155098,True,3,88
19541,89155418,89156817,False,1,1399
19542,89162462,89196069,False,1,33607
19543,89162462,89196069,True,3,33607
19544,89169181,89179544,True,1,10363
19545,89174426,89196163,True,2,21737
19546,89178326,89188895,True,2,10569
19547,89178538,89179765,True,1,1227
19548,89182762,89184801,True,15,2039
19549,89182762,89215751,True,1,32989
19550,89188446,89188525,True,1,79
19551,89188679,89190397,True,1,1718
19552,89191792,89191890,True,1,98
19553,89193274,89197427,False,1,4153
19554,89193693,89195140,True,3,1447
19555,89193693,89203697,True,1,10004
19556,89193722,89195132,True,2,1410
19557,89197122,89198975,True,1,1853
19558,89210693,89211060,False,1,367
19559,89210693,89211060,True,2,367
19560,89217105,89217228,False,1,123
19561,89221981,89226464,False,1,4483
19562,89235269,89237458,True,1,2189
19563,89236405,89241777,True,1,5372
19564,89237988,89239451,True,1,1463
19565,89239692,89242036,True,1,2344
19566,89240333,89240541,True,2,208
19567,89248946,89250969,True,1,2023
19568,89251799,89252369,True,1,570
19569,89252886,89253456,True,1,570
19570,89252954,89254050,True,1,1096
19571,89262752,89269120,True,1,6368
19572,89265117,89278244,True,1,13127
19573,89268936,89273126,True,2,4190
19574,89275249,89276049,True,1,800
19575,89285121,89320862,True,1,35741
19576,89291477,89292174,True,1,697
19577,89291595,89292174,True,1,579
19578,89292372,89310034,True,4,17662
19579,89296004,89301308,True,1,5304
19580,89300853,89313913,True,1,13060
19581,89315855,89321405,False,1,5550
19582,89315855,89321405,True,5,5550
19583,89328079,89348839,True,2,20760
19584,89333145,89337065,True,1,3920
19585,89333145,89337074,False,1,3929
19586,89333145,89337074,True,2,3929
19587,89336187,89369642,True,3,33455
19588,89338509,89338953,True,3,444
19589,89338509,89339122,True,3,613
19590,89338715,89339224,True,2,509
19591,89358323,89358503,True,5,180
19592,89358323,89358543,True,2,220
19593,89358654,89359144,True,1,490
19594,89361236,89362888,True,1,1652
19595,89361236,89363141,False,1,1905
19596,89363992,89365194,True,1,1202
19597,89370042,89372179,True,1,2137
19598,89374053,89400350,True,3,26297
19599,89380558,89382663,True,2,2105
19600,89381153,89381599,True,1,446
19601,89381153,89381622,True,2,469
19602,89392958,89395851,True,1,2893
19603,89397959,89402613,False,1,4654
19604,89403096,89405378,True,1,2282
19605,89408970,89413578,False,1,4608
19606,89408970,89413578,True,4,4608
19607,89415205,89418230,True,1,3025
19608,89433428,89433928,True,1,500
19609,89433428,89433931,True,4,503
19610,89434639,89439184,True,1,4545
19611,89435344,89452023,False,1,16679
19612,89439548,89470765,True,1,31217
19613,89439825,89471047,True,1,31222
19614,89440081,89471177,True,1,31096
19615,89441387,89448685,False,1,7298
19616,89443948,89454540,True,1,10592
19617,89465380,89465590,False,1,210
19618,89465380,89465590,True,8,210
19619,89465472,89471262,False,1,5790
19620,89476981,89484771,True,1,7790
19621,89481144,89543221,True,1,62077
19622,89493938,89497362,False,2,3424
19623,89493938,89497362,True,3,3424
19624,89502586,89527608,True,1,25022
19625,89508366,89510215,True,1,1849
19626,89508366,89515827,True,1,7461
19627,89508370,89510215,True,1,1845
19628,89508370,89515827,True,1,7457
19629,89515028,89528770,True,1,13742
19630,89528123,89532497,True,2,4374
19631,89528221,89532531,True,1,4310
19632,89542311,89544063,True,1,1752
19633,89542604,89544063,True,1,1459
19634,89554291,89574552,True,1,20261
19635,89572037,89667852,True,1,95815
19636,89576409,89583964,True,1,7555
19637,89576578,89576944,True,1,366
19638,89577119,89584314,True,1,7195
19639,89583849,89593459,True,1,9610
19640,89583849,89593471,True,1,9622
19641,89585279,89585949,True,1,670
19642,89591684,89591808,True,1,124
19643,89592060,89694854,True,3,102794
19644,89595094,89697888,True,1,102794
19645,89599524,89600378,True,2,854
19646,89606087,89608954,True,1,2867
19647,89606584,89619093,True,1,12509
19648,89606584,89619952,True,1,13368
19649,89611274,89611360,True,1,86
19650,89617166,89617505,True,1,339
19651,89618691,89620135,True,1,1444
19652,89620038,89621053,False,1,1015
19653,89624226,89913059,True,1,288833
19654,89654374,89654941,False,2,567
19655,89658700,89658785,True,2,85
19656,89664794,89671479,True,4,6685
19657,89671394,89671818,True,1,424
19658,89672632,89674585,False,1,1953
19659,89672632,89674585,True,1,1953
19660,89672632,89675084,True,1,2452
19661,89677658,89680091,True,1,2433
19662,89681493,89682514,True,1,1021
19663,89681858,89685547,True,1,3689
19664,89710392,89711636,True,3,1244
19665,89710392,89714513,True,1,4121
19666,89712970,89723931,True,1,10961
19667,89731497,89732652,True,1,1155
19668,89734133,89741874,True,1,7741
19669,89734391,89739683,True,1,5292
19670,89736249,89741613,True,1,5364
19671,89740704,89740954,False,1,250
19672,89742161,89748610,True,1,6449
19673,89742247,89748700,True,1,6453
19674,89742794,89745397,True,1,2603
19675,89745862,89746592,True,1,730
19676,89746680,89748718,True,1,2038
19677,89747373,89748338,True,3,965
19678,89747373,89753708,True,1,6335
19679,89764114,89773363,False,1,9249
19680,89779306,89969330,True,2,190024
19681,89782071,89786309,True,2,4238
19682,89782140,89782371,True,1,231
19683,89804824,89815843,True,6,11019
19684,89807015,89809094,True,1,2079
19685,89815324,89819946,True,1,4622
19686,89829673,89833203,True,1,3530
19687,89832286,89842912,True,3,10626
19688,89834340,89843435,True,1,9095
19689,89836599,89836740,True,1,141
19690,89852867,89927313,True,1,74446
19691,89855987,89859211,True,1,3224
19692,89858048,89878848,True,2,20800
19693,89865142,89866365,True,1,1223
19694,89865142,89866820,True,1,1678
19695,89865142,89866838,True,1,1696
19696,89896222,89901752,False,1,5530
19697,89896222,89901752,True,1,5530
19698,89898913,89961175,True,2,62262
19699,89910466,89911008,True,7,542
19700,89916098,89916517,True,2,419
19701,89918535,89919183,False,1,648
19702,89918535,89929696,True,1,11161
19703,89925091,89927548,True,2,2457
19704,89930540,89930694,False,1,154
19705,89930540,89931597,False,1,1057
19706,89930540,89931597,True,1,1057
19707,89935723,89970176,True,1,34453
19708,89949476,89954133,False,1,4657
19709,89957339,89957574,True,7,235
19710,89962221,89963356,True,5,1135
19711,89980763,89981316,False,1,553
19712,89990888,89992217,True,6,1329
19713,89991410,89991797,False,1,387
19714,89995581,89995755,False,1,174
19715,89997768,89998593,True,1,825
19716,90001072,90007369,True,4,6297
19717,90003647,90004442,True,1,795
19718,90004732,90005016,False,1,284
19719,90004753,90004826,True,3,73
19720,90007495,90011303,True,3,3808
19721,90007883,90008179,True,1,296
19722,90012108,90012873,True,1,765
19723,90014428,90154824,True,1,140396
19724,90015297,90016456,True,4,1159
19725,90017203,90017423,True,1,220
19726,90018854,90020770,True,1,1916
19727,90020476,90025296,True,4,4820
19728,90033717,90047379,True,1,13662
19729,90035566,90048370,True,2,12804
19730,90035566,90056317,True,1,20751
19731,90042968,90044777,False,1,1809
19732,90042968,90049756,True,1,6788
19733,90045048,90072548,True,1,27500
19734,90045547,90046045,False,2,498
19735,90057447,90075635,True,1,18188
19736,90057447,90077103,True,3,19656
19737,90078800,90117194,False,1,38394
19738,90079748,90117636,True,2,37888
19739,90079748,90143301,True,1,63553
19740,90083544,90084196,False,1,652
19741,90118610,90156725,True,1,38115
19742,90124802,90134599,False,1,9797
19743,90129111,90162796,True,1,33685
19744,90129111,90174895,True,1,45784
19745,90134628,90145082,True,2,10454
19746,90134628,90170747,True,1,36119
19747,90135721,90140075,True,1,4354
19748,90145807,90147912,True,1,2105
19749,90145807,90171057,True,1,25250
19750,90145807,90183156,True,1,37349
19751,90159106,90169194,True,1,10088
19752,90194164,90196212,False,1,2048
19753,90195583,90195716,True,2,133
19754,90196071,90199229,True,1,3158
19755,90196565,90208546,True,2,11981
19756,90196859,90208840,True,1,11981
19757,90212828,90213407,True,1,579
19758,90221372,90247872,False,1,26500
19759,90231308,90232851,True,1,1543
19760,90234019,90243941,True,1,9922
19761,90240157,90240272,True,1,115
19762,90240381,90245344,True,1,4963
19763,90240381,90259501,True,1,19120
19764,90240444,90245497,True,1,5053
19765,90240696,90245752,True,1,5056
19766,90242295,90243578,True,2,1283
19767,90251327,90254312,True,1,2985
19768,90254272,90257718,True,1,3446
19769,90254464,90254892,True,1,428
19770,90260004,90261119,True,6,1115
19771,90278239,90292925,True,2,14686
19772,90279723,90280553,True,5,830
19773,90280938,90295739,True,1,14801
19774,90294572,90297590,True,4,3018
19775,90294572,90297667,True,1,3095
19776,90296944,90330772,True,4,33828
19777,90297671,90300798,True,1,3127
19778,90300437,90301207,False,1,770
19779,90304063,90305303,True,1,1240
19780,90338025,90372203,True,2,34178
19781,90339085,90340741,True,1,1656
19782,90340235,90343633,True,1,3398
19783,90349981,90350589,True,2,608
19784,90364822,90386521,False,1,21699
19785,90375298,90378512,True,9,3214
19786,90387756,90388082,True,1,326
19787,90393693,90395118,True,4,1425
19788,90394851,90414272,True,1,19421
19789,90399775,90401059,False,1,1284
19790,90404950,90407049,True,1,2099
19791,90411163,90412072,True,2,909
19792,90419060,90420646,True,2,1586
19793,90424183,90425119,True,1,936
19794,90424515,90425138,True,1,623
19795,90426096,90427879,True,1,1783
19796,90434673,90434751,True,1,78
19797,90452107,90452481,False,1,374
19798,90452107,90454318,False,1,2211
19799,90452107,90455748,False,1,3641
19800,90465947,90468011,True,1,2064
19801,90475044,90476431,True,1,1387
19802,90482517,90482949,True,1,432
19803,90497879,90497991,True,1,112
19804,90499411,90499555,True,1,144
19805,90504280,90506459,True,1,2179
19806,90517963,90522240,True,1,4277
19807,90527759,90529784,True,2,2025
19808,90532380,90532545,True,1,165
19809,90543932,90544039,True,1,107
19810,90548731,90550036,False,1,1305
19811,90548731,90550036,True,1,1305
19812,90556226,90558346,True,4,2120
19813,90562666,90565285,True,2,2619
19814,90567843,90571026,True,1,3183
19815,90570341,90608951,True,1,38610
19816,90571891,90573787,True,1,1896
19817,90572948,90573180,True,1,232
19818,90573636,90577876,True,1,4240
19819,90576278,90576676,True,2,398
19820,90592250,90592449,True,2,199
19821,90592291,90592455,False,1,164
19822,90614102,90625107,False,1,11005
19823,90624778,90626795,True,2,2017
19824,90628873,90630767,True,1,1894
19825,90628873,90630772,True,1,1899
19826,90630848,90647905,False,1,17057
19827,90630848,90647905,True,2,17057
19828,90632868,90639567,True,1,6699
19829,90632868,90656541,True,1,23673
19830,90662513,90682990,False,1,20477
19831,90662513,90682990,True,2,20477
19832,90676657,90691956,True,1,15299
19833,90680698,90681488,True,1,790
19834,90690610,90724791,True,1,34181
19835,90699262,90717918,True,2,18656
19836,90727786,90731174,True,3,3388
19837,90729342,90734372,False,1,5030
19838,90733277,90736142,True,1,2865
19839,90733749,90734963,True,1,1214
19840,90739778,90742024,True,1,2246
19841,90743137,90743314,True,1,177
19842,90748780,90752493,False,1,3713
19843,90759254,90760025,True,1,771
19844,90771321,90771610,True,2,289
19845,90780607,90789511,True,1,8904
19846,90787338,90793851,False,1,6513
19847,90789047,90789138,True,2,91
19848,90789047,90789141,True,1,94
19849,90789422,90790124,True,1,702
19850,90791920,90794060,True,2,2140
19851,90802439,90802959,True,1,520
19852,90802766,90803144,True,2,378
19853,90803205,90803731,False,1,526
19854,90807344,90809224,True,1,1880
19855,90813472,90814084,False,1,612
19856,90813472,90814517,True,1,1045
19857,90813793,90830130,True,1,16337
19858,90813793,90834207,True,1,20414
19859,90818136,90818895,True,1,759
19860,90818939,90826026,True,1,7087
19861,90819570,90819663,True,3,93
19862,90821126,90821862,True,3,736
19863,90830696,90833585,False,1,2889
19864,90835322,90835503,True,1,181
19865,90835322,90835703,True,1,381
19866,90835910,90836047,True,1,137
19867,90839015,90841861,False,1,2846
19868,90844487,90845858,True,1,1371
19869,90844487,90846305,True,2,1818
19870,90860148,90860270,False,1,122
19871,90860246,90863147,True,1,2901
19872,90860246,90865997,True,1,5751
19873,90860349,90860924,False,1,575
19874,90860349,90861109,False,1,760
19875,90864646,90884175,True,3,19529
19876,90865085,90896362,False,1,31277
19877,90865085,90896362,True,4,31277
19878,90880296,90880569,True,1,273
19879,90884111,90999835,True,1,115724
19880,90891104,90893498,False,1,2394
19881,90903331,90903497,False,1,166
19882,90910532,90920829,True,4,10297
19883,90915799,90923059,True,2,7260
19884,90916591,90923467,True,1,6876
19885,90917322,90923816,True,1,6494
19886,90919742,90923490,True,3,3748
19887,90928230,90928373,True,2,143
19888,90928230,90928375,True,1,145
19889,90937467,90937558,True,4,91
19890,90945211,90945772,True,1,561
19891,90954597,90955954,True,1,1357
19892,90955761,90956331,True,2,570
19893,90955761,90956381,True,3,620
19894,90956079,90957355,True,1,1276
19895,90957171,90957286,True,1,115
19896,90967063,90967811,True,1,748
19897,90989009,90989121,True,1,112
19898,90991148,90991299,True,1,151
19899,90992698,90994998,True,1,2300
19900,90997201,91009086,False,1,11885
19901,91005851,91006669,True,1,818
19902,91009649,91010911,True,2,1262
19903,91018826,91019077,True,1,251
19904,91028840,91030958,True,1,2118
19905,91046888,91141900,True,2,95012
19906,91049709,91060920,False,1,11211
19907,91054522,91056070,True,1,1548
19908,91055836,91061640,False,1,5804
19909,91060316,91064341,False,2,4025
19910,91065993,91066521,False,1,528
19911,91084663,91085737,False,1,1074
19912,91084663,91085737,True,2,1074
19913,91086350,91098108,True,1,11758
19914,91087010,91098768,False,1,11758
19915,91088903,91089823,True,1,920
19916,91104941,91105024,False,1,83
19917,91106753,91117723,True,3,10970
19918,91107213,91107475,True,2,262
19919,91109920,91119907,True,4,9987
19920,91119902,91123772,False,1,3870
19921,91119902,91123772,True,2,3870
19922,91121190,91124598,True,1,3408
19923,91127563,91142124,False,1,14561
19924,91127563,91142124,True,3,14561
19925,91133764,91165099,True,1,31335
19926,91133764,91169575,True,2,35811
19927,91133764,91180309,True,2,46545
19928,91133764,91254987,True,4,121223
19929,91133764,91257770,True,8,124006
19930,91133764,91272969,True,1,139205
19931,91133764,91273009,True,1,139245
19932,91133764,91277963,True,1,144199
19933,91133764,91278573,True,4,144809
19934,91135241,91136838,True,1,1597
19935,91150595,91153726,True,1,3131
19936,91158357,91158684,True,1,327
19937,91158620,91159579,True,1,959
19938,91161772,91162104,False,1,332
19939,91165054,91165680,True,1,626
19940,91165164,91165692,True,1,528
19941,91165164,91175892,True,1,10728
19942,91170256,91172030,True,1,1774
19943,91181219,91181791,True,5,572
19944,91190870,91196985,False,3,6115
19945,91193215,91238200,True,1,44985
19946,91200751,91209076,True,1,8325
19947,91210877,91211405,True,3,528
19948,91211406,91212533,False,1,1127
19949,91214148,91225511,False,1,11363
19950,91217364,91231716,True,2,14352
19951,91219943,91274012,True,1,54069
19952,91219943,91305564,True,2,85621
19953,91219943,91334845,False,1,114902
19954,91227525,91228224,True,1,699
19955,91228905,91246480,True,1,17575
19956,91232556,91235900,True,2,3344
19957,91237397,91248704,True,1,11307
19958,91246633,91270055,True,1,23422
19959,91247924,91248473,True,1,549
19960,91274101,91313962,True,1,39861
19961,91285755,91285869,False,1,114
19962,91290452,91294904,True,1,4452
19963,91295648,91296656,True,3,1008
19964,91299451,91300640,True,1,1189
19965,91300415,91302333,False,2,1918
19966,91307740,91309417,True,2,1677
19967,91310040,91312048,True,1,2008
19968,91312057,91312836,True,1,779
19969,91327465,91328295,True,1,830
19970,91332666,91333357,True,4,691
19971,91332666,91335128,True,1,2462
19972,91332669,91335128,True,1,2459
19973,91341753,91342779,True,1,1026
19974,91343189,91344079,False,1,890
19975,91345807,91345992,True,1,185
19976,91361813,91362687,True,2,874
19977,91362274,91363556,True,1,1282
19978,91364091,91364546,True,1,455
19979,91373182,91382260,True,1,9078
19980,91389486,91405496,True,1,16010
19981,91390234,91392034,False,1,1800
19982,91390234,91392034,True,1,1800
19983,91391984,91392809,False,1,825
19984,91410611,91410987,True,1,376
19985,91411741,91412158,True,1,417
19986,91411848,91424034,True,1,12186
19987,91414974,91416133,False,1,1159
19988,91420477,91420783,False,1,306
19989,91420477,91420783,True,1,306
19990,91421366,91422456,True,1,1090
19991,91432493,91435207,True,1,2714
19992,91439997,91444080,True,1,4083
19993,91439997,91444993,True,1,4996
19994,91439997,91446486,True,1,6489
19995,91440079,91440192,False,1,113
19996,91445579,91445692,True,1,113
19997,91445756,91445923,True,1,167
19998,91451338,91452006,True,1,668
19999,91454349,91454900,False,1,551
20000,91454853,91454953,True,1,100
20001,91457303,91458619,True,1,1316
20002,91461742,91462591,True,1,849
20003,91461742,91475681,True,2,13939
20004,91468651,91470097,True,1,1446
20005,91479263,91480843,True,1,1580
20006,91480482,91481282,True,2,800
20007,91480991,91481247,True,1,256
20008,91484950,91510737,False,1,25787
20009,91487864,91488883,False,1,1019
20010,91499035,91499170,True,2,135
20011,91499035,91499530,True,3,495
20012,91509412,91516760,True,2,7348
20013,91509412,91529243,True,1,19831
20014,91510105,91511948,True,1,1843
20015,91527007,91527335,False,1,328
20016,91527464,91529166,False,1,1702
20017,91531751,91533160,True,1,1409
20018,91535876,91541944,True,1,6068
20019,91535948,91536037,True,1,89
20020,91540203,91543527,True,1,3324
20021,91546332,91546704,True,1,372
20022,91546886,91547667,True,1,781
20023,91547231,91548012,False,1,781
20024,91547231,91548012,True,2,781
20025,91552194,91553486,True,1,1292
20026,91552951,91555159,True,1,2208
20027,91578229,91584717,True,1,6488
20028,91586247,91586524,True,1,277
20029,91590022,91591099,True,12,1077
20030,91597559,91598287,True,3,728
20031,91597983,91600973,True,1,2990
20032,91598753,91601677,True,1,2924
20033,91606736,91607902,False,2,1166
20034,91606736,91609227,False,4,2491
20035,91606736,91609227,True,1,2491
20036,91611317,91612084,True,1,767
20037,91611317,91612314,True,1,997
20038,91611877,91612626,True,1,749
20039,91612106,91612635,False,1,529
20040,91619467,91619772,True,1,305
20041,91619856,91620387,True,1,531
20042,91620784,91621101,True,4,317
20043,91621920,91630583,True,1,8663
20044,91622662,91626449,True,1,3787
20045,91651593,91652981,True,1,1388
20046,91651690,91652981,True,1,1291
20047,91654527,91658965,True,1,4438
20048,91669301,91677731,False,1,8430
20049,91677922,91679665,True,11,1743
20050,91677922,91687287,True,9,9365
20051,91688101,91692787,True,3,4686
20052,91691121,91691992,True,1,871
20053,91697714,91698457,True,1,743
20054,91709627,91710113,True,4,486
20055,91711076,91711228,True,1,152
20056,91724192,91726802,True,1,2610
20057,91728795,91751538,True,1,22743
20058,91732633,91733655,False,1,1022
20059,91732633,91733655,True,2,1022
20060,91732633,91734738,True,1,2105
20061,91733954,91740822,True,2,6868
20062,91734169,91734242,False,1,73
20063,91737181,91747702,False,1,10521
20064,91737181,91748152,True,3,10971
20065,91737500,91746199,True,1,8699
20066,91738212,91746487,True,1,8275
20067,91739500,91747552,True,4,8052
20068,91742040,91742156,False,1,116
20069,91750930,91751771,True,1,841
20070,91758629,91949179,True,1,190550
20071,91759139,91763747,False,1,4608
20072,91759139,91763747,True,1,4608
20073,91759782,91764119,False,1,4337
20074,91759835,91761322,False,1,1487
20075,91759835,91761322,True,1,1487
20076,91766377,91768674,True,3,2297
20077,91767172,91772634,True,1,5462
20078,91770497,91770634,True,2,137
20079,91797054,91797334,True,1,280
20080,91797662,91813278,True,5,15616
20081,91802461,91804638,True,3,2177
20082,91807778,91808841,False,1,1063
20083,91814518,91826680,True,1,12162
20084,91818357,91818456,True,1,99
20085,91819442,91819816,True,1,374
20086,91819930,91820298,True,1,368
20087,91822826,91824096,True,2,1270
20088,91823573,91827523,True,3,3950
20089,91829080,91829335,True,1,255
20090,91830414,91830680,True,1,266
20091,91830862,91830941,True,1,79
20092,91831001,91833038,False,1,2037
20093,91831396,91834085,False,1,2689
20094,91833694,91833910,True,1,216
20095,91836601,91837734,True,1,1133
20096,91837593,91842435,True,2,4842
20097,91846773,91847468,True,1,695
20098,91848131,91850562,True,1,2431
20099,91848131,91855297,True,1,7166
20100,91854243,91878040,True,1,23797
20101,91854578,91865685,True,1,11107
20102,91856142,91864391,True,2,8249
20103,91856142,91870295,True,1,14153
20104,91856326,91856503,True,1,177
20105,91856558,91858103,True,1,1545
20106,91862947,91863666,True,1,719
20107,91863082,91863666,True,1,584
20108,91874815,91875237,False,1,422
20109,91874815,91875606,False,1,791
20110,91881492,91882524,False,1,1032
20111,91886439,91887565,True,2,1126
20112,91888521,91888612,True,1,91
20113,91891532,91891759,True,1,227
20114,91905276,91906245,False,1,969
20115,91905276,91906245,True,3,969
20116,91906645,91908054,True,3,1409
20117,91906807,91907382,True,5,575
20118,91908163,91908916,True,1,753
20119,91920435,91920685,False,4,250
20120,91920435,91920685,True,1,250
20121,91920435,91921823,True,1,1388
20122,91922722,91924536,True,1,1814
20123,91924236,91926050,True,1,1814
20124,91925674,91926566,False,1,892
20125,91931940,91938881,True,1,6941
20126,91934944,91937825,True,1,2881
20127,91937603,91938844,True,4,1241
20128,91940669,91942672,True,1,2003
20129,91943222,91945137,True,5,1915
20130,91943222,91945254,True,3,2032
20131,91943222,91947059,False,1,3837
20132,91943222,91947059,True,1,3837
20133,91947174,91966191,True,1,19017
20134,91950266,91967649,True,1,17383
20135,91953792,91956883,True,4,3091
20136,91953894,91971966,False,1,18072
20137,91962788,91963051,False,1,263
20138,91970004,91972923,True,1,2919
20139,91973214,91974491,True,1,1277
20140,91977592,91977856,False,1,264
20141,91977592,91977856,True,2,264
20142,92000949,92001590,False,1,641
20143,92004399,92004935,True,1,536
20144,92005850,92006072,True,1,222
20145,92021721,92031606,True,1,9885
20146,92033002,92033090,True,2,88
20147,92033281,92034560,True,1,1279
20148,92033281,92043913,True,1,10632
20149,92038067,92039558,True,3,1491
20150,92038067,92040868,True,1,2801
20151,92041151,92041165,True,1,14
20152,92042012,92042105,True,1,93
20153,92059962,92064354,True,1,4392
20154,92063738,92118903,True,1,55165
20155,92067069,92067817,False,1,748
20156,92078374,92089363,False,1,10989
20157,92078374,92089363,True,3,10989
20158,92081057,92091225,True,1,10168
20159,92095982,92096619,True,1,637
20160,92096839,92097047,True,4,208
20161,92099536,92106552,True,5,7016
20162,92100817,92103473,True,1,2656
20163,92106707,92137417,True,1,30710
20164,92106707,92154889,True,1,48182
20165,92125760,92125936,True,1,176
20166,92125760,92131197,True,1,5437
20167,92131109,92131553,True,1,444
20168,92131109,92211333,True,1,80224
20169,92135736,92153267,True,1,17531
20170,92135736,92156551,True,1,20815
20171,92135769,92138338,True,1,2569
20172,92135982,92153506,True,1,17524
20173,92156054,92156900,True,1,846
20174,92171820,92171913,False,1,93
20175,92171820,92172108,True,3,288
20176,92171820,92175121,True,1,3301
20177,92187055,92188221,True,2,1166
20178,92188977,92198373,True,1,9396
20179,92195626,92204986,True,1,9360
20180,92207373,92209368,True,1,1995
20181,92223057,92224624,True,6,1567
20182,92225703,92229454,False,1,3751
20183,92225703,92229454,True,4,3751
20184,92231246,92234324,True,1,3078
20185,92239534,92239739,False,1,205
20186,92247330,92247444,True,2,114
20187,92248659,92248808,True,2,149
20188,92251509,92253652,True,3,2143
20189,92252360,92254101,True,1,1741
20190,92253492,92254688,False,1,1196
20191,92257251,92260879,True,1,3628
20192,92257251,92260883,True,3,3632
20193,92261363,92342525,True,5,81162
20194,92264159,92265782,True,1,1623
20195,92264583,92265817,True,1,1234
20196,92270567,92270843,False,1,276
20197,92275731,92280256,True,1,4525
20198,92289797,92292716,True,1,2919
20199,92289928,92290039,True,1,111
20200,92292645,92292984,True,1,339
20201,92296354,92299779,True,2,3425
20202,92307793,92310490,True,1,2697
20203,92320184,92325737,True,1,5553
20204,92330268,92344322,True,1,14054
20205,92343057,92344234,False,1,1177
20206,92343057,92344234,True,3,1177
20207,92369868,92374301,True,1,4433
20208,92370119,92372987,True,2,2868
20209,92370119,92374310,True,2,4191
20210,92370119,92375580,True,1,5461
20211,92371602,92372697,False,1,1095
20212,92376191,92377453,True,1,1262
20213,92379504,92402949,True,3,23445
20214,92379898,92381954,True,3,2056
20215,92381696,92382354,True,2,658
20216,92391908,92392409,True,2,501
20217,92410449,92457275,True,1,46826
20218,92421979,92425390,True,3,3411
20219,92428998,92454128,True,1,25130
20220,92430717,92440615,True,1,9898
20221,92430717,92447991,True,1,17274
20222,92445415,92445510,True,4,95
20223,92452486,92454491,True,2,2005
20224,92461297,92461625,True,2,328
20225,92462303,92462382,True,1,79
20226,92485875,92491335,True,1,5460
20227,92489014,92492970,True,1,3956
20228,92490497,92498400,True,1,7903
20229,92497312,92498559,True,1,1247
20230,92504201,92509790,True,1,5589
20231,92504201,92515521,True,2,11320
20232,92511665,92512048,True,1,383
20233,92526933,92568263,True,1,41330
20234,92537411,92537648,True,1,237
20235,92539028,92559387,True,2,20359
20236,92541041,92544622,True,1,3581
20237,92542072,92555838,True,1,13766
20238,92546873,92547202,True,8,329
20239,92546873,92547799,True,1,926
20240,92553045,92553353,True,1,308
20241,92554988,92564577,True,1,9589
20242,92564421,92564499,True,1,78
20243,92564512,92566134,True,1,1622
20244,92567840,92588774,True,1,20934
20245,92567900,92587625,True,1,19725
20246,92567900,92589747,True,2,21847
20247,92567900,92590508,True,1,22608
20248,92573285,92574290,True,3,1005
20249,92573285,92574588,True,1,1303
20250,92573811,92574160,True,1,349
20251,92573811,92575113,True,1,1302
20252,92574634,92630164,True,1,55530
20253,92575169,92576046,True,1,877
20254,92598331,92602669,True,2,4338
20255,92598991,92620711,True,2,21720
20256,92612212,92612516,True,5,304
20257,92613404,92614256,True,4,852
20258,92628890,92629157,True,2,267
20259,92635462,92643223,True,2,7761
20260,92637330,92649552,True,1,12222
20261,92637654,92637806,True,1,152
20262,92642566,92645211,True,1,2645
20263,92643887,92644524,True,4,637
20264,92646913,92648182,True,2,1269
20265,92660860,92678083,True,2,17223
20266,92669288,92672776,True,1,3488
20267,92675147,92676121,True,1,974
20268,92682191,92683775,False,1,1584
20269,92682191,92687730,False,3,5539
20270,92682215,92683775,False,2,1560
20271,92690942,92700913,False,1,9971
20272,92698511,92704017,True,1,5506
20273,92707481,92708045,True,1,564
20274,92709491,92743293,True,1,33802
20275,92709651,92710180,True,2,529
20276,92712607,92780043,True,1,67436
20277,92717926,92744942,True,1,27016
20278,92717929,92744927,True,1,26998
20279,92717929,92744942,True,1,27013
20280,92720055,92723551,True,2,3496
20281,92733951,92755655,True,4,21704
20282,92735300,92742848,True,1,7548
20283,92738325,92757794,True,4,19469
20284,92741192,92758258,True,1,17066
20285,92758645,92762268,True,1,3623
20286,92758815,92762273,True,1,3458
20287,92765023,92767239,True,1,2216
20288,92766400,92770936,True,1,4536
20289,92787861,92797811,True,1,9950
20290,92790902,92794200,True,2,3298
20291,92805066,92805938,True,2,872
20292,92805455,92806222,True,1,767
20293,92806512,92806809,True,3,297
20294,92806512,92807046,False,1,534
20295,92806695,92806865,True,1,170
20296,92806943,92807102,True,1,159
20297,92809986,92810823,False,1,837
20298,92821528,92823595,False,1,2067
20299,92823321,92823821,True,1,500
20300,92823321,92824056,True,1,735
20301,92837454,92848022,True,6,10568
20302,92837454,92857422,True,1,19968
20303,92838697,92843483,False,1,4786
20304,92868049,92890384,True,1,22335
20305,92872718,92874238,False,1,1520
20306,92886973,92899806,True,1,12833
20307,92894117,92895966,True,1,1849
20308,92894502,92915071,True,4,20569
20309,92897713,92898277,True,1,564
20310,92898205,92898630,True,1,425
20311,92898233,92898605,True,1,372
20312,92899525,92902450,False,1,2925
20313,92899525,92943529,True,1,44004
20314,92904014,92905253,False,1,1239
20315,92919652,92957740,False,1,38088
20316,92925323,92931407,True,2,6084
20317,92943979,92945878,False,1,1899
20318,92955215,92956924,True,4,1709
20319,92963916,92975680,False,1,11764
20320,92963916,92975680,True,1,11764
20321,92989200,93031338,False,1,42138
20322,92989200,93042807,False,5,53607
20323,92989200,93042807,True,4,53607
20324,92997480,93004982,True,2,7502
20325,93009088,93011407,False,1,2319
20326,93009088,93011407,True,1,2319
20327,93015354,93017399,True,6,2045
20328,93035618,93038946,True,3,3328
20329,93045088,93045193,True,1,105
20330,93049616,93098550,True,1,48934
20331,93061236,93063420,True,2,2184
20332,93066780,93213386,False,2,146606
20333,93074490,93075726,True,1,1236
20334,93079191,93081328,True,1,2137
20335,93086199,93086418,True,1,219
20336,93086988,93087377,True,1,389
20337,93093053,93094287,True,2,1234
20338,93093810,93094519,True,1,709
20339,93101889,93102589,False,4,700
20340,93101889,93102589,True,20,700
20341,93117430,93119887,True,2,2457
20342,93124482,93141207,False,1,16725
20343,93134573,93139066,False,1,4493
20344,93134573,93161419,False,1,26846
20345,93140745,93193941,True,2,53196
20346,93145145,93164045,True,1,18900
20347,93145382,93157267,True,1,11885
20348,93145382,93166889,True,1,21507
20349,93159694,93168341,True,5,8647
20350,93170235,93170524,False,1,289
20351,93179566,93181008,True,1,1442
20352,93184933,93187286,True,1,2353
20353,93188729,93205309,True,1,16580
20354,93197808,93198049,False,1,241
20355,93214043,93214494,True,1,451
20356,93214694,93215571,True,1,877
20357,93230433,93231893,True,1,1460
20358,93232117,93236627,True,1,4510
20359,93238569,93239658,True,1,1089
20360,93241127,93241899,True,1,772
20361,93241686,93244229,True,4,2543
20362,93243486,93244193,False,1,707
20363,93246941,93250468,True,1,3527
20364,93250314,93261971,True,1,11657
20365,93252576,93255904,True,1,3328
20366,93254082,93295968,False,2,41886
20367,93254774,93255618,True,7,844
20368,93255254,93257216,True,2,1962
20369,93278265,93278698,True,1,433
20370,93278265,93290418,True,2,12153
20371,93278265,93304652,True,2,26387
20372,93278265,93305712,True,1,27447
20373,93281044,93282477,False,1,1433
20374,93281044,93282914,True,1,1870
20375,93281829,93286944,True,1,5115
20376,93289684,93334441,True,1,44757
20377,93302206,93303118,True,1,912
20378,93303053,93315169,True,1,12116
20379,93307250,93308091,True,1,841
20380,93308112,93312595,True,1,4483
20381,93308687,93317711,False,1,9024
20382,93309004,93309202,False,1,198
20383,93309004,93309264,True,3,260
20384,93309381,93309480,True,2,99
20385,93312751,93323597,False,1,10846
20386,93313683,93313766,True,2,83
20387,93315706,93321661,True,1,5955
20388,93317522,93319167,True,2,1645
20389,93319437,93323524,True,1,4087
20390,93322751,93322837,True,1,86
20391,93327829,93328269,True,2,440
20392,93335773,93345629,True,1,9856
20393,93335773,93349109,False,1,13336
20394,93338301,93354374,True,1,16073
20395,93338436,93339099,True,1,663
20396,93339379,93347460,False,1,8081
20397,93339379,93350940,False,1,11561
20398,93344485,93344940,True,2,455
20399,93346804,93351126,True,1,4322
20400,93347132,93348194,True,2,1062
20401,93355795,93356631,True,2,836
20402,93369392,93369777,False,2,385
20403,93369392,93371345,True,1,1953
20404,93370051,93372473,True,1,2422
20405,93371470,93373594,True,1,2124
20406,93374311,93374425,False,1,114
20407,93375670,93385629,False,1,9959
20408,93375670,93431731,False,1,56061
20409,93380211,93425973,True,1,45762
20410,93380578,93381348,True,1,770
20411,93385465,93385912,True,2,447
20412,93385956,93393948,False,1,7992
20413,93388151,93389216,True,2,1065
20414,93389982,93390481,True,1,499
20415,93392983,93409255,True,1,16272
20416,93397384,93400608,False,1,3224
20417,93399015,93401631,True,1,2616
20418,93399399,93399537,True,1,138
20419,93401915,93405004,True,4,3089
20420,93404450,93405372,True,1,922
20421,93410779,93412590,True,1,1811
20422,93413544,93414245,False,1,701
20423,93413595,93413989,False,1,394
20424,93416060,93417244,False,1,1184
20425,93416125,93417230,False,1,1105
20426,93418181,93425579,True,1,7398
20427,93423038,93423460,False,2,422
20428,93423038,93423460,True,4,422
20429,93424237,93431013,True,2,6776
20430,93426784,93427380,True,1,596
20431,93426944,93428282,False,1,1338
20432,93427446,93427548,True,1,102
20433,93429380,93432284,True,1,2904
20434,93433937,93434155,True,1,218
20435,93442018,93530768,False,1,88750
20436,93444965,93445263,True,1,298
20437,93445334,93445590,True,1,256
20438,93447239,93448458,True,2,1219
20439,93447298,93448458,True,2,1160
20440,93450467,93450945,False,1,478
20441,93454400,93455748,False,1,1348
20442,93454400,93456661,False,1,2261
20443,93456620,93459883,False,1,3263
20444,93463040,93464971,False,1,1931
20445,93463040,93464971,True,7,1931
20446,93466064,93466371,True,1,307
20447,93474104,93583821,False,1,109717
20448,93474104,93583821,True,1,109717
20449,93477868,93479642,True,2,1774
20450,93478216,93489036,False,1,10820
20451,93478936,93485067,True,1,6131
20452,93481606,93481992,True,1,386
20453,93485892,93490100,True,2,4208
20454,93488827,93488923,True,1,96
20455,93489964,93490540,True,1,576
20456,93493980,93496579,False,1,2599
20457,93502847,93513909,True,1,11062
20458,93506962,93508035,True,3,1073
20459,93507577,93507994,False,1,417
20460,93507577,93507994,True,2,417
20461,93510210,93517974,False,1,7764
20462,93515814,93516621,True,1,807
20463,93521876,93523521,True,1,1645
20464,93522297,93522380,True,2,83
20465,93522440,93522528,True,1,88
20466,93522565,93536196,True,1,13631
20467,93522580,93527468,True,1,4888
20468,93529910,93530342,True,1,432
20469,93530898,93531057,True,4,159
20470,93538871,93544150,False,1,5279
20471,93538871,93544150,True,1,5279
20472,93540193,93540757,True,1,564
20473,93543510,93616018,True,1,72508
20474,93544021,93616150,True,1,72129
20475,93567653,93567981,False,1,328
20476,93567653,93567981,True,1,328
20477,93572476,93573217,True,1,741
20478,93592104,93602567,False,1,10463
20479,93598342,93598759,True,1,417
20480,93600661,93607455,True,3,6794
20481,93601216,93602229,True,1,1013
20482,93603403,93608785,False,1,5382
20483,93603403,93608785,True,3,5382
20484,93606531,93607479,True,1,948
20485,93612439,93612841,True,1,402
20486,93612439,93616319,False,1,3880
20487,93612439,93616319,True,2,3880
20488,93613799,93614008,True,1,209
20489,93614018,93617320,True,1,3302
20490,93614386,93617320,True,1,2934
20491,93614450,93618581,True,1,4131
20492,93617142,93623624,True,1,6482
20493,93617142,93628024,True,1,10882
20494,93617473,93617978,False,2,505
20495,93642049,93642691,True,1,642
20496,93642049,93643950,True,4,1901
20497,93647505,93648312,True,1,807
20498,93650252,93650388,True,1,136
20499,93654835,93655221,False,1,386
20500,93658676,93658959,False,1,283
20501,93672940,93679471,True,1,6531
20502,93676687,93677651,True,1,964
20503,93679927,93685941,True,3,6014
20504,93679927,93701875,False,1,21948
20505,93679927,93701875,True,1,21948
20506,93681164,93681955,False,2,791
20507,93688761,93690234,True,1,1473
20508,93700724,93707253,True,3,6529
20509,93720153,93727699,True,1,7546
20510,93736011,93736120,False,1,109
20511,93742524,93744203,False,1,1679
20512,93742725,93745388,False,1,2663
20513,93743876,93745257,True,1,1381
20514,93743876,93746373,True,1,2497
20515,93751513,93763577,True,1,12064
20516,93759133,93762422,True,2,3289
20517,93773145,93773451,True,1,306
20518,93796810,93801972,False,1,5162
20519,93798947,93799075,True,1,128
20520,93799117,93800375,False,1,1258
20521,93816789,93827407,True,4,10618
20522,93816789,93833773,True,1,16984
20523,93829265,93832753,True,1,3488
20524,93833768,93835010,True,9,1242
20525,93836640,93863843,True,1,27203
20526,93836686,93836911,True,1,225
20527,93838344,93838478,True,1,134
20528,93838568,93841785,True,1,3217
20529,93840336,93840561,True,1,225
20530,93847494,93848738,True,1,1244
20531,93848733,93853143,True,1,4410
20532,93848799,93849375,True,1,576
20533,93851688,93887901,True,3,36213
20534,93852348,93911754,True,1,59406
20535,93852936,93912004,True,1,59068
20536,93854920,93856681,True,1,1761
20537,93869694,93880357,True,1,10663
20538,93870682,93880357,False,1,9675
20539,93870682,93880357,True,2,9675
20540,93875882,93877488,True,3,1606
20541,93875882,93878301,True,1,2419
20542,93881275,93899954,False,1,18679
20543,93881275,93911069,False,1,29794
20544,93911071,93915385,True,1,4314
20545,93916200,93918579,True,1,2379
20546,93916641,93966996,True,6,50355
20547,93916641,94032176,True,1,115535
20548,93919961,93921546,False,1,1585
20549,93919992,93921718,True,2,1726
20550,93926848,93926943,False,1,95
20551,93926848,93926943,True,1,95
20552,93929690,93931476,True,1,1786
20553,93933434,93948895,True,1,15461
20554,93935844,93937048,True,2,1204
20555,93940349,93940916,True,1,567
20556,93940419,93940916,True,1,497
20557,93941581,93942735,True,1,1154
20558,93941581,93942940,True,1,1359
20559,93945503,93948798,True,1,3295
20560,93945503,93948813,True,1,3310
20561,93968741,94012962,True,1,44221
20562,93971912,93973898,True,1,1986
20563,93972585,93972817,True,1,232
20564,93977546,93982283,False,1,4737
20565,93980405,93982186,True,1,1781
20566,93987108,93988465,True,1,1357
20567,93989139,93989604,False,1,465
20568,94003453,94003595,True,1,142
20569,94003453,94003625,True,1,172
20570,94008833,94010967,False,1,2134
20571,94009500,94011370,True,5,1870
20572,94009531,94011370,True,1,1839
20573,94015432,94016461,True,2,1029
20574,94016327,94017499,True,4,1172
20575,94024796,94026178,True,2,1382
20576,94024831,94084610,False,1,59779
20577,94029786,94030577,True,8,791
20578,94042574,94051329,True,1,8755
20579,94045505,94056382,True,1,10877
20580,94047550,94048982,True,3,1432
20581,94047550,94050226,True,2,2676
20582,94054498,94055472,True,1,974
20583,94059051,94059641,True,1,590
20584,94067042,94067223,False,1,181
20585,94067042,94067223,True,3,181
20586,94067593,94087818,True,1,20225
20587,94068284,94071847,True,1,3563
20588,94071995,94074163,True,1,2168
20589,94073644,94073723,True,1,79
20590,94080838,94082391,True,1,1553
20591,94087187,94087268,True,1,81
20592,94087857,94088191,True,1,334
20593,94100547,94108398,True,1,7851
20594,94106105,94106840,True,1,735
20595,94106623,94111400,True,1,4777
20596,94110225,94138062,False,1,27837
20597,94116641,94117023,True,3,382
20598,94127464,94218986,True,1,91522
20599,94137046,94137285,True,1,239
20600,94141151,94141867,True,1,716
20601,94147190,94156074,False,1,8884
20602,94148742,94149058,True,2,316
20603,94150055,94151242,True,2,1187
20604,94155590,94160476,True,1,4886
20605,94156579,94161024,True,3,4445
20606,94163409,94166193,True,2,2784
20607,94165126,94165365,True,1,239
20608,94167270,94169065,True,1,1795
20609,94167270,94170256,True,1,2986
20610,94177201,94180111,True,3,2910
20611,94184931,94190780,True,1,5849
20612,94195102,94195742,False,1,640
20613,94196904,94197106,False,1,202
20614,94197046,94197216,True,1,170
20615,94202352,94209574,True,3,7222
20616,94202352,94218961,True,1,16609
20617,94209205,94213593,True,1,4388
20618,94210672,94211177,True,1,505
20619,94210874,94214489,True,1,3615
20620,94233142,94235565,True,2,2423
20621,94233142,94258822,True,1,25680
20622,94248653,94250437,True,1,1784
20623,94248767,94255284,True,1,6517
20624,94255133,94351629,True,4,96496
20625,94261741,94263955,True,7,2214
20626,94274793,94275186,True,1,393
20627,94275139,94276039,True,1,900
20628,94275139,94276190,True,1,1051
20629,94279598,94287558,False,1,7960
20630,94279598,94292050,False,1,12452
20631,94285138,94289800,True,2,4662
20632,94287011,94287616,True,1,605
20633,94303997,94306783,True,1,2786
20634,94309473,94309638,True,1,165
20635,94316879,94319232,True,3,2353
20636,94317167,94317288,False,1,121
20637,94317262,94346932,True,2,29670
20638,94317262,94347913,True,1,30651
20639,94317655,94320008,True,1,2353
20640,94319128,94320634,True,2,1506
20641,94319821,94323581,False,1,3760
20642,94327285,94336043,False,1,8758
20643,94330428,94337157,False,1,6729
20644,94336260,94337429,True,1,1169
20645,94337176,94345812,True,4,8636
20646,94339955,94358238,True,1,18283
20647,94346845,94346954,True,1,109
20648,94354614,94356793,True,1,2179
20649,94355166,94356240,True,1,1074
20650,94355564,94355860,True,8,296
20651,94372901,94373665,True,5,764
20652,94378986,94382079,True,3,3093
20653,94385376,94386020,True,1,644
20654,94385507,94385944,False,1,437
20655,94389681,94389956,True,1,275
20656,94398669,94398987,True,3,318
20657,94399997,94401671,True,1,1674
20658,94411924,94426465,True,1,14541
20659,94411946,94416516,False,1,4570
20660,94419693,94428428,True,1,8735
20661,94420298,94428737,True,1,8439
20662,94420909,94428935,True,1,8026
20663,94426770,94445445,False,1,18675
20664,94443022,94443642,True,1,620
20665,94446362,94446558,False,1,196
20666,94446362,94446558,True,2,196
20667,94454720,94457724,False,1,3004
20668,94457224,94457316,False,1,92
20669,94460137,94499671,True,1,39534
20670,94473306,94474377,False,2,1071
20671,94473306,94474377,True,3,1071
20672,94474668,94475052,True,1,384
20673,94483257,94484876,True,2,1619
20674,94498649,94500584,True,2,1935
20675,94498909,94500274,False,1,1365
20676,94522652,94525124,True,6,2472
20677,94528722,94528840,True,2,118
20678,94529602,94541147,True,4,11545
20679,94529602,94542835,True,1,13233
20680,94534454,94536259,True,1,1805
20681,94536391,94537949,True,1,1558
20682,94539707,94546516,True,3,6809
20683,94539756,94540038,True,1,282
20684,94539756,94540079,True,1,323
20685,94539883,94585994,True,3,46111
20686,94540998,94551788,True,1,10790
20687,94542049,94542148,False,1,99
20688,94553600,94554910,True,1,1310
20689,94554109,94554524,False,1,415
20690,94557143,94558369,True,4,1226
20691,94559147,94560196,True,2,1049
20692,94560339,94560869,True,1,530
20693,94567839,94568294,True,4,455
20694,94575428,94576547,False,1,1119
20695,94575791,94581479,True,2,5688
20696,94582121,94586302,True,1,4181
20697,94582499,94586574,True,6,4075
20698,94583467,94587046,True,3,3579
20699,94586355,94610486,False,1,24131
20700,94597081,94601431,True,1,4350
20701,94603097,94604738,True,1,1641
20702,94603224,94604738,True,1,1514
20703,94614433,94620878,True,8,6445
20704,94617427,94623980,True,2,6553
20705,94617616,94618968,False,1,1352
20706,94620049,94623794,True,3,3745
20707,94620174,94621438,True,1,1264
20708,94624527,94626252,True,1,1725
20709,94628398,94631536,True,1,3138
20710,94630242,94632479,True,1,2237
20711,94632397,94635632,True,1,3235
20712,94632569,94634511,True,1,1942
20713,94633697,94635487,False,1,1790
20714,94648913,94653037,False,1,4124
20715,94648913,94685470,True,2,36557
20716,94648913,94688385,True,1,39472
20717,94651268,94655210,False,1,3942
20718,94651268,94655210,True,1,3942
20719,94667427,94671664,False,1,4237
20720,94681305,94682776,True,1,1471
20721,94683227,94683417,True,2,190
20722,94691021,94696979,True,1,5958
20723,94701280,94703590,True,1,2310
20724,94702148,94710867,True,3,8719
20725,94706223,94706350,True,1,127
20726,94706827,94707016,True,1,189
20727,94712720,94712919,True,1,199
20728,94714304,94714554,False,1,250
20729,94735626,94742035,False,1,6409
20730,94742853,94755239,True,2,12386
20731,94743079,94746085,True,1,3006
20732,94753505,94756801,True,2,3296
20733,94754071,94767018,True,1,12947
20734,94760288,94761133,True,1,845
20735,94760968,94766140,False,1,5172
20736,94775163,94776080,True,1,917
20737,94790827,94793276,True,1,2449
20738,94793410,94796897,True,1,3487
20739,94795689,94795833,True,1,144
20740,94799359,94799470,False,1,111
20741,94803523,94804208,True,1,685
20742,94815450,94872199,True,2,56749
20743,94841148,94842804,False,1,1656
20744,94841148,94842804,True,4,1656
20745,94842410,94842983,True,1,573
20746,94845160,94860121,False,1,14961
20747,94845160,94860121,True,2,14961
20748,94845160,94868630,True,1,23470
20749,94847545,94862451,True,1,14906
20750,94854463,94922695,True,1,68232
20751,94857910,94860462,False,1,2552
20752,94860258,94861660,True,1,1402
20753,94860258,94861681,True,1,1423
20754,94863659,94864698,True,1,1039
20755,94863697,94864698,True,1,1001
20756,94880815,94880984,True,1,169
20757,94880892,94885474,True,1,4582
20758,94883485,94889033,False,1,5548
20759,94883562,94884494,True,3,932
20760,94891508,94916538,True,1,25030
20761,94906492,94907884,True,1,1392
20762,94910772,94910851,True,3,79
20763,94911320,94911608,False,1,288
20764,94918905,94919588,True,2,683
20765,94920517,94923408,True,1,2891
20766,94927381,94943242,True,1,15861
20767,94939952,94965571,True,1,25619
20768,94942337,94942412,True,1,75
20769,94942337,94942417,True,1,80
20770,94942337,94942732,True,1,395
20771,94946893,94971279,True,1,24386
20772,94953017,95180990,True,1,227973
20773,94963985,94965538,True,1,1553
20774,94967450,94969066,True,2,1616
20775,94968114,94969055,True,1,941
20776,94969525,94969682,True,2,157
20777,94974945,95001928,True,2,26983
20778,94977931,94981229,True,3,3298
20779,94978905,94984899,True,1,5994
20780,94979929,94981229,True,1,1300
20781,94981142,94981229,True,2,87
20782,94986595,94987324,True,1,729
20783,94990546,94993000,True,1,2454
20784,94990546,94993017,True,1,2471
20785,94990546,95026517,True,1,35971
20786,94991244,94991328,True,4,84
20787,95022484,95022668,False,1,184
20788,95022484,95022668,True,2,184
20789,95036119,95049394,True,3,13275
20790,95036810,95037523,True,1,713
20791,95046354,95047361,True,1,1007
20792,95048568,95049009,True,1,441
20793,95066498,95067451,True,1,953
20794,95070722,95071171,False,1,449
20795,95074816,95076903,True,2,2087
20796,95076821,95096008,True,1,19187
20797,95077034,95077154,True,1,120
20798,95077202,95077806,True,1,604
20799,95079356,95082572,True,1,3216
20800,95098676,95099015,True,1,339
20801,95112583,95113002,False,1,419
20802,95112583,95113002,True,1,419
20803,95112583,95113072,True,1,489
20804,95113680,95113844,True,2,164
20805,95113885,95114049,True,1,164
20806,95133373,95149513,False,1,16140
20807,95138572,95139793,True,1,1221
20808,95138693,95156503,True,1,17810
20809,95145499,95152077,True,1,6578
20810,95162680,95162889,True,2,209
20811,95174329,95174437,True,3,108
20812,95174519,95178231,True,1,3712
20813,95174519,95180002,True,1,5483
20814,95176269,95191965,True,1,15696
20815,95189090,95190891,True,4,1801
20816,95193006,95196886,True,1,3880
20817,95193937,95198246,True,3,4309
20818,95201271,95201380,True,2,109
20819,95202733,95203271,True,1,538
20820,95206458,95209556,True,3,3098
20821,95206746,95212148,False,1,5402
20822,95207978,95214286,True,2,6308
20823,95207978,95214367,True,3,6389
20824,95207978,95217901,True,1,9923
20825,95216634,95217530,True,1,896
20826,95217094,95219337,True,1,2243
20827,95220186,95220830,True,3,644
20828,95220476,95238792,True,1,18316
20829,95223582,95226913,True,1,3331
20830,95248551,95250949,True,1,2398
20831,95248720,95255460,True,1,6740
20832,95257173,95259526,False,1,2353
20833,95257173,95259526,True,2,2353
20834,95260519,95260702,True,1,183
20835,95260746,95265743,True,3,4997
20836,95268206,95280840,True,1,12634
20837,95268364,95280828,False,1,12464
20838,95268364,95280828,True,3,12464
20839,95268483,95280863,True,1,12380
20840,95274743,95276783,True,1,2040
20841,95279328,95283108,True,2,3780
20842,95290031,95290459,False,1,428
20843,95290132,95291955,True,1,1823
20844,95298337,95299396,True,1,1059
20845,95298337,95309903,False,1,11566
20846,95298975,95299932,True,1,957
20847,95306932,95309253,True,1,2321
20848,95307350,95315005,True,1,7655
20849,95310387,95311788,True,4,1401
20850,95312377,95316883,True,1,4506
20851,95316510,95316807,False,1,297
20852,95325742,95337770,True,3,12028
20853,95327377,95330551,True,1,3174
20854,95332730,95341252,True,1,8522
20855,95332818,95341252,True,1,8434
20856,95345482,95362854,False,2,17372
20857,95354129,95355470,True,7,1341
20858,95363040,95365718,False,1,2678
20859,95363040,95365718,True,1,2678
20860,95367405,95376535,True,1,9130
20861,95367808,95371016,True,1,3208
20862,95367808,95371636,True,2,3828
20863,95376835,95377341,True,1,506
20864,95377812,95377925,True,1,113
20865,95378338,95380424,True,1,2086
20866,95379445,95384541,False,1,5096
20867,95379445,95387512,False,1,8067
20868,95380851,95391915,True,1,11064
20869,95389787,95393130,True,1,3343
20870,95389890,95474573,False,1,84683
20871,95392686,95398347,True,1,5661
20872,95392686,95401802,True,1,9116
20873,95399125,95402306,True,1,3181
20874,95400332,95406900,False,1,6568
20875,95410335,95411090,False,1,755
20876,95412595,95413048,True,4,453
20877,95412917,95413048,True,3,131
20878,95428095,95428626,False,1,531
20879,95433404,95441769,True,5,8365
20880,95441051,95442252,True,1,1201
20881,95441051,95442740,True,1,1689
20882,95442673,95442955,False,1,282
20883,95443114,95443443,True,2,329
20884,95449253,95453897,True,3,4644
20885,95449253,95459848,True,1,10595
20886,95452171,95454533,True,2,2362
20887,95461305,95462192,True,7,887
20888,95469592,95470015,False,1,423
20889,95477132,95479547,True,2,2415
20890,95488231,95490324,True,1,2093
20891,95489925,95491090,True,1,1165
20892,95491303,95491597,False,1,294
20893,95494051,95498062,True,4,4011
20894,95494051,95515990,False,1,21939
20895,95496861,95544992,True,1,48131
20896,95499706,95504023,True,1,4317
20897,95505064,95505172,False,2,108
20898,95507541,95518533,True,1,10992
20899,95508992,95520350,False,1,11358
20900,95509821,95514339,True,1,4518
20901,95519596,95521315,True,1,1719
20902,95555413,95555960,False,1,547
20903,95557561,95558907,True,2,1346
20904,95562881,95563777,True,1,896
20905,95576603,95581211,True,2,4608
20906,95587284,95591088,True,1,3804
20907,95587284,95592296,True,2,5012
20908,95591396,95594260,True,1,2864
20909,95591403,95593052,True,5,1649
20910,95591403,95594260,True,2,2857
20911,95591670,95594407,True,1,2737
20912,95595321,95596456,True,3,1135
20913,95595748,95596883,True,1,1135
20914,95598465,95599072,True,1,607
20915,95599256,95623436,False,1,24180
20916,95599256,95633607,False,1,34351
20917,95599256,95633607,True,1,34351
20918,95599256,95638093,True,1,38837
20919,95600415,95601562,False,1,1147
20920,95600415,95601562,True,2,1147
20921,95602184,95604042,False,1,1858
20922,95617821,95617934,True,4,113
20923,95626258,95636139,True,1,9881
20924,95629013,95646472,True,1,17459
20925,95669929,95692510,True,1,22581
20926,95669929,95705061,False,1,35132
20927,95671009,95679443,True,1,8434
20928,95671445,95676596,True,3,5151
20929,95671909,95673818,True,1,1909
20930,95680687,95684301,True,1,3614
20931,95685495,95704676,False,1,19181
20932,95687612,95687783,True,1,171
20933,95689100,95691212,False,1,2112
20934,95689100,95691212,True,3,2112
20935,95693435,95822131,True,2,128696
20936,95697893,95700131,True,1,2238
20937,95699610,95702367,False,1,2757
20938,95699610,95702367,True,4,2757
20939,95705146,95708546,True,1,3400
20940,95713002,95714304,True,1,1302
20941,95714625,95716112,False,1,1487
20942,95723192,95730450,True,1,7258
20943,95727548,95730846,True,1,3298
20944,95728686,95730500,True,1,1814
20945,95732191,95735226,True,5,3035
20946,95733212,95735310,True,1,2098
20947,95734135,95736054,True,2,1919
20948,95737015,95843712,True,1,106697
20949,95757996,95783529,True,6,25533
20950,95757996,95795760,True,1,37764
20951,95760453,95760562,True,1,109
20952,95764818,95765006,False,1,188
20953,95767083,95803574,False,1,36491
20954,95784661,95784766,False,1,105
20955,95785667,95785856,True,2,189
20956,95786607,95786830,True,1,223
20957,95786607,95788915,True,2,2308
20958,95786708,95786830,True,3,122
20959,95788071,95788592,True,1,521
20960,95789205,95791225,True,1,2020
20961,95789648,95790353,False,1,705
20962,95789967,95790353,False,3,386
20963,95790453,95790817,False,1,364
20964,95802955,95803579,True,2,624
20965,95803000,95803579,True,1,579
20966,95813184,95816089,True,5,2905
20967,95813184,95816517,True,1,3333
20968,95817563,95819437,True,1,1874
20969,95819270,95819630,True,1,360
20970,95831705,95832880,True,3,1175
20971,95831705,95834582,True,1,2877
20972,95831705,95837094,True,1,5389
20973,95832964,95877282,False,1,44318
20974,95834564,95836079,True,1,1515
20975,95837158,95837393,True,3,235
20976,95837422,95850921,True,1,13499
20977,95839372,95839585,True,1,213
20978,95842936,95846672,False,1,3736
20979,95842936,95846690,False,1,3754
20980,95846639,95846776,True,1,137
20981,95848627,95853393,True,1,4766
20982,95865000,95866621,True,1,1621
20983,95865000,95866700,True,3,1700
20984,95877839,95880771,True,2,2932
20985,95889708,95890571,True,1,863
20986,95890502,95890583,True,1,81
20987,95906463,95908857,True,1,2394
20988,95934784,95936708,False,1,1924
20989,95934784,95936708,True,1,1924
20990,95947028,95947309,True,1,281
20991,95957200,95958186,False,1,986
20992,95957200,95958186,True,1,986
20993,95962915,95964966,True,1,2051
20994,95967540,95969319,False,1,1779
20995,95973286,95976584,True,1,3298
20996,95975319,95984240,False,1,8921
20997,95980033,96086953,True,2,106920
20998,95982037,95982380,True,1,343
20999,95982536,95983856,True,2,1320
21000,95999200,96002917,True,1,3717
21001,95999200,96017127,False,1,17927
21002,96004669,96133717,True,2,129048
21003,96007919,96010285,True,1,2366
21004,96019472,96061523,True,1,42051
21005,96020852,96028284,True,3,7432
21006,96021755,96062625,True,6,40870
21007,96022337,96029157,True,1,6820
21008,96031523,96033921,True,1,2398
21009,96033641,96034994,False,1,1353
21010,96037692,96045873,True,1,8181
21011,96037946,96038723,True,1,777
21012,96037946,96040719,True,1,2773
21013,96041598,96043272,False,1,1674
21014,96041598,96043401,False,1,1803
21015,96048575,96048675,True,4,100
21016,96053791,96055128,True,4,1337
21017,96055086,96058378,False,2,3292
21018,96069444,96069524,True,3,80
21019,96080505,96080917,True,1,412
21020,96091558,96091648,True,1,90
21021,96091947,96092716,True,2,769
21022,96093676,96096996,True,1,3320
21023,96100762,96101192,True,1,430
21024,96111181,96111855,True,1,674
21025,96111181,96112312,True,7,1131
21026,96113087,96116475,True,3,3388
21027,96126748,96127413,True,1,665
21028,96136596,96138130,True,1,1534
21029,96138131,96141941,False,1,3810
21030,96138131,96141941,True,2,3810
21031,96150334,96150910,True,1,576
21032,96150334,96156036,True,2,5702
21033,96173096,96275940,True,2,102844
21034,96173096,96327930,True,1,154834
21035,96174140,96276468,True,1,102328
21036,96183336,96187587,True,1,4251
21037,96208219,96208931,True,3,712
21038,96208219,96209814,True,1,1595
21039,96222991,96285150,True,1,62159
21040,96226088,96226419,False,1,331
21041,96229663,96231451,True,1,1788
21042,96234595,96234701,False,5,106
21043,96234595,96234701,True,1,106
21044,96245011,96247973,True,2,2962
21045,96256874,96257161,True,1,287
21046,96256874,96257203,True,1,329
21047,96257711,96258567,False,1,856
21048,96257760,96258528,True,1,768
21049,96257823,96258653,True,1,830
21050,96257865,96258695,True,2,830
21051,96259920,96260255,False,1,335
21052,96259920,96260255,True,6,335
21053,96267348,96274778,True,2,7430
21054,96277315,96278479,True,1,1164
21055,96278918,96279561,True,1,643
21056,96283791,96284091,False,1,300
21057,96283791,96284091,True,1,300
21058,96286414,96286617,True,1,203
21059,96310901,96313272,True,1,2371
21060,96312044,96312970,False,1,926
21061,96315090,96315795,True,1,705
21062,96322181,96324021,True,1,1840
21063,96330764,96331320,False,1,556
21064,96334189,96339775,True,1,5586
21065,96335343,96339734,False,1,4391
21066,96344362,96345594,True,1,1232
21067,96345555,96347423,True,2,1868
21068,96346232,96347843,True,1,1611
21069,96347071,96365936,False,2,18865
21070,96347071,96365936,True,6,18865
21071,96354175,96354366,True,4,191
21072,96366751,96367449,True,1,698
21073,96371721,96373246,False,2,1525
21074,96371911,96373286,False,1,1375
21075,96379084,96379958,True,3,874
21076,96379181,96381374,False,1,2193
21077,96380070,96380787,True,1,717
21078,96399242,96399499,True,4,257
21079,96402098,96402226,False,1,128
21080,96402098,96402226,True,3,128
21081,96412332,96412795,True,1,463
21082,96413074,96559338,True,1,146264
21083,96415576,96416666,True,1,1090
21084,96416174,96422395,False,1,6221
21085,96422205,96443610,True,3,21405
21086,96422662,96424510,True,1,1848
21087,96423849,96424016,True,1,167
21088,96431781,96432149,True,1,368
21089,96433395,96436413,True,1,3018
21090,96433395,96438364,True,1,4969
21091,96441864,96441973,False,1,109
21092,96457977,96467039,True,1,9062
21093,96471115,96493262,False,1,22147
21094,96474107,96475435,True,4,1328
21095,96485961,96486429,True,2,468
21096,96486803,96488092,False,1,1289
21097,96486803,96488092,True,3,1289
21098,96495421,96497373,True,1,1952
21099,96497832,96499014,True,1,1182
21100,96498180,96498325,True,1,145
21101,96498326,96506857,True,1,8531
21102,96500222,96506531,True,1,6309
21103,96502478,96503358,True,1,880
21104,96509623,96510543,False,1,920
21105,96510652,96514675,False,1,4023
21106,96510652,96514675,True,3,4023
21107,96510652,96517369,True,1,6717
21108,96510652,96532602,False,1,21950
21109,96521449,96522786,True,1,1337
21110,96523634,96524415,True,2,781
21111,96524465,96524593,False,1,128
21112,96524465,96524593,True,1,128
21113,96530038,96530678,True,1,640
21114,96549229,96695138,False,1,145909
21115,96556742,96564250,False,1,7508
21116,96556742,96564250,True,2,7508
21117,96563912,96565821,True,1,1909
21118,96565299,96571708,False,1,6409
21119,96565299,96571708,True,4,6409
21120,96610736,96611258,True,1,522
21121,96634346,96634846,True,2,500
21122,96637207,96638628,True,3,1421
21123,96647249,96647893,True,6,644
21124,96650365,96662762,True,1,12397
21125,96650365,96664596,True,1,14231
21126,96669332,96669497,True,1,165
21127,96669332,96670895,True,1,1563
21128,96669332,96671972,True,1,2640
21129,96671881,96672151,True,4,270
21130,96671881,96673803,True,1,1922
21131,96678979,96681807,True,1,2828
21132,96687757,96715476,True,1,27719
21133,96696828,96699727,True,1,2899
21134,96697616,96700601,True,1,2985
21135,96703718,96706861,True,1,3143
21136,96705491,96706490,True,1,999
21137,96705988,96861255,True,1,155267
21138,96710230,96725511,True,1,15281
21139,96714745,96715319,True,2,574
21140,96714816,96715319,True,2,503
21141,96733951,96733951,True,1,0
21142,96734083,96734617,False,1,534
21143,96734083,96734617,True,3,534
21144,96734861,96735180,True,1,319
21145,96734861,96735324,True,1,463
21146,96734861,96735540,True,4,679
21147,96736515,96737852,True,2,1337
21148,96748546,96751634,True,1,3088
21149,96760458,96762248,True,1,1790
21150,96761174,96762619,True,1,1445
21151,96763746,96765328,True,1,1582
21152,96769471,96770189,True,1,718
21153,96780216,96784981,False,1,4765
21154,96780695,96785671,False,1,4976
21155,96790786,96793741,True,1,2955
21156,96790786,96813558,True,1,22772
21157,96791329,96791422,False,1,93
21158,96796382,96797793,True,5,1411
21159,96796382,96815357,True,1,18975
21160,96796419,96797818,True,3,1399
21161,96811109,96827608,True,2,16499
21162,96826530,96827220,True,2,690
21163,96826530,96839621,True,1,13091
21164,96827518,96827853,True,1,335
21165,96827518,96827880,True,1,362
21166,96827518,96828504,True,1,986
21167,96827518,96830550,True,1,3032
21168,96827612,96829437,True,1,1825
21169,96832206,96843454,False,1,11248
21170,96847028,96854381,False,1,7353
21171,96847028,96854381,True,1,7353
21172,96852548,96854426,True,2,1878
21173,96857649,96866473,True,1,8824
21174,96858734,96860792,True,6,2058
21175,96865701,96866294,True,1,593
21176,96866713,96867526,True,1,813
21177,96866896,96872855,True,4,5959
21178,96875847,96876817,True,5,970
21179,96890593,96894691,True,1,4098
21180,96890886,96892618,True,1,1732
21181,96891257,96892389,True,4,1132
21182,96892688,96893042,True,1,354
21183,96901218,96903124,True,2,1906
21184,96910305,96910380,False,1,75
21185,96912304,96912982,True,1,678
21186,96912304,96913016,True,1,712
21187,96912657,96912790,True,1,133
21188,96913568,96913962,True,1,394
21189,96914981,96915241,False,1,260
21190,96915590,96915713,True,1,123
21191,96919189,96921070,True,1,1881
21192,96942768,96951267,True,1,8499
21193,96948155,96948694,True,7,539
21194,96962656,96972515,True,1,9859
21195,96963407,96963496,True,1,89
21196,96967916,96977305,True,1,9389
21197,96967916,96996695,True,1,28779
21198,96971527,96972306,True,1,779
21199,96976316,96979554,True,1,3238
21200,96976609,96979554,True,2,2945
21201,96977422,96979937,True,1,2515
21202,96985579,96987089,True,1,1510
21203,96988870,96995151,False,1,6281
21204,96988870,96995151,True,2,6281
21205,96989516,97005758,True,1,16242
21206,96995975,97009813,True,1,13838
21207,96997024,96998226,True,2,1202
21208,96999575,97000801,True,2,1226
21209,97000066,97012559,True,1,12493
21210,97001076,97001424,True,4,348
21211,97002500,97002692,True,1,192
21212,97007268,97007782,True,1,514
21213,97007268,97041554,True,3,34286
21214,97007268,97042510,True,1,35242
21215,97012711,97013113,True,1,402
21216,97014486,97014983,True,1,497
21217,97014546,97014857,True,1,311
21218,97014593,97014912,True,1,319
21219,97019781,97019954,True,8,173
21220,97020168,97020321,True,1,153
21221,97021305,97024480,True,1,3175
21222,97026201,97029560,True,2,3359
21223,97032889,97032977,True,1,88
21224,97033071,97040573,True,1,7502
21225,97033191,97040693,True,1,7502
21226,97033895,97035908,True,1,2013
21227,97034336,97040107,True,1,5771
21228,97034370,97039863,True,4,5493
21229,97038047,97039110,True,1,1063
21230,97043310,97044618,True,2,1308
21231,97043310,97051843,True,1,8533
21232,97046296,97047980,True,1,1684
21233,97066478,97070109,True,1,3631
21234,97083747,97097492,True,1,13745
21235,97084262,97084494,True,1,232
21236,97084262,97084505,True,1,243
21237,97084559,97084855,True,1,296
21238,97085352,97086553,True,2,1201
21239,97091482,97094076,True,1,2594
21240,97102744,97107308,True,1,4564
21241,97102744,97107351,True,3,4607
21242,97105240,97106028,True,1,788
21243,97106002,97111009,True,1,5007
21244,97106002,97111031,False,1,5029
21245,97108206,97111235,True,1,3029
21246,97110324,97112421,False,1,2097
21247,97110324,97112421,True,1,2097
21248,97112355,97114533,True,6,2178
21249,97112569,97113177,True,2,608
21250,97112569,97115639,False,1,3070
21251,97113575,97129870,True,1,16295
21252,97124860,97125403,False,1,543
21253,97133360,97153010,True,1,19650
21254,97135008,97160964,False,1,25956
21255,97149808,97152692,True,1,2884
21256,97160058,97163188,True,1,3130
21257,97171855,97179673,False,1,7818
21258,97171855,97179673,True,1,7818
21259,97171952,97172298,True,1,346
21260,97172597,97199057,True,1,26460
21261,97199190,97199871,True,1,681
21262,97199719,97200284,True,1,565
21263,97202563,97203973,True,1,1410
21264,97203360,97203719,True,1,359
21265,97220303,97223878,False,1,3575
21266,97220393,97223827,True,2,3434
21267,97223742,97226756,True,2,3014
21268,97228260,97229219,True,1,959
21269,97237691,97237830,False,2,139
21270,97237691,97237830,True,4,139
21271,97240410,97244391,True,2,3981
21272,97241007,97242274,True,1,1267
21273,97241314,97244083,True,1,2769
21274,97244338,97246684,True,1,2346
21275,97247296,97248083,True,1,787
21276,97247612,97248083,True,1,471
21277,97248967,97250976,True,1,2009
21278,97249074,97249452,True,1,378
21279,97249074,97249507,True,1,433
21280,97249074,97250070,True,1,996
21281,97250901,97251021,False,1,120
21282,97250901,97251021,True,1,120
21283,97252206,97302879,False,1,50673
21284,97268386,97272854,False,1,4468
21285,97273056,97273497,True,1,441
21286,97277490,97284657,True,25,7167
21287,97278672,97279553,False,1,881
21288,97279446,97325554,False,1,46108
21289,97290034,97294477,True,1,4443
21290,97292572,97292754,True,1,182
21291,97301310,97303841,True,2,2531
21292,97302759,97302848,False,1,89
21293,97314829,97315155,False,1,326
21294,97316734,97317168,True,1,434
21295,97320637,97321354,True,1,717
21296,97321035,97321554,True,2,519
21297,97321085,97321576,True,1,491
21298,97321250,97321639,True,1,389
21299,97321250,97321847,True,1,597
21300,97321428,97321538,True,1,110
21301,97322592,97322719,True,1,127
21302,97325798,97326479,True,1,681
21303,97326588,97326804,True,7,216
21304,97336056,97346052,True,6,9996
21305,97344732,97344839,True,1,107
21306,97345819,97345926,True,1,107
21307,97347919,97348997,True,1,1078
21308,97349560,97351000,True,3,1440
21309,97354008,97354873,True,1,865
21310,97356515,97358881,True,1,2366
21311,97369881,97372411,True,1,2530
21312,97372606,97375071,True,2,2465
21313,97376926,97378750,False,1,1824
21314,97376926,97378750,True,5,1824
21315,97379368,97379780,True,1,412
21316,97397111,97398324,False,2,1213
21317,97397111,97398324,True,12,1213
21318,97397111,97410867,True,1,13756
21319,97404078,97405266,False,1,1188
21320,97404078,97405266,True,1,1188
21321,97404865,97423854,True,1,18989
21322,97410202,97412607,False,1,2405
21323,97413904,97416043,False,1,2139
21324,97413904,97424999,True,1,11095
21325,97423457,97427272,True,2,3815
21326,97424559,97445408,True,2,20849
21327,97426574,97429937,True,13,3363
21328,97437838,97438101,True,1,263
21329,97451641,97452404,True,2,763
21330,97462556,97462773,True,2,217
21331,97462556,97463008,False,2,452
21332,97462556,97463404,True,2,848
21333,97463734,97483629,True,1,19895
21334,97463734,97483703,True,1,19969
21335,97463737,97483629,True,1,19892
21336,97471302,97472172,True,3,870
21337,97473509,97477347,True,1,3838
21338,97475727,97476427,False,4,700
21339,97475727,97476427,True,20,700
21340,97481989,97484783,False,1,2794
21341,97481989,97484783,True,3,2794
21342,97483306,97485734,True,1,2428
21343,97501829,97501910,True,2,81
21344,97510491,97510967,True,3,476
21345,97510559,97510967,True,2,408
21346,97510570,97510967,True,1,397
21347,97511167,97511311,True,1,144
21348,97511397,97514003,True,1,2606
21349,97511633,97514239,False,2,2606
21350,97511633,97514239,True,5,2606
21351,97513519,97517228,True,1,3709
21352,97514190,97564787,True,1,50597
21353,97514662,97515157,True,1,495
21354,97514662,97565031,True,1,50369
21355,97517982,97518537,False,1,555
21356,97521200,97522479,True,1,1279
21357,97523058,97524556,True,1,1498
21358,97523426,97524557,True,1,1131
21359,97523647,97524555,True,4,908
21360,97525608,97532500,True,3,6892
21361,97526955,97530224,True,1,3269
21362,97542029,97542128,True,1,99
21363,97544054,97544849,True,1,795
21364,97546831,97547855,True,1,1024
21365,97548531,97548659,True,1,128
21366,97549207,97549483,True,1,276
21367,97559489,97559714,True,1,225
21368,97559874,97560210,True,3,336
21369,97569841,97570521,True,1,680
21370,97570590,97574233,True,1,3643
21371,97577243,97577699,True,2,456
21372,97592383,97603882,True,1,11499
21373,97594117,97611244,False,1,17127
21374,97594117,97611244,True,3,17127
21375,97594117,97614590,True,1,20473
21376,97600483,97600553,True,2,70
21377,97600643,97600973,True,1,330
21378,97602591,97602669,True,2,78
21379,97603030,97607382,True,1,4352
21380,97613947,97614114,True,1,167
21381,97614886,97635215,True,1,20329
21382,97617427,97626515,True,1,9088
21383,97638705,97641098,True,2,2393
21384,97657495,97658713,True,1,1218
21385,97660830,97661698,True,1,868
21386,97666325,97667694,True,3,1369
21387,97666325,97668475,False,1,2150
21388,97666756,97667878,True,2,1122
21389,97666870,97667957,True,1,1087
21390,97668179,97670957,True,2,2778
21391,97672211,97681832,False,1,9621
21392,97672305,97672878,True,5,573
21393,97677261,97679150,True,1,1889
21394,97688883,97694837,True,1,5954
21395,97689970,97692924,True,1,2954
21396,97689970,97693240,True,1,3270
21397,97692711,97709330,True,1,16619
21398,97692711,97712549,True,1,19838
21399,97735444,97736641,True,1,1197
21400,97741914,97747121,False,1,5207
21401,97746336,97746451,False,1,115
21402,97746336,97746451,True,2,115
21403,97746536,97746836,True,1,300
21404,97752644,97753306,True,1,662
21405,97754166,97756981,False,1,2815
21406,97756067,97759296,True,1,3229
21407,97756067,97812033,False,1,55966
21408,97768234,97776215,True,1,7981
21409,97770803,97927694,True,1,156891
21410,97771230,97771807,False,1,577
21411,97772410,97773311,True,2,901
21412,97774353,97775151,True,2,798
21413,97774986,97782191,True,1,7205
21414,97774986,97783425,True,1,8439
21415,97782034,97782218,False,1,184
21416,97789560,97790293,True,2,733
21417,97796324,97799753,True,1,3429
21418,97804083,97804730,True,1,647
21419,97818623,97823947,False,1,5324
21420,97822366,97830448,True,1,8082
21421,97824403,97828868,True,1,4465
21422,97826112,97829462,True,1,3350
21423,97829900,97835273,True,1,5373
21424,97833086,97835984,True,3,2898
21425,97833122,97835984,True,2,2862
21426,97837038,97910186,False,1,73148
21427,97837038,98005372,False,1,168334
21428,97839264,97839405,True,1,141
21429,97839716,97841107,True,1,1391
21430,97842024,97876585,True,1,34561
21431,97842805,97847114,False,1,4309
21432,97845106,97845330,True,1,224
21433,97857739,97868565,False,1,10826
21434,97858484,97858907,True,2,423
21435,97864662,97864884,True,5,222
21436,97868415,97873180,True,1,4765
21437,97869971,97875193,True,1,5222
21438,97870138,97870226,True,1,88
21439,97880907,97883003,True,1,2096
21440,97881110,97883003,True,1,1893
21441,97881110,97884439,True,1,3329
21442,97888617,97888894,True,1,277
21443,97898478,97898669,True,1,191
21444,97912711,97916459,True,2,3748
21445,97918078,97923888,True,1,5810
21446,97920424,97925073,False,2,4649
21447,97923266,97923764,True,1,498
21448,97927654,97939138,False,1,11484
21449,97929396,97946717,True,1,17321
21450,97930140,97963937,True,1,33797
21451,97930200,97931941,True,1,1741
21452,97938062,97938691,False,1,629
21453,97939714,97939810,True,1,96
21454,97944500,98014524,True,1,70024
21455,97945247,97946072,True,2,825
21456,97972428,97975015,True,2,2587
21457,97976753,97978756,True,1,2003
21458,97977460,97979150,True,1,1690
21459,97977573,97982890,True,1,5317
21460,97998491,97999086,True,1,595
21461,97998491,98003838,True,2,5347
21462,98038456,98039299,True,3,843
21463,98040387,98041163,True,1,776
21464,98041396,98041513,True,1,117
21465,98055383,98055604,True,2,221
21466,98056626,98057657,True,1,1031
21467,98061619,98063930,True,2,2311
21468,98064519,98065155,True,4,636
21469,98067245,98067486,True,1,241
21470,98068869,98068960,True,1,91
21471,98077566,98078436,True,1,870
21472,98083282,98087600,True,4,4318
21473,98089600,98093488,True,1,3888
21474,98089600,98093702,True,1,4102
21475,98089600,98094089,True,1,4489
21476,98089600,98095358,True,1,5758
21477,98089999,98092152,True,2,2153
21478,98090132,98094106,True,1,3974
21479,98094952,98095716,False,1,764
21480,98094952,98095716,True,3,764
21481,98102379,98106044,True,2,3665
21482,98106060,98106155,True,3,95
21483,98106060,98106170,True,1,110
21484,98106713,98106977,True,1,264
21485,98107178,98107265,True,1,87
21486,98111008,98134624,True,1,23616
21487,98115910,98117684,True,1,1774
21488,98117449,98118394,True,1,945
21489,98118290,98118850,True,1,560
21490,98118727,98118850,True,1,123
21491,98123349,98123596,True,3,247
21492,98123598,98123687,True,1,89
21493,98127485,98133423,True,5,5938
21494,98134133,98134709,True,2,576
21495,98135218,98136755,True,3,1537
21496,98147652,98149632,False,1,1980
21497,98151024,98152125,True,1,1101
21498,98153909,98162763,True,1,8854
21499,98158332,98169476,True,1,11144
21500,98170459,98171780,True,2,1321
21501,98184072,98185477,True,2,1405
21502,98208482,98210605,True,1,2123
21503,98214840,98215019,True,4,179
21504,98216020,98217379,True,1,1359
21505,98217374,98227151,True,1,9777
21506,98234256,98242897,True,3,8641
21507,98237287,98237715,True,3,428
21508,98239319,98239809,True,1,490
21509,98240580,98240946,True,1,366
21510,98242559,98251086,True,1,8527
21511,98242559,98274207,True,1,31648
21512,98245347,98246204,True,3,857
21513,98245735,98246446,True,1,711
21514,98252701,98253374,True,1,673
21515,98252701,98264172,True,1,11471
21516,98253641,98264172,True,1,10531
21517,98254017,98304788,True,1,50771
21518,98254017,98308394,True,1,54377
21519,98255335,98256794,True,1,1459
21520,98256541,98257354,True,1,813
21521,98257844,98259172,True,1,1328
21522,98258766,98260094,True,1,1328
21523,98266876,98268787,True,5,1911
21524,98268125,98270515,True,1,2390
21525,98273196,98274060,True,1,864
21526,98273254,98275177,True,1,1923
21527,98275341,98275862,True,1,521
21528,98276236,98276849,True,1,613
21529,98282672,98283414,True,1,742
21530,98282698,98307747,True,3,25049
21531,98282698,98324575,True,1,41877
21532,98291439,98293093,True,4,1654
21533,98292723,98293720,True,3,997
21534,98303104,98303256,False,1,152
21535,98305948,98306031,True,1,83
21536,98317341,98317410,True,1,69
21537,98320356,98321453,True,1,1097
21538,98322473,98322692,True,3,219
21539,98323872,98323959,True,1,87
21540,98329961,98331381,True,1,1420
21541,98330304,98330624,True,1,320
21542,98332810,98333137,True,1,327
21543,98336683,98338375,True,3,1692
21544,98336683,98343582,True,2,6899
21545,98336683,98343586,True,1,6903
21546,98357138,98358178,True,3,1040
21547,98376260,98377299,True,4,1039
21548,98378506,98378970,True,1,464
21549,98380400,98385130,True,2,4730
21550,98380400,98399344,True,1,18944
21551,98387254,98395448,True,2,8194
21552,98395232,98396271,True,5,1039
21553,98398563,98405437,True,1,6874
21554,98398573,98405437,True,1,6864
21555,98401660,98403665,True,1,2005
21556,98406515,98406983,True,2,468
21557,98406916,98409081,True,1,2165
21558,98414338,98415377,True,4,1039
21559,98416550,98425339,True,2,8789
21560,98418135,98419084,True,1,949
21561,98418867,98420066,True,1,1199
21562,98418867,98426481,True,1,7614
21563,98419304,98420659,False,1,1355
21564,98420541,98426350,False,1,5809
21565,98423507,98423844,True,1,337
21566,98425010,98429378,True,2,4368
21567,98427761,98432121,True,1,4360
21568,98428757,98436116,True,1,7359
21569,98430553,98430981,True,1,428
21570,98433061,98433225,True,2,164
21571,98433355,98434394,True,3,1039
21572,98433355,98453454,True,3,20099
21573,98435616,98436080,True,1,464
21574,98437828,98438457,True,1,629
21575,98448013,98448461,True,1,448
21576,98448095,98448950,True,2,855
21577,98452382,98453421,True,1,1039
21578,98456017,98493210,True,6,37193
21579,98456017,98498524,True,1,42507
21580,98456017,98508815,True,1,52798
21581,98461919,98462480,True,3,561
21582,98461919,98463906,True,2,1987
21583,98471489,98472528,True,2,1039
21584,98471753,98471833,True,1,80
21585,98473938,98486129,True,3,12191
21586,98485837,98486981,True,1,1144
21587,98487490,98487818,True,2,328
21588,98487785,98488047,True,1,262
21589,98488399,98489683,True,1,1284
21590,98488429,98488700,False,2,271
21591,98488429,98488700,True,1,271
21592,98502939,98505693,True,1,2754
21593,98505807,98507012,True,1,1205
21594,98511850,98512015,False,2,165
21595,98512840,98524347,True,1,11507
21596,98517856,98517961,True,1,105
21597,98518875,98519328,True,1,453
21598,98525240,98543444,False,1,18204
21599,98539336,98539746,True,2,410
21600,98556815,98570083,False,1,13268
21601,98565957,98569396,True,2,3439
21602,98577346,98580591,True,1,3245
21603,98593655,98594693,True,2,1038
21604,98596143,98596619,True,1,476
21605,98597039,98598001,True,4,962
21606,98598880,98598954,True,2,74
21607,98605161,98605302,True,1,141
21608,98606594,98606679,False,1,85
21609,98612767,98613805,True,2,1038
21610,98614907,98617509,True,2,2602
21611,98618256,98618787,True,1,531
21612,98625340,98626660,True,1,1320
21613,98630460,98630821,True,3,361
21614,98631725,98633304,True,2,1579
21615,98631879,98632917,True,2,1038
21616,98632878,98632984,True,1,106
21617,98632878,98633191,True,1,313
21618,98633782,98634085,True,1,303
21619,98634295,98634471,True,1,176
21620,98650985,98652023,True,2,1038
21621,98662882,98663427,True,2,545
21622,98670101,98671139,True,2,1038
21623,98676183,98678529,True,1,2346
21624,98681161,98681625,True,2,464
21625,98689199,98690237,True,1,1038
21626,98696469,98702472,True,1,6003
21627,98699263,98711350,True,1,12087
21628,98708323,98709361,True,2,1038
21629,98719458,98720849,True,2,1391
21630,98727345,98728383,True,2,1038
21631,98730013,98735969,True,5,5956
21632,98734369,98738457,True,1,4088
21633,98744772,98745484,True,1,712
21634,98751556,98752128,True,1,572
21635,98768604,98769508,True,1,904
21636,98781381,98781792,True,1,411
21637,98789788,98790066,True,1,278
21638,98792843,98792979,True,3,136
21639,98794393,98796505,True,2,2112
21640,98796807,98796907,True,1,100
21641,98797641,98801239,True,1,3598
21642,98806935,98807347,True,2,412
21643,98815807,98819447,True,1,3640
21644,98823176,98846212,True,4,23036
21645,98828412,98828581,True,1,169
21646,98829356,98831041,False,1,1685
21647,98837761,98838367,True,3,606
21648,98844799,98846665,True,1,1866
21649,98862261,98868965,True,1,6704
21650,98874006,98875193,True,1,1187
21651,98896188,98941332,True,1,45144
21652,98899711,98900125,True,1,414
21653,98904219,98906072,True,1,1853
21654,98909010,98909256,True,1,246
21655,98909361,98909459,True,5,98
21656,98909361,98910901,True,1,1540
21657,98916335,98916919,False,1,584
21658,98916335,98916919,True,4,584
21659,98916335,98917058,True,1,723
21660,98916335,98917569,True,2,1234
21661,98917442,98917598,False,1,156
21662,98917442,98917598,True,2,156
21663,98922072,98922145,True,1,73
21664,98923703,98923776,True,1,73
21665,98924993,98949701,True,1,24708
21666,98924993,98955778,True,1,30785
21667,98924997,98955799,False,1,30802
21668,98924997,98955799,True,1,30802
21669,98935425,98947344,True,1,11919
21670,98937431,98937590,True,2,159
21671,98944249,98944411,True,3,162
21672,98955866,98959055,False,1,3189
21673,98967472,98968114,True,1,642
21674,98982444,98982647,True,3,203
21675,98990565,98991134,True,2,569
21676,98992234,98992324,False,1,90
21677,98994335,98999729,False,1,5394
21678,98994335,98999729,True,3,5394
21679,99000734,99000947,True,1,213
21680,99012623,99053985,True,1,41362
21681,99015271,99021844,True,1,6573
21682,99015271,99055414,True,1,40143
21683,99015430,99015960,True,1,530
21684,99015430,99021844,True,2,6414
21685,99015430,99032249,True,2,16819
21686,99015430,99033621,True,1,18191
21687,99015430,99037818,True,1,22388
21688,99015430,99037822,True,1,22392
21689,99015430,99055414,True,1,39984
21690,99015570,99055414,True,1,39844
21691,99017931,99025434,True,2,7503
21692,99029649,99124438,True,1,94789
21693,99037766,99038557,False,1,791
21694,99038803,99039038,True,1,235
21695,99043101,99043632,False,1,531
21696,99044287,99044589,True,2,302
21697,99049729,99082047,True,3,32318
21698,99052582,99052816,True,1,234
21699,99070490,99070888,True,1,398
21700,99070695,99070927,True,1,232
21701,99077982,99078216,True,1,234
21702,99094582,99094933,True,1,351
21703,99100360,99130333,True,2,29973
21704,99101991,99131224,False,1,29233
21705,99101991,99131224,True,1,29233
21706,99102120,99102354,True,2,234
21707,99103177,99104087,False,1,910
21708,99103177,99104087,True,1,910
21709,99115392,99115626,True,2,234
21710,99118469,99118993,False,1,524
21711,99118469,99118993,True,1,524
21712,99129662,99131390,True,1,1728
21713,99144809,99145960,True,1,1151
21714,99146432,99147448,True,2,1016
21715,99146432,99147750,True,1,1318
21716,99158350,99158668,True,3,318
21717,99160346,99177675,True,1,17329
21718,99165044,99180070,True,1,15026
21719,99175613,99177717,False,1,2104
21720,99177357,99178124,False,1,767
21721,99177357,99178124,True,2,767
21722,99184180,99254327,True,1,70147
21723,99187859,99188905,True,1,1046
21724,99210839,99213298,True,1,2459
21725,99219466,99222534,True,2,3068
21726,99219479,99222547,True,5,3068
21727,99235315,99235721,True,1,406
21728,99241463,99244566,True,1,3103
21729,99241535,99246292,True,1,4757
21730,99243657,99284954,True,1,41297
21731,99245641,99253776,False,1,8135
21732,99245641,99253776,True,1,8135
21733,99247770,99248111,False,1,341
21734,99252116,99254109,True,1,1993
21735,99256566,99264746,False,1,8180
21736,99256566,99264746,True,1,8180
21737,99263270,99263648,False,1,378
21738,99263270,99263648,True,1,378
21739,99264373,99264739,True,1,366
21740,99273145,99273225,False,1,80
21741,99273312,99277551,True,1,4239
21742,99284676,99285018,True,1,342
21743,99292321,99295258,True,1,2937
21744,99302854,99303260,True,1,406
21745,99308729,99312369,True,7,3640
21746,99309044,99309227,True,1,183
21747,99317831,99322110,True,1,4279
21748,99320683,99323617,True,8,2934
21749,99322162,99322462,True,6,300
21750,99353908,99363133,False,1,9225
21751,99368990,99373237,True,2,4247
21752,99371961,99372115,True,1,154
21753,99374626,99375238,True,3,612
21754,99378436,99378867,True,1,431
21755,99387154,99387721,True,4,567
21756,99391661,99393965,True,2,2304
21757,99416640,99418508,True,4,1868
21758,99421847,99424050,True,1,2203
21759,99423280,99423354,True,2,74
21760,99429622,99515117,True,1,85495
21761,99431011,99431601,True,1,590
21762,99434102,99434355,True,6,253
21763,99443001,99443124,True,1,123
21764,99446193,99446319,True,1,126
21765,99447368,99447569,True,1,201
21766,99447408,99447609,True,1,201
21767,99447659,99447860,False,1,201
21768,99453215,99455921,True,1,2706
21769,99453988,99455510,True,1,1522
21770,99473915,99473999,False,1,84
21771,99473915,99473999,True,1,84
21772,99482374,99482465,True,1,91
21773,99482374,99483587,True,1,1213
21774,99518247,99518327,True,1,80
21775,99518511,99518593,True,1,82
21776,99522057,99525696,False,2,3639
21777,99522057,99525696,True,2,3639
21778,99522057,99615238,True,1,93181
21779,99526815,99527261,True,4,446
21780,99567724,99569322,False,1,1598
21781,99586540,99586751,True,1,211
21782,99587045,99589499,True,1,2454
21783,99589847,99590647,True,1,800
21784,99605134,99608126,True,2,2992
21785,99605134,99610587,True,1,5453
21786,99617857,99618422,False,1,565
21787,99626965,99628183,True,1,1218
21788,99644301,99645051,False,2,750
21789,99644301,99645051,True,4,750
21790,99656486,99657038,True,1,552
21791,99661785,99662691,True,1,906
21792,99664629,99666746,True,1,2117
21793,99668554,99668687,True,1,133
21794,99668849,99671306,True,1,2457
21795,99669892,99670112,True,1,220
21796,99672216,99672291,True,1,75
21797,99672253,99672342,True,1,89
21798,99676977,99677177,False,1,200
21799,99677508,99677645,True,3,137
21800,99677542,99677645,True,2,103
21801,99681562,99682298,True,1,736
21802,99685507,99685965,True,1,458
21803,99688546,99689545,True,7,999
21804,99732685,99732916,True,2,231
21805,99733789,100144963,True,1,411174
21806,99734157,99734823,True,1,666
21807,99734306,99734878,True,2,572
21808,99761938,99762549,True,1,611
21809,99767914,99788866,True,3,20952
21810,99783058,99784290,True,1,1232
21811,99783058,99785518,True,1,2460
21812,99785966,99810679,True,1,24713
21813,99787094,99811276,True,1,24182
21814,99792735,99793023,True,5,288
21815,99793570,99793662,True,3,92
21816,99795294,99795505,False,1,211
21817,99795569,99796093,True,1,524
21818,99826544,99829091,True,1,2547
21819,99826544,99830533,False,1,3989
21820,99826544,99830533,True,2,3989
21821,99827751,99830910,True,1,3159
21822,99849430,99851790,True,3,2360
21823,99849430,99853063,True,1,3633
21824,99851569,99852137,True,1,568
21825,99856163,99859766,True,1,3603
21826,99860557,99860888,True,1,331
21827,99866214,99867619,True,1,1405
21828,99866214,99867623,True,1,1409
21829,99866723,99866924,True,2,201
21830,99867392,99867523,True,1,131
21831,99871063,99871368,True,2,305
21832,99872969,99873668,True,1,699
21833,99873134,99876249,True,1,3115
21834,99873640,99873730,True,1,90
21835,99892888,99892985,True,2,97
21836,99894624,99896958,True,1,2334
21837,99899229,99899355,True,1,126
21838,99900621,99916869,True,1,16248
21839,99902131,99902222,True,1,91
21840,99904597,99904709,True,4,112
21841,99905259,99906385,True,1,1126
21842,99911168,99912363,True,4,1195
21843,99913150,99918213,True,2,5063
21844,99913150,99919397,True,1,6247
21845,99913150,99920549,True,1,7399
21846,99923635,99924649,True,2,1014
21847,99925791,99926674,True,2,883
21848,99933822,99952238,True,1,18416
21849,99939016,99996955,True,1,57939
21850,99953549,99958892,True,1,5343
21851,99953834,99966442,True,1,12608
21852,99954241,99999959,True,2,45718
21853,99955003,99955323,True,4,320
21854,99955134,99977483,False,4,22349
21855,99955134,99977483,True,5,22349
21856,99955746,99956746,True,1,1000
21857,99955746,99956763,True,1,1017
21858,99962822,99963522,True,1,700
21859,99969940,99970243,True,3,303
21860,99973393,99976147,True,1,2754
21861,99981711,99983915,True,3,2204
21862,99999349,100000070,True,1,721
21863,100011481,100018671,True,4,7190
21864,100011481,100052095,True,4,40614
21865,100021613,100022111,True,1,498
21866,100022801,100027535,True,1,4734
21867,100027597,100031382,True,1,3785
21868,100031542,100032177,True,1,635
21869,100033165,100033572,True,1,407
21870,100033373,100033780,True,1,407
21871,100034194,100044213,True,1,10019
21872,100034572,100041522,True,1,6950
21873,100035210,100045229,True,1,10019
21874,100035355,100042584,True,1,7229
21875,100037421,100044115,True,2,6694
21876,100037421,100052669,True,1,15248
21877,100048735,100049509,True,1,774
21878,100051733,100059929,True,1,8196
21879,100055157,100055666,True,3,509
21880,100057142,100057577,True,1,435
21881,100062189,100062596,True,1,407
21882,100066075,100284379,True,1,218304
21883,100071409,100072143,True,1,734
21884,100071409,100072390,True,3,981
21885,100084095,100092609,True,1,8514
21886,100087960,100096055,True,1,8095
21887,100100682,100102955,True,1,2273
21888,100117803,100118296,True,2,493
21889,100118439,100118748,True,1,309
21890,100118439,100119493,False,1,1054
21891,100118439,100119493,True,1,1054
21892,100120381,100120476,False,1,95
21893,100131335,100133672,True,1,2337
21894,100131335,100134500,False,1,3165
21895,100131335,100134500,True,2,3165
21896,100140031,100150569,True,3,10538
21897,100141145,100141717,False,1,572
21898,100141145,100141717,True,1,572
21899,100169324,100171048,True,2,1724
21900,100170043,100174354,True,1,4311
21901,100171263,100172683,True,1,1420
21902,100184657,100186619,True,1,1962
21903,100184657,100191894,True,1,7237
21904,100189908,100191493,True,1,1585
21905,100200060,100200156,True,1,96
21906,100200060,100202569,True,2,2509
21907,100214479,100221091,True,1,6612
21908,100220657,100224278,True,3,3621
21909,100223896,100225301,True,1,1405
21910,100234057,100234883,True,1,826
21911,100235831,100238963,True,1,3132
21912,100236996,100238558,True,1,1562
21913,100243573,100264513,True,1,20940
21914,100252802,100254153,True,4,1351
21915,100270686,100281537,True,2,10851
21916,100271654,100281836,True,1,10182
21917,100271915,100279589,True,1,7674
21918,100271983,100281838,True,1,9855
21919,100277468,100277540,True,1,72
21920,100290880,100293657,True,1,2777
21921,100295031,100316482,True,6,21451
21922,100295031,100316491,True,2,21460
21923,100296184,100297861,True,2,1677
21924,100301151,100301555,True,1,404
21925,100303106,100304874,False,1,1768
21926,100303106,100304874,True,4,1768
21927,100309135,100313410,False,1,4275
21928,100319830,100326588,True,1,6758
21929,100319830,100335697,True,2,15867
21930,100325915,100326793,True,10,878
21931,100330433,100330528,True,1,95
21932,100331555,100332124,True,1,569
21933,100335000,100336173,False,2,1173
21934,100335000,100336173,True,4,1173
21935,100337722,100338338,False,3,616
21936,100337722,100338338,True,9,616
21937,100360981,100363535,True,2,2554
21938,100360981,100364150,True,2,3169
21939,100366906,100367138,False,1,232
21940,100370762,100371155,True,2,393
21941,100371299,100371387,True,1,88
21942,100373771,100374484,True,2,713
21943,100375827,100432889,False,1,57062
21944,100376800,100377351,True,1,551
21945,100382318,100382526,False,1,208
21946,100385109,100385302,True,1,193
21947,100385844,100389853,True,1,4009
21948,100388961,100389280,True,1,319
21949,100388961,100389440,True,4,479
21950,100388961,100389858,True,1,897
21951,100389921,100390388,True,1,467
21952,100393172,100393457,True,1,285
21953,100405185,100406998,True,1,1813
21954,100418526,100418651,True,1,125
21955,100431199,100434667,True,3,3468
21956,100444852,100445041,False,2,189
21957,100444856,100445041,False,1,185
21958,100450152,100477358,True,1,27206
21959,100458306,100459606,True,2,1300
21960,100462623,100466460,True,1,3837
21961,100470125,100473096,True,1,2971
21962,100470153,100470809,True,1,656
21963,100470153,100472000,False,1,1847
21964,100470153,100472000,True,1,1847
21965,100478316,100483116,False,1,4800
21966,100485472,100494271,True,2,8799
21967,100486199,100486324,True,1,125
21968,100495133,100524476,True,1,29343
21969,100501962,100502172,True,4,210
21970,100503364,100503450,True,1,86
21971,100504284,100504900,True,1,616
21972,100525114,100541845,True,2,16731
21973,100525170,100528699,True,1,3529
21974,100528348,100552773,True,1,24425
21975,100528348,100553253,True,1,24905
21976,100534926,100556026,False,1,21100
21977,100540636,100555191,False,1,14555
21978,100540636,100555191,True,2,14555
21979,100547531,100563176,True,1,15645
21980,100547531,100563473,True,1,15942
21981,100549476,100549962,True,1,486
21982,100557167,100697199,True,1,140032
21983,100568832,100573855,True,1,5023
21984,100573987,100579396,True,1,5409
21985,100578810,100579294,True,1,484
21986,100594567,100594678,True,1,111
21987,100597701,100598131,False,1,430
21988,100600959,100622282,True,2,21323
21989,100607502,100607619,True,1,117
21990,100609949,100610039,True,1,90
21991,100610240,100611630,False,1,1390
21992,100610240,100611630,True,2,1390
21993,100611601,100621442,False,1,9841
21994,100613085,100613861,True,2,776
21995,100613372,100614148,True,1,776
21996,100616431,100616508,True,1,77
21997,100617542,100617689,True,1,147
21998,100620754,100621792,False,1,1038
21999,100620754,100621792,True,2,1038
22000,100621332,100621551,True,1,219
22001,100621461,100621551,True,1,90
22002,100622121,100625853,True,1,3732
22003,100624828,100625158,True,7,330
22004,100629016,100629178,True,1,162
22005,100633119,100640417,True,1,7298
22006,100643267,100643361,True,3,94
22007,100644083,100646188,True,1,2105
22008,100650864,100651000,True,2,136
22009,100660204,100673582,False,1,13378
22010,100661204,100661319,True,3,115
22011,100661204,100662396,True,2,1192
22012,100666247,100666385,True,1,138
22013,100668790,100670082,True,1,1292
22014,100668790,100670474,True,1,1684
22015,100668935,100670474,True,1,1539
22016,100669786,100673338,False,1,3552
22017,100674606,100675906,True,1,1300
22018,100675550,100675736,True,6,186
22019,100675550,100676805,True,1,1255
22020,100675831,100676809,True,1,978
22021,100679597,100681050,True,1,1453
22022,100685235,100689473,False,1,4238
22023,100688895,100703019,True,14,14124
22024,100689496,100692459,True,1,2963
22025,100691294,100694835,False,1,3541
22026,100696818,100706958,True,2,10140
22027,100706105,100706724,True,2,619
22028,100708203,100711652,False,1,3449
22029,100708203,100711652,True,2,3449
22030,100708822,100708913,True,1,91
22031,100709171,100712076,False,2,2905
22032,100709171,100712076,True,1,2905
22033,100711190,100711605,True,3,415
22034,100711441,100712551,True,1,1110
22035,100712495,100713017,True,1,522
22036,100712807,100712880,True,1,73
22037,100719610,100719707,True,1,97
22038,100722138,100722803,False,1,665
22039,100722138,100725132,True,1,2994
22040,100725957,100726126,True,1,169
22041,100725957,100726154,True,1,197
22042,100727844,100733532,False,1,5688
22043,100727844,100733532,True,1,5688
22044,100728539,100733877,True,1,5338
22045,100729081,100729163,True,4,82
22046,100733621,100734368,True,1,747
22047,100734573,100811449,True,1,76876
22048,100734586,100834847,True,1,100261
22049,100735374,100735979,False,1,605
22050,100735374,100735979,True,6,605
22051,100736676,100737054,False,3,378
22052,100738060,100741641,True,1,3581
22053,100745606,100747091,True,5,1485
22054,100749003,100749334,True,1,331
22055,100750625,100751671,False,1,1046
22056,100754845,100757349,True,1,2504
22057,100757452,100757539,True,2,87
22058,100761185,100761284,True,1,99
22059,100761682,100762079,False,1,397
22060,100761682,100762079,True,1,397
22061,100761682,100762434,True,1,752
22062,100762890,100763145,True,1,255
22063,100765251,100766024,True,1,773
22064,100767070,100767409,True,4,339
22065,100770022,100770106,True,2,84
22066,100776711,100777068,True,1,357
22067,100776711,100777134,True,1,423
22068,100784495,100784864,True,5,369
22069,100785157,100787821,True,1,2664
22070,100801805,100805980,True,3,4175
22071,100802467,100802547,True,2,80
22072,100820864,100823124,False,1,2260
22073,100823224,100841032,True,2,17808
22074,100823224,100842664,True,1,19440
22075,100823224,100842688,True,1,19464
22076,100823224,100842755,True,1,19531
22077,100823363,100823590,True,1,227
22078,100825371,100843179,True,1,17808
22079,100852701,100860948,False,1,8247
22080,100864221,100864456,True,1,235
22081,100865056,100866386,True,1,1330
22082,100868230,100868362,True,1,132
22083,100897451,100907401,True,1,9950
22084,100903118,100903951,True,3,833
22085,100905437,100906066,True,1,629
22086,100905742,100907395,True,2,1653
22087,100907278,100924290,True,1,17012
22088,100922401,100952540,True,1,30139
22089,100935394,100938361,True,1,2967
22090,100945909,100945978,False,1,69
22091,100947443,100947955,False,1,512
22092,100948167,100951352,False,1,3185
22093,100949199,100949480,True,1,281
22094,100949494,100964087,True,2,14593
22095,100958311,100958924,True,4,613
22096,100959764,100962061,True,3,2297
22097,100964324,100966035,True,3,1711
22098,100966498,100972892,True,1,6394
22099,100970406,100976588,True,1,6182
22100,100976137,100982453,False,1,6316
22101,100976137,100982453,True,2,6316
22102,100982724,100983869,True,2,1145
22103,100985923,100989010,True,1,3087
22104,100990956,100997293,True,1,6337
22105,100995475,100995956,True,3,481
22106,100997905,101000280,True,6,2375
22107,101010285,101010418,False,1,133
22108,101011847,101018037,True,1,6190
22109,101011847,101019580,True,1,7733
22110,101012043,101019580,True,1,7537
22111,101014464,101031374,True,1,16910
22112,101026545,101026659,True,1,114
22113,101026826,101027708,True,4,882
22114,101027539,101124312,True,1,96773
22115,101048057,101050323,False,1,2266
22116,101048057,101051761,True,1,3704
22117,101048057,101051907,True,2,3850
22118,101052674,101057042,True,6,4368
22119,101056813,101057841,True,1,1028
22120,101057048,101058862,True,2,1814
22121,101057625,101059112,True,2,1487
22122,101058590,101063358,True,1,4768
22123,101058590,101063480,True,1,4890
22124,101058590,101071627,True,1,13037
22125,101069348,101069483,True,3,135
22126,101090979,101091441,True,1,462
22127,101092392,101092647,True,1,255
22128,101101095,101102214,True,1,1119
22129,101104253,101104844,True,1,591
22130,101105860,101106350,False,1,490
22131,101108387,101118991,False,1,10604
22132,101114577,101119407,False,2,4830
22133,101121047,101123390,True,1,2343
22134,101139253,101180208,True,1,40955
22135,101140369,101147651,True,3,7282
22136,101141414,101145247,False,2,3833
22137,101141414,101145247,True,5,3833
22138,101142409,101142943,True,1,534
22139,101142494,101142943,True,2,449
22140,101143041,101157211,True,1,14170
22141,101144028,101182590,True,1,38562
22142,101148586,101168682,True,2,20096
22143,101149463,101185220,True,2,35757
22144,101151114,101186105,True,2,34991
22145,101151780,101154680,False,1,2900
22146,101151780,101154680,True,1,2900
22147,101151780,101155435,False,1,3655
22148,101151780,101156350,True,1,4570
22149,101156456,101159754,True,4,3298
22150,101164729,101164866,True,1,137
22151,101169416,101170836,True,3,1420
22152,101171061,101173525,True,1,2464
22153,101175960,101179289,True,1,3329
22154,101179596,101182346,True,1,2750
22155,101179596,101183737,True,1,4141
22156,101192623,101193801,True,5,1178
22157,101192623,101200347,True,1,7724
22158,101199036,101206266,False,1,7230
22159,101210831,101211987,False,1,1156
22160,101213286,101214942,True,1,1656
22161,101213913,101215268,True,1,1355
22162,101218544,101223018,True,1,4474
22163,101218544,101224525,True,2,5981
22164,101236951,101237287,False,1,336
22165,101236951,101237299,False,1,348
22166,101236951,101241765,False,3,4814
22167,101246448,101247890,True,1,1442
22168,101247122,101265555,False,1,18433
22169,101248763,101255812,True,1,7049
22170,101248789,101255813,True,1,7024
22171,101279426,101284151,True,1,4725
22172,101289457,101289686,True,2,229
22173,101289694,101291660,True,1,1966
22174,101293957,101295420,True,1,1463
22175,101295405,101295958,False,1,553
22176,101298852,101299569,True,1,717
22177,101302014,101305045,True,1,3031
22178,101307845,101312489,True,1,4644
22179,101309218,101309504,True,1,286
22180,101309233,101309504,True,1,271
22181,101310146,101332726,True,1,22580
22182,101311712,101313659,True,1,1947
22183,101312373,101312462,False,1,89
22184,101312373,101312462,True,3,89
22185,101313106,101313689,False,8,583
22186,101313106,101335251,False,1,22145
22187,101313106,101620745,False,1,307639
22188,101313106,101645636,False,1,332530
22189,101318554,101320891,True,7,2337
22190,101320006,101320158,True,1,152
22191,101324100,101324174,True,1,74
22192,101329805,101330942,True,4,1137
22193,101343479,101347376,False,1,3897
22194,101356851,101360201,True,1,3350
22195,101358490,101359330,True,1,840
22196,101363063,101364083,False,1,1020
22197,101363063,101364083,True,1,1020
22198,101367571,101367714,False,1,143
22199,101367571,101367714,True,3,143
22200,101372158,101372236,True,1,78
22201,101380400,101382115,True,3,1715
22202,101386017,101386098,True,1,81
22203,101392151,101392447,True,1,296
22204,101401295,101402286,False,1,991
22205,101402162,101409889,True,1,7727
22206,101402354,101405478,True,2,3124
22207,101403269,101409889,True,1,6620
22208,101405597,101405889,True,1,292
22209,101405836,101407357,False,1,1521
22210,101406679,101406971,False,1,292
22211,101408727,101436358,True,1,27631
22212,101410054,101410131,True,2,77
22213,101413812,101420502,True,3,6690
22214,101414870,101416564,True,1,1694
22215,101423122,101441225,True,1,18103
22216,101425402,101528775,True,1,103373
22217,101425438,101426357,True,1,919
22218,101427644,101427723,True,3,79
22219,101433289,101447782,True,3,14493
22220,101433429,101441111,True,1,7682
22221,101433429,101447782,True,1,14353
22222,101441052,101444366,True,1,3314
22223,101442281,101445448,True,1,3167
22224,101448317,101455227,True,2,6910
22225,101455086,101457762,True,1,2676
22226,101455086,101460910,True,2,5824
22227,101462276,101464446,True,2,2170
22228,101462579,101464749,True,1,2170
22229,101490752,101494964,True,2,4212
22230,101490752,101498302,False,1,7550
22231,101490752,101500999,False,1,10247
22232,101492416,101496600,True,1,4184
22233,101492416,101499938,False,1,7522
22234,101492416,101502635,False,1,10219
22235,101501081,101501161,True,1,80
22236,101507741,101510353,True,1,2612
22237,101520221,101609081,True,1,88860
22238,101520221,101724347,False,2,204126
22239,101537783,101544476,True,3,6693
22240,101551995,101552631,True,5,636
22241,101552155,101552699,True,1,544
22242,101558824,101560353,True,1,1529
22243,101558824,101567245,True,3,8421
22244,101562885,101564631,True,1,1746
22245,101563724,101592192,True,4,28468
22246,101567599,101568999,True,2,1400
22247,101571858,101573424,True,1,1566
22248,101571970,101575178,True,1,3208
22249,101573123,101577556,True,1,4433
22250,101577971,101580711,True,1,2740
22251,101585792,101614750,True,2,28958
22252,101589402,101600777,True,1,11375
22253,101589402,101616134,True,5,26732
22254,101589402,101616137,True,1,26735
22255,101590843,101617843,False,1,27000
22256,101593618,101595697,True,1,2079
22257,101605648,101608373,True,1,2725
22258,101621027,101637861,True,1,16834
22259,101633445,101634486,True,1,1041
22260,101634385,101641686,True,1,7301
22261,101638112,101642242,True,1,4130
22262,101642401,101643501,True,1,1100
22263,101642401,101645699,True,1,3298
22264,101643239,101644245,True,1,1006
22265,101643459,101647171,False,1,3712
22266,101644603,101646149,True,1,1546
22267,101644603,101646628,True,1,2025
22268,101644812,101645798,True,1,986
22269,101644870,101646895,True,1,2025
22270,101649387,101909715,True,1,260328
22271,101649387,102131366,True,1,481979
22272,101663138,101665737,True,1,2599
22273,101666000,101674205,False,1,8205
22274,101674414,101674618,True,1,204
22275,101703356,101711433,True,2,8077
22276,101723770,101723999,True,1,229
22277,101739412,101740293,True,1,881
22278,101750638,101753872,True,1,3234
22279,101759324,101759465,True,2,141
22280,101768628,101769870,True,2,1242
22281,101768774,101848629,False,1,79855
22282,101769099,101769179,True,3,80
22283,101772034,101775047,True,2,3013
22284,101775226,101789682,True,1,14456
22285,101775226,101789685,False,1,14459
22286,101775226,101789685,True,1,14459
22287,101775523,101789501,True,3,13978
22288,101793484,101795538,True,1,2054
22289,101797790,101918524,True,2,120734
22290,101799302,101799537,True,1,235
22291,101804417,101804733,True,1,316
22292,101807617,101866990,False,1,59373
22293,101813521,101813808,True,2,287
22294,101814129,101848068,False,1,33939
22295,101814129,101848068,True,2,33939
22296,101840344,101840416,True,1,72
22297,101840370,101840978,True,1,608
22298,101844436,101845395,True,4,959
22299,101850553,101851024,True,3,471
22300,101872388,101874575,True,1,2187
22301,101883503,101883610,True,2,107
22302,101886083,101886753,True,4,670
22303,101893518,101901518,True,4,8000
22304,101901897,101902911,True,1,1014
22305,101924849,101925865,True,1,1016
22306,101924849,101925895,True,1,1046
22307,101924849,101926424,True,1,1575
22308,101924849,101926669,True,1,1820
22309,101928527,101928608,True,5,81
22310,101928760,101953556,False,1,24796
22311,101928760,101971880,False,1,43120
22312,101931771,101932564,True,1,793
22313,101937826,101937976,True,2,150
22314,101940256,101940855,False,1,599
22315,101940256,101940921,True,2,665
22316,101950863,101950960,False,2,97
22317,101950863,101953926,False,1,3063
22318,101959636,101960840,False,1,1204
22319,101959650,101960919,True,2,1269
22320,101978562,101996771,False,2,18209
22321,101979371,101984264,True,2,4893
22322,101999807,102011871,True,1,12064
22323,101999884,102026642,True,1,26758
22324,102014799,102014883,False,1,84
22325,102014799,102015052,True,6,253
22326,102015139,102015292,True,2,153
22327,102018782,102018886,True,5,104
22328,102029886,102030247,True,2,361
22329,102035070,102035239,True,3,169
22330,102042821,102071946,True,1,29125
22331,102043206,102043479,False,1,273
22332,102053759,102081289,True,3,27530
22333,102053861,102081391,True,1,27530
22334,102053864,102054533,True,9,669
22335,102069141,102083298,True,1,14157
22336,102078442,102079346,True,1,904
22337,102083488,102083614,True,1,126
22338,102087656,102087773,True,1,117
22339,102125073,102125186,True,5,113
22340,102125960,102126677,True,1,717
22341,102130852,102131000,True,1,148
22342,102150301,102150815,True,1,514
22343,102151991,102154769,True,1,2778
22344,102159354,102159969,True,1,615
22345,102169173,102176712,True,6,7539
22346,102170315,102391890,False,1,221575
22347,102202399,102207763,True,1,5364
22348,102212373,102212772,False,1,399
22349,102222321,102263793,True,1,41472
22350,102226201,102226543,True,1,342
22351,102250971,102251175,True,3,204
22352,102264233,102265994,False,1,1761
22353,102266025,102276716,False,1,10691
22354,102272134,102273107,True,1,973
22355,102279607,102291386,True,1,11779
22356,102299620,102302869,True,1,3249
22357,102305469,102312006,True,1,6537
22358,102315878,102331709,True,1,15831
22359,102316599,102327625,True,1,11026
22360,102331022,102334530,True,2,3508
22361,102341344,102342482,True,2,1138
22362,102342485,102343619,True,1,1134
22363,102342485,102356097,True,1,13612
22364,102349788,102350072,False,1,284
22365,102353391,102354348,True,2,957
22366,102376870,102379149,False,1,2279
22367,102376870,102379149,True,1,2279
22368,102376928,102377791,False,1,863
22369,102385329,102388784,True,2,3455
22370,102388419,102390189,False,1,1770
22371,102388419,102390189,True,1,1770
22372,102391267,102417059,False,2,25792
22373,102401993,102405141,False,2,3148
22374,102401993,102405141,True,3,3148
22375,102413221,102413386,False,1,165
22376,102413221,102413386,True,7,165
22377,102440392,102442834,False,1,2442
22378,102444516,102445823,False,1,1307
22379,102444656,102445755,False,1,1099
22380,102444673,102445823,False,2,1150
22381,102451145,102451780,True,5,635
22382,102453533,102453764,True,1,231
22383,102467463,102471663,True,1,4200
22384,102473634,102474323,True,2,689
22385,102474385,102474673,True,1,288
22386,102507875,102515954,False,2,8079
22387,102574134,102704080,True,1,129946
22388,102578064,102578181,False,1,117
22389,102579602,102582743,False,1,3141
22390,102587453,102587520,True,1,67
22391,102603175,102603509,False,1,334
22392,102603175,102603509,True,2,334
22393,102637852,102642228,True,1,4376
22394,102637902,102638107,True,1,205
22395,102641934,102642098,False,1,164
22396,102645008,102645556,False,1,548
22397,102645008,102645556,True,1,548
22398,102657748,102658419,False,1,671
22399,102657748,102658419,True,2,671
22400,102657748,102658557,False,1,809
22401,102657748,102658676,True,2,928
22402,102677873,102683545,True,1,5672
22403,102677873,102684338,False,1,6465
22404,102677873,102684338,True,1,6465
22405,102677873,102686045,True,1,8172
22406,102695656,102702530,True,1,6874
22407,102699438,102735537,True,1,36099
22408,102716427,102717664,True,4,1237
22409,102726587,102734083,True,1,7496
22410,102743040,102743971,True,1,931
22411,102743040,102745762,True,2,2722
22412,102743040,102752831,False,1,9791
22413,102744208,102746921,True,2,2713
22414,102747406,102748985,False,1,1579
22415,102749151,102755646,True,1,6495
22416,102749151,102755728,True,2,6577
22417,102753463,102754663,False,1,1200
22418,102753463,102754663,True,4,1200
22419,102753463,102756414,True,2,2951
22420,102761992,102764350,True,7,2358
22421,102764112,102764664,False,1,552
22422,102765231,102765891,True,1,660
22423,102771291,102776324,False,2,5033
22424,102780786,102788357,True,1,7571
22425,102794701,102814367,True,1,19666
22426,102819949,102821220,False,2,1271
22427,102819949,102821220,True,2,1271
22428,102819949,102821440,True,1,1491
22429,102823330,102823739,True,1,409
22430,102823365,102823447,True,1,82
22431,102845558,102846328,True,1,770
22432,102867852,102869461,True,2,1609
22433,102869178,102869635,True,1,457
22434,102871530,102875847,True,1,4317
22435,102871810,102875204,True,1,3394
22436,102884253,102884914,True,1,661
22437,102884342,102884896,False,2,554
22438,102884342,102884896,True,5,554
22439,102885624,102892787,True,1,7163
22440,102886051,102888083,True,1,2032
22441,102891762,102894011,True,1,2249
22442,102893600,102898452,True,3,4852
22443,102913295,102920257,False,1,6962
22444,102913439,102916441,True,2,3002
22445,102924458,102926884,True,6,2426
22446,102924458,102932309,True,1,7851
22447,102927690,102930183,True,1,2493
22448,102930089,102930724,True,1,635
22449,102951313,102953180,True,1,1867
22450,102960681,102962776,True,4,2095
22451,102964462,102971937,True,1,7475
22452,102968089,102985354,True,2,17265
22453,102976596,102977308,True,2,712
22454,102976599,102977308,True,1,709
22455,102979594,102982328,True,1,2734
22456,102998733,103000268,False,1,1535
22457,102998733,103000268,True,4,1535
22458,102998733,103003615,True,1,4882
22459,103003506,103004768,True,2,1262
22460,103007518,103008031,False,1,513
22461,103009274,103011781,True,1,2507
22462,103012179,103012621,True,2,442
22463,103015913,103018548,False,1,2635
22464,103028297,103033549,True,1,5252
22465,103029267,103034519,True,1,5252
22466,103034207,103034670,True,3,463
22467,103051439,103051832,False,1,393
22468,103051439,103051832,True,4,393
22469,103053913,103054235,True,1,322
22470,103064815,103064943,False,1,128
22471,103064815,103064943,True,2,128
22472,103065060,103066389,True,5,1329
22473,103070111,103145592,False,1,75481
22474,103092367,103183517,True,1,91150
22475,103093876,103156016,True,1,62140
22476,103099139,103105281,True,2,6142
22477,103119494,103121255,False,5,1761
22478,103119494,103121255,True,3,1761
22479,103126252,103126590,True,1,338
22480,103130403,103133399,True,2,2996
22481,103130403,103144233,True,1,13830
22482,103130403,103145661,True,1,15258
22483,103130403,103146375,True,1,15972
22484,103135826,103146039,True,1,10213
22485,103137593,103147033,False,1,9440
22486,103144855,103151489,True,1,6634
22487,103151261,103199976,True,2,48715
22488,103152783,103155410,True,1,2627
22489,103161528,103162002,True,1,474
22490,103162569,103163223,True,1,654
22491,103165093,103166095,True,3,1002
22492,103172464,103194827,True,1,22363
22493,103178817,103458981,True,1,280164
22494,103180706,103181293,True,1,587
22495,103184699,103185416,False,1,717
22496,103184699,103199066,True,3,14367
22497,103203258,103208179,True,1,4921
22498,103247317,103253400,True,1,6083
22499,103247317,103303069,False,1,55752
22500,103256788,103256988,True,2,200
22501,103265211,103266632,True,6,1421
22502,103267956,103303356,True,1,35400
22503,103267956,103309343,True,1,41387
22504,103273548,103274060,True,3,512
22505,103279035,103279665,False,1,630
22506,103279035,103279665,True,2,630
22507,103291616,103293218,True,1,1602
22508,103291616,103293724,True,1,2108
22509,103291616,103296033,False,1,4417
22510,103291616,103301875,True,1,10259
22511,103313392,103313678,False,1,286
22512,103316611,103317603,False,2,992
22513,103326838,103328068,True,1,1230
22514,103328691,103329006,True,1,315
22515,103338948,103339098,True,1,150
22516,103341282,103341343,True,3,61
22517,103350133,103353319,True,4,3186
22518,103359651,103364103,True,1,4452
22519,103404495,103437570,True,1,33075
22520,103410494,103411414,True,1,920
22521,103410494,103411545,True,1,1051
22522,103410494,103413475,True,2,2981
22523,103410494,103423617,True,1,13123
22524,103410636,103413574,True,1,2938
22525,103410852,103413574,True,1,2722
22526,103411330,103424069,True,1,12739
22527,103411361,103424069,True,1,12708
22528,103414047,103417457,True,3,3410
22529,103444604,103445692,True,1,1088
22530,103456745,103456806,True,2,61
22531,103456745,103457391,True,1,646
22532,103458395,103467468,False,1,9073
22533,103458521,103460415,True,1,1894
22534,103460120,103462555,False,1,2435
22535,103481310,103482244,False,1,934
22536,103481310,103482244,True,4,934
22537,103482263,103483942,False,1,1679
22538,103482263,103483942,True,1,1679
22539,103482263,103490156,True,1,7893
22540,103494108,103495420,False,1,1312
22541,103494108,103495420,True,3,1312
22542,103496775,103497143,True,1,368
22543,103506881,103507438,True,6,557
22544,103509130,103521466,False,1,12336
22545,103522117,103528098,True,1,5981
22546,103523051,103528451,True,1,5400
22547,103530990,103531078,True,1,88
22548,103534484,103536165,True,1,1681
22549,103534648,103535270,True,1,622
22550,103546742,103550317,True,1,3575
22551,103562168,103588901,False,1,26733
22552,103570372,103619590,True,4,49218
22553,103571435,103587104,True,1,15669
22554,103590018,103591044,True,1,1026
22555,103591879,103593576,True,2,1697
22556,103592338,103596230,True,1,3892
22557,103593174,103601951,True,3,8777
22558,103593816,103596255,True,1,2439
22559,103594014,103631431,True,1,37417
22560,103600392,103615333,False,1,14941
22561,103604036,103671857,True,1,67821
22562,103610056,103610238,True,1,182
22563,103610056,103610250,True,4,194
22564,103618591,103619317,True,1,726
22565,103625583,103625763,True,1,180
22566,103630281,103640417,True,1,10136
22567,103637412,103653083,False,1,15671
22568,103637412,103653083,True,3,15671
22569,103638098,103653390,True,1,15292
22570,103642452,103646775,True,3,4323
22571,103655451,103655546,True,4,95
22572,103670688,103671837,False,1,1149
22573,103670688,103671837,True,1,1149
22574,103675797,103676318,True,1,521
22575,103684597,103771573,True,1,86976
22576,103697043,103698560,True,2,1517
22577,103702306,103706776,True,1,4470
22578,103703396,103703602,False,2,206
22579,103720010,103727506,True,1,7496
22580,103722228,103723068,True,1,840
22581,103722252,103723059,True,1,807
22582,103740820,103741060,True,1,240
22583,103749962,103750065,True,2,103
22584,103766678,103766919,True,2,241
22585,103768732,103769429,True,1,697
22586,103769527,103771182,True,3,1655
22587,103770383,103772038,True,1,1655
22588,103784305,103785272,True,1,967
22589,103791344,103791516,True,1,172
22590,103791385,103791516,False,1,131
22591,103791773,103793422,True,1,1649
22592,103801760,103801864,False,1,104
22593,103815927,103817278,True,1,1351
22594,103827899,103830238,True,8,2339
22595,103830650,103833553,True,2,2903
22596,103838545,103838934,True,1,389
22597,103842762,103972111,False,1,129349
22598,103855979,103856883,True,2,904
22599,103855979,103856904,True,1,925
22600,103855979,103856934,True,2,955
22601,103858243,103859737,True,1,1494
22602,103875681,103877639,True,4,1958
22603,103886144,103887170,True,1,1026
22604,103894263,103896256,True,2,1993
22605,103908449,103909690,True,1,1241
22606,103909302,103910944,False,1,1642
22607,103910137,103911721,True,1,1584
22608,103911478,103913062,True,1,1584
22609,103911976,103992902,True,1,80926
22610,103935056,103935163,True,1,107
22611,103947583,103948261,True,1,678
22612,103947583,103948823,True,1,1240
22613,103953084,103953723,True,1,639
22614,103953084,103953728,True,1,644
22615,103959690,103961565,True,1,1875
22616,103970162,104041565,True,2,71403
22617,103983834,103984273,True,9,439
22618,103989695,103994744,True,3,5049
22619,104006146,104006482,True,4,336
22620,104007299,104008573,True,1,1274
22621,104018261,104020926,True,3,2665
22622,104026884,104027769,False,1,885
22623,104031106,104032245,True,2,1139
22624,104032491,104033135,False,1,644
22625,104034899,104035360,True,1,461
22626,104034904,104035360,True,5,456
22627,104046292,104053782,True,3,7490
22628,104046292,104054195,True,1,7903
22629,104046292,104055759,True,2,9467
22630,104048929,104049731,True,1,802
22631,104055033,104055616,False,1,583
22632,104055785,104056699,True,1,914
22633,104065878,104066332,True,2,454
22634,104085778,104106644,True,1,20866
22635,104087666,104102325,True,3,14659
22636,104102440,104103583,True,1,1143
22637,104120619,104121162,True,1,543
22638,104132425,104133084,True,2,659
22639,104142196,104157984,False,1,15788
22640,104142196,104171166,False,1,28970
22641,104142196,104174271,True,1,32075
22642,104149258,104150931,True,1,1673
22643,104160392,104161024,True,3,632
22644,104165438,104200206,True,4,34768
22645,104165438,104217649,True,1,52211
22646,104168021,104179490,True,1,11469
22647,104168021,104228970,False,1,60949
22648,104168021,104228970,True,1,60949
22649,104168074,104170890,True,1,2816
22650,104174037,104175511,True,1,1474
22651,104174046,104187109,False,1,13063
22652,104174046,104190214,True,1,16168
22653,104174046,104264786,False,1,90740
22654,104191339,104192235,True,1,896
22655,104203449,104205009,True,2,1560
22656,104207356,104296485,True,1,89129
22657,104219249,104239831,True,2,20582
22658,104219249,104265641,True,1,46392
22659,104224434,104225225,True,1,791
22660,104230430,104244038,True,1,13608
22661,104235454,104235599,False,1,145
22662,104237289,104274982,True,2,37693
22663,104243857,104276830,True,1,32973
22664,104258395,104259682,True,2,1287
22665,104292455,104292593,True,1,138
22666,104317443,104393213,False,1,75770
22667,104317443,104393213,True,2,75770
22668,104329780,104332602,True,1,2822
22669,104334689,104347006,False,1,12317
22670,104336118,104341956,False,1,5838
22671,104362580,104367134,True,1,4554
22672,104368066,104370771,True,1,2705
22673,104369412,104371867,True,1,2455
22674,104386084,104387136,True,1,1052
22675,104391158,104406691,True,1,15533
22676,104391281,104406691,True,1,15410
22677,104391281,104407865,True,1,16584
22678,104394400,104401501,False,2,7101
22679,104399346,104402334,True,1,2988
22680,104412557,104412685,False,1,128
22681,104427883,104437214,True,1,9331
22682,104433719,104435845,True,1,2126
22683,104433719,104435871,True,3,2152
22684,104433719,104436583,True,1,2864
22685,104451747,104452832,True,1,1085
22686,104453972,104494883,True,1,40911
22687,104460678,104469708,True,2,9030
22688,104464369,104464784,True,2,415
22689,104464369,104465322,True,1,953
22690,104464369,104465333,True,1,964
22691,104464718,104465478,False,1,760
22692,104464718,104465478,True,1,760
22693,104477860,104479265,True,2,1405
22694,104478389,104479474,True,1,1085
22695,104499280,104502476,True,1,3196
22696,104499280,104504087,True,1,4807
22697,104509970,104510103,True,4,133
22698,104510548,104513137,True,3,2589
22699,104513423,104514636,True,1,1213
22700,104513423,104518770,True,1,5347
22701,104514582,104514965,True,1,383
22702,104516218,104517476,True,1,1258
22703,104516959,104520557,True,1,3598
22704,104520425,104520636,False,1,211
22705,104525842,104526300,True,1,458
22706,104528935,104531065,True,1,2130
22707,104528935,104536348,True,1,7413
22708,104533384,104538510,True,1,5126
22709,104546730,104547468,False,1,738
22710,104559872,104560517,True,1,645
22711,104560503,104560585,True,1,82
22712,104560515,104560894,True,2,379
22713,104563907,104564142,True,5,235
22714,104564397,104564648,True,1,251
22715,104565157,104565411,True,1,254
22716,104570264,104573735,True,2,3471
22717,104570517,104607731,False,4,37214
22718,104570517,104607731,True,1,37214
22719,104570517,104623095,True,1,52578
22720,104571670,104574287,True,1,2617
22721,104579972,104580987,True,2,1015
22722,104596994,104625400,True,1,28406
22723,104601468,104601970,True,1,502
22724,104602680,104607453,True,1,4773
22725,104612431,104612993,True,1,562
22726,104612431,104614333,True,1,1902
22727,104622983,104649435,True,1,26452
22728,104628047,104654549,False,1,26502
22729,104643727,104646153,False,1,2426
22730,104643727,104646153,True,2,2426
22731,104643727,104646809,False,1,3082
22732,104649054,104649293,True,1,239
22733,104653494,104653625,True,1,131
22734,104654529,104671354,False,1,16825
22735,104654529,104671354,True,1,16825
22736,104654529,104671358,True,1,16829
22737,104654529,104744387,True,1,89858
22738,104684560,104685418,True,1,858
22739,104685557,104688083,True,1,2526
22740,104688684,104761675,True,1,72991
22741,104690543,104690867,True,1,324
22742,104691068,104714497,True,4,23429
22743,104694446,104716210,True,1,21764
22744,104700895,104706757,True,1,5862
22745,104703805,104707548,True,1,3743
22746,104718275,104723210,True,1,4935
22747,104730267,104731586,True,1,1319
22748,104740879,104741167,False,1,288
22749,104751332,104755083,True,2,3751
22750,104751509,104755083,True,2,3574
22751,104759413,104772615,True,1,13202
22752,104760813,104763711,True,1,2898
22753,104768061,104778015,False,1,9954
22754,104777847,104778244,False,1,397
22755,104778731,104783671,True,1,4940
22756,104778731,104800089,True,1,21358
22757,104787637,104792210,True,1,4573
22758,104788391,104790133,True,2,1742
22759,104801777,104803700,True,1,1923
22760,104803991,104806254,True,1,2263
22761,104808621,104808938,True,1,317
22762,104811664,104813754,False,1,2090
22763,104828087,104829790,True,4,1703
22764,104833338,104852207,True,1,18869
22765,104837794,104838152,True,1,358
22766,104861480,104861833,True,1,353
22767,104861480,104863670,True,1,2190
22768,104871456,104871635,False,2,179
22769,104871456,104871635,True,2,179
22770,104872481,104875582,True,1,3101
22771,104875211,104885625,True,1,10414
22772,104883597,104887610,True,1,4013
22773,104884544,104884941,False,1,397
22774,104885190,104886170,False,1,980
22775,104889789,104891351,True,2,1562
22776,104890537,104891463,True,1,926
22777,104890537,104893294,True,2,2757
22778,104900706,104901203,True,1,497
22779,104904902,104932056,False,1,27154
22780,104912645,104914260,True,1,1615
22781,104927612,104927893,True,1,281
22782,104927783,104927893,True,1,110
22783,104937059,104939421,True,1,2362
22784,104937356,104938808,True,1,1452
22785,104943733,104943972,True,2,239
22786,104944820,104945467,False,1,647
22787,104945011,104945697,True,1,686
22788,104945797,104950103,True,2,4306
22789,104947444,104951155,False,1,3711
22790,104960600,104961196,True,1,596
22791,104970428,104970511,True,1,83
22792,104970765,104972086,False,1,1321
22793,104970765,104972086,True,1,1321
22794,104972487,104974964,True,1,2477
22795,104979273,104981380,True,3,2107
22796,104991638,105040503,True,1,48865
22797,104992676,104998096,True,1,5420
22798,104992676,104998183,True,3,5507
22799,104992676,104999650,True,2,6974
22800,104997368,105004975,True,1,7607
22801,104997491,105004975,True,1,7484
22802,104999438,105002368,True,1,2930
22803,104999449,105002360,True,1,2911
22804,105015970,105016532,True,9,562
22805,105023762,105025167,True,2,1405
22806,105024291,105025376,True,1,1085
22807,105032522,105036385,True,1,3863
22808,105037060,105038199,True,1,1139
22809,105037188,105037403,True,1,215
22810,105037188,105037835,True,1,647
22811,105042839,105046146,False,1,3307
22812,105043832,105044561,False,1,729
22813,105043907,105047361,True,2,3454
22814,105043907,105052351,True,1,8444
22815,105056428,105059017,True,3,2589
22816,105058862,105064535,True,2,5673
22817,105059415,105060383,False,2,968
22818,105065126,105077072,True,1,11946
22819,105071926,105077766,True,1,5840
22820,105075369,105080415,True,1,5046
22821,105082216,105084805,False,1,2589
22822,105082216,105084805,True,2,2589
22823,105105623,105106016,True,1,393
22824,105106422,105109483,True,1,3061
22825,105110902,105110986,True,1,84
22826,105117131,105117215,True,5,84
22827,105121613,105130047,True,6,8434
22828,105125808,105128820,True,6,3012
22829,105128085,105128219,True,2,134
22830,105128120,105128219,True,1,99
22831,105138581,105147013,True,1,8432
22832,105138581,105155756,True,1,17175
22833,105140385,105143754,True,2,3369
22834,105141542,105145058,True,1,3516
22835,105161618,105163802,False,2,2184
22836,105161618,105163802,True,8,2184
22837,105172344,105182722,False,1,10378
22838,105173120,105176439,False,1,3319
22839,105173120,105179569,True,1,6449
22840,105173120,105188975,True,1,15855
22841,105177634,105184520,True,1,6886
22842,105192619,105192844,True,1,225
22843,105199327,105199660,True,1,333
22844,105203335,105205329,True,1,1994
22845,105205524,105205797,True,3,273
22846,105209517,105210539,False,1,1022
22847,105215840,105289804,True,3,73964
22848,105230381,105231257,True,1,876
22849,105237929,105243263,False,1,5334
22850,105237929,105244826,True,1,6897
22851,105240192,105240855,True,1,663
22852,105241144,105241807,True,1,663
22853,105245245,105251207,False,1,5962
22854,105254357,105255890,True,1,1533
22855,105260087,105262397,True,3,2310
22856,105278644,105284977,True,1,6333
22857,105286295,105338778,True,1,52483
22858,105287072,105292466,True,1,5394
22859,105288752,105290136,True,1,1384
22860,105289921,105331380,True,1,41459
22861,105304232,105306010,False,2,1778
22862,105312955,105313829,True,1,874
22863,105314367,105315503,True,1,1136
22864,105318548,105321591,True,1,3043
22865,105318917,105321840,True,2,2923
22866,105336964,105338061,True,1,1097
22867,105346830,105347597,True,1,767
22868,105359973,105360269,True,2,296
22869,105386481,105398249,True,2,11768
22870,105386850,105398498,True,1,11648
22871,105391717,105392530,True,1,813
22872,105393308,105394195,True,1,887
22873,105409292,105409540,True,1,248
22874,105414140,105414601,False,1,461
22875,105414140,105414601,True,3,461
22876,105416686,105417178,True,1,492
22877,105418708,105423644,True,1,4936
22878,105418708,105438876,False,2,20168
22879,105418708,105438876,True,2,20168
22880,105419652,105439345,True,1,19693
22881,105440006,105440718,True,1,712
22882,105440056,105440718,False,1,662
22883,105440056,105440718,True,1,662
22884,105440153,105440718,True,1,565
22885,105452513,105452977,True,2,464
22886,105457554,105457707,True,5,153
22887,105463417,105474141,True,4,10724
22888,105468972,105471978,False,1,3006
22889,105469808,105475877,True,1,6069
22890,105480154,105480514,True,1,360
22891,105485283,105485964,False,5,681
22892,105490680,105516395,True,2,25715
22893,105492319,105504289,True,1,11970
22894,105502314,105663832,True,2,161518
22895,105508619,105509038,True,1,419
22896,105523164,105524059,True,2,895
22897,105541287,105543693,True,3,2406
22898,105543248,105544956,True,1,1708
22899,105543759,105545253,True,1,1494
22900,105545707,105558185,True,2,12478
22901,105549018,105557317,False,1,8299
22902,105552969,105554971,True,2,2002
22903,105555480,105558119,True,1,2639
22904,105560702,105562043,True,2,1341
22905,105563124,105574952,True,1,11828
22906,105576713,105577275,True,1,562
22907,105590251,105590855,False,1,604
22908,105600901,105604070,True,4,3169
22909,105609073,105609177,False,1,104
22910,105623349,105623612,False,1,263
22911,105623349,105623612,True,1,263
22912,105624614,105671202,True,1,46588
22913,105625190,105625464,True,1,274
22914,105627941,105628224,True,1,283
22915,105628045,105628219,True,1,174
22916,105634584,105635539,True,1,955
22917,105635583,105636542,True,1,959
22918,105636392,105638452,True,1,2060
22919,105637098,105637391,True,1,293
22920,105637098,105637476,True,1,378
22921,105649164,105655389,True,1,6225
22922,105650856,105651497,True,1,641
22923,105657695,105658400,True,2,705
22924,105668894,105747155,True,2,78261
22925,105677547,105678980,True,3,1433
22926,105679256,105690455,True,3,11199
22927,105681643,105681755,True,1,112
22928,105682511,105682808,True,1,297
22929,105683732,105688726,True,2,4994
22930,105686135,105690115,True,2,3980
22931,105694511,105694994,True,5,483
22932,105697480,105699639,True,1,2159
22933,105713054,105755744,True,1,42690
22934,105722196,105723777,True,1,1581
22935,105725380,105725492,True,1,112
22936,105728561,105729297,True,1,736
22937,105728561,105731003,False,1,2442
22938,105734576,105734761,True,3,185
22939,105736198,105737208,True,2,1010
22940,105740769,105741568,True,2,799
22941,105742772,105742789,True,1,17
22942,105746399,105749531,True,3,3132
22943,105748021,105750457,False,1,2436
22944,105748021,105750457,True,3,2436
22945,105754082,105756287,True,1,2205
22946,105761393,105763471,True,1,2078
22947,105762696,105762808,True,1,112
22948,105777186,105780992,True,2,3806
22949,105778621,105779966,True,2,1345
22950,105783226,105785359,True,2,2133
22951,105784822,105785011,True,18,189
22952,105796582,105797146,False,1,564
22953,105796582,105797195,False,1,613
22954,105796612,105803227,False,1,6615
22955,105796612,105803227,True,2,6615
22956,105802277,105802738,True,2,461
22957,105807898,105815348,True,1,7450
22958,105817382,105817938,True,1,556
22959,105820552,105820800,True,1,248
22960,105824050,105824196,True,1,146
22961,105832245,105832814,True,1,569
22962,105835549,105844175,False,1,8626
22963,105835549,105844175,True,3,8626
22964,105852756,105854404,True,1,1648
22965,105854177,105854917,False,1,740
22966,105856651,105857679,True,1,1028
22967,105857314,105858605,True,1,1291
22968,105859801,105865648,True,1,5847
22969,105860846,105866109,True,2,5263
22970,105864936,105867098,True,1,2162
22971,105869027,105874681,True,1,5654
22972,105869402,105871866,True,3,2464
22973,105871711,105874047,True,2,2336
22974,105876219,105877039,True,1,820
22975,105876874,105877709,True,1,835
22976,105876874,105878665,True,1,1791
22977,105885832,105889629,True,1,3797
22978,105886933,105890472,False,1,3539
22979,105904226,105911463,True,2,7237
22980,105904226,105922667,True,1,18441
22981,105913688,105916756,True,1,3068
22982,105913688,105916947,True,2,3259
22983,105913835,105916793,True,1,2958
22984,105913835,105916984,True,1,3149
22985,105920554,105921043,True,1,489
22986,105954376,105960813,False,1,6437
22987,105954376,105960813,True,7,6437
22988,105954376,105961932,True,4,7556
22989,105956335,105959118,True,5,2783
22990,105956335,105959123,True,1,2788
22991,105956335,105960899,True,1,4564
22992,105956335,105968076,True,1,11741
22993,105958991,105959117,True,1,126
22994,105959328,105960100,True,2,772
22995,105959702,105960474,True,1,772
22996,105962191,105971698,True,1,9507
22997,105976794,105976886,True,2,92
22998,105982342,105983106,False,1,764
22999,105985503,105987358,True,1,1855
23000,105993305,105995256,True,1,1951
23001,106003589,106004382,True,1,793
23002,106036338,106088787,True,1,52449
23003,106040174,106084853,True,2,44679
23004,106049289,106052224,True,5,2935
23005,106058731,106067736,False,3,9005
23006,106059255,106060150,True,3,895
23007,106060420,106060762,True,1,342
23008,106061872,106067067,True,1,5195
23009,106061872,106077425,False,1,15553
23010,106077559,106077658,True,1,99
23011,106078755,106079144,True,1,389
23012,106081055,106082319,True,1,1264
23013,106092301,106109098,True,3,16797
23014,106099203,106121950,False,1,22747
23015,106099203,106130134,True,1,30931
23016,106124828,106133747,True,1,8919
23017,106126605,106127369,False,1,764
23018,106136261,106140396,True,1,4135
23019,106137743,106137763,True,1,20
23020,106137920,106138011,True,1,91
23021,106147108,106149013,True,1,1905
23022,106147108,106150853,True,1,3745
23023,106148055,106149407,True,1,1352
23024,106157171,106184210,True,1,27039
23025,106168633,106169130,True,2,497
23026,106177933,106278780,True,1,100847
23027,106184816,106263735,True,1,78919
23028,106185557,106206565,False,1,21008
23029,106198412,106204710,False,1,6298
23030,106198412,106207598,False,1,9186
23031,106198412,106207598,True,1,9186
23032,106200759,106201402,False,1,643
23033,106218952,106221474,True,1,2522
23034,106224028,106225266,True,2,1238
23035,106227761,106227847,True,1,86
23036,106232546,106232629,True,4,83
23037,106233667,106235586,True,5,1919
23038,106233667,106237804,True,4,4137
23039,106233667,106253934,True,3,20267
23040,106233667,106274429,True,1,40762
23041,106248586,106248883,True,1,297
23042,106266251,106322907,True,1,56656
23043,106266263,106267584,True,4,1321
23044,106305853,106310410,True,1,4557
23045,106318176,106319325,True,1,1149
23046,106320944,106373394,False,1,52450
23047,106324832,106325269,True,1,437
23048,106347917,106348920,True,2,1003
23049,106347917,106349094,True,1,1177
23050,106363156,106589643,False,1,226487
23051,106363156,106589643,True,1,226487
23052,106367610,106368088,True,1,478
23053,106378809,106378898,False,1,89
23054,106381290,106433229,True,2,51939
23055,106383421,106387726,False,1,4305
23056,106383421,106387726,True,2,4305
23057,106383421,106393175,True,1,9754
23058,106384485,106414258,False,1,29773
23059,106384485,106414258,True,2,29773
23060,106390666,106394340,True,1,3674
23061,106390666,106407640,True,1,16974
23062,106393810,106394057,True,1,247
23063,106394131,106408450,True,1,14319
23064,106401360,106401467,True,1,107
23065,106416182,106416708,True,1,526
23066,106416182,106416785,True,1,603
23067,106416182,106423331,True,3,7149
23068,106416182,106425148,True,2,8966
23069,106424972,106426010,True,1,1038
23070,106431091,106431357,True,2,266
23071,106435064,106436355,True,1,1291
23072,106442521,106443180,True,1,659
23073,106443016,106443119,True,2,103
23074,106443916,106445571,False,1,1655
23075,106453923,106454009,True,3,86
23076,106465901,106465980,True,1,79
23077,106484144,106485277,True,1,1133
23078,106487086,106489305,True,1,2219
23079,106505093,106506784,True,1,1691
23080,106505093,106515845,True,1,10752
23081,106518347,106518487,True,1,140
23082,106519599,106520422,True,5,823
23083,106524861,106529894,True,1,5033
23084,106526423,106527020,True,1,597
23085,106526423,106527559,True,1,1136
23086,106538266,106541301,True,2,3035
23087,106539772,106550824,True,1,11052
23088,106544752,106549004,True,1,4252
23089,106555341,106560068,True,1,4727
23090,106555344,106560068,True,2,4724
23091,106559816,106563170,True,1,3354
23092,106582372,106583213,True,4,841
23093,106591751,106604249,True,1,12498
23094,106591751,106606181,False,1,14430
23095,106602607,106603042,True,1,435
23096,106605615,106609056,True,1,3441
23097,106605615,106611918,True,1,6303
23098,106605615,106621855,True,1,16240
23099,106616827,106628317,True,2,11490
23100,106636736,106638146,False,1,1410
23101,106639122,106639525,True,1,403
23102,106649256,106650277,True,3,1021
23103,106649711,106650922,True,1,1211
23104,106652637,106653262,True,1,625
23105,106685280,106687430,True,1,2150
23106,106685376,106685609,True,2,233
23107,106686216,106686952,True,1,736
23108,106686417,106688280,True,1,1863
23109,106687188,106690214,True,3,3026
23110,106687188,106694122,True,2,6934
23111,106690422,106737561,True,1,47139
23112,106690422,106737566,True,1,47144
23113,106723850,106724688,True,5,838
23114,106725904,106726980,True,3,1076
23115,106734530,106744361,True,1,9831
23116,106742988,106744243,True,3,1255
23117,106756925,106757025,True,1,100
23118,106764660,106766315,True,1,1655
23119,106764660,106770802,True,2,6142
23120,106786037,106800366,True,5,14329
23121,106786037,106806579,True,1,20542
23122,106800341,106802440,False,1,2099
23123,106800341,106810316,True,3,9975
23124,106807480,106807903,True,1,423
23125,106808176,106808608,True,2,432
23126,106837176,106837666,True,2,490
23127,106855304,106855632,False,3,328
23128,106863054,106876179,True,1,13125
23129,106863054,106886389,True,2,23335
23130,106863811,106863905,True,1,94
23131,106876409,106876715,True,1,306
23132,106881656,106886446,True,1,4790
23133,106885764,106888369,True,2,2605
23134,106887878,106889471,True,2,1593
23135,106891218,106892141,False,1,923
23136,106893756,106897585,True,1,3829
23137,106893756,106898985,True,1,5229
23138,106899757,106900065,True,3,308
23139,106904328,106904453,True,1,125
23140,106904698,106904773,False,1,75
23141,106906872,106907017,True,1,145
23142,106907468,106908633,True,3,1165
23143,106916747,106916949,True,1,202
23144,106916747,106916976,True,1,229
23145,106917849,106918195,True,1,346
23146,106920832,106921786,True,1,954
23147,106921033,106921859,True,1,826
23148,106921033,106921918,True,3,885
23149,106937058,106941276,True,1,4218
23150,106939216,106942486,True,1,3270
23151,106941868,106948801,True,1,6933
23152,106945598,106955646,False,1,10048
23153,106959533,106960644,True,1,1111
23154,106961276,106974200,True,2,12924
23155,106961276,106974209,True,1,12933
23156,106968172,106969588,True,1,1416
23157,106983270,106985929,True,1,2659
23158,106994716,106995206,False,1,490
23159,106994716,106995206,True,1,490
23160,107017124,107022017,True,1,4893
23161,107017124,107024611,True,3,7487
23162,107021754,107023362,True,1,1608
23163,107029826,107031595,True,1,1769
23164,107040576,107041605,True,1,1029
23165,107051622,107051794,True,2,172
23166,107051670,107051839,True,1,169
23167,107055703,107056763,True,1,1060
23168,107055703,107060205,True,1,4502
23169,107055703,107063194,True,2,7491
23170,107057776,107057863,True,1,87
23171,107058335,107060252,True,3,1917
23172,107071436,107072292,True,2,856
23173,107096201,107100108,True,1,3907
23174,107103680,107104878,False,1,1198
23175,107103914,107104851,True,7,937
23176,107106753,107107401,True,3,648
23177,107106753,107111078,False,1,4325
23178,107106768,107107397,True,1,629
23179,107119428,107120022,True,2,594
23180,107129173,107129812,True,1,639
23181,107130885,107131241,True,1,356
23182,107143381,107147257,True,3,3876
23183,107147905,107154027,True,1,6122
23184,107149155,107149993,True,1,838
23185,107152907,107153536,True,1,629
23186,107157314,107157609,False,1,295
23187,107162151,107164313,False,1,2162
23188,107170526,107170747,False,1,221
23189,107170526,107170747,True,2,221
23190,107181562,107181647,True,1,85
23191,107206050,107211356,True,2,5306
23192,107209996,107211216,True,6,1220
23193,107214504,107214861,True,1,357
23194,107221793,107226558,True,1,4765
23195,107221793,107226778,True,1,4985
23196,107224292,107229592,True,3,5300
23197,107224292,107230086,True,2,5794
23198,107224292,107230695,True,3,6403
23199,107224292,107237044,True,1,12752
23200,107269917,107273208,True,4,3291
23201,107278832,107284183,True,1,5351
23202,107287765,107293888,True,3,6123
23203,107291188,107291969,True,1,781
23204,107291927,107292475,True,1,548
23205,107312368,107313290,False,1,922
23206,107319746,107366439,True,1,46693
23207,107324243,107324619,True,2,376
23208,107324867,107328489,True,1,3622
23209,107336151,107345247,True,1,9096
23210,107347138,107348777,True,1,1639
23211,107360179,107361432,True,1,1253
23212,107378657,107378855,False,2,198
23213,107378657,107378855,True,1,198
23214,107378657,107380866,True,1,2209
23215,107385379,107387105,True,2,1726
23216,107387206,107387401,True,3,195
23217,107387807,107390577,True,1,2770
23218,107400927,107407413,True,1,6486
23219,107402736,107402866,True,2,130
23220,107409298,107411798,False,1,2500
23221,107410916,107412201,True,1,1285
23222,107420768,107423090,True,2,2322
23223,107420768,107424400,True,3,3632
23224,107432895,107437148,True,1,4253
23225,107443563,107449767,True,2,6204
23226,107443563,107450287,True,1,6724
23227,107448342,107482819,False,1,34477
23228,107457310,107457927,True,1,617
23229,107458466,107459157,True,1,691
23230,107476015,107581924,True,2,105909
23231,107479378,107491062,True,2,11684
23232,107480447,107485632,True,2,5185
23233,107490775,107492187,False,1,1412
23234,107501767,107503020,False,2,1253
23235,107530276,107531144,True,1,868
23236,107548060,107549419,True,2,1359
23237,107548895,107549868,True,1,973
23238,107571121,107571602,True,1,481
23239,107587951,107590742,False,1,2791
23240,107589918,107642397,False,1,52479
23241,107595483,107596965,True,2,1482
23242,107613309,107620865,True,1,7556
23243,107615888,107621350,False,2,5462
23244,107615888,107621350,True,3,5462
23245,107623747,107626265,True,1,2518
23246,107623747,107626268,False,1,2521
23247,107628995,107652599,True,1,23604
23248,107629144,107652595,True,1,23451
23249,107635405,107635708,True,3,303
23250,107637813,107638102,True,1,289
23251,107656944,107673033,True,1,16089
23252,107657303,107673159,False,1,15856
23253,107657303,107673159,True,1,15856
23254,107660575,107664422,False,1,3847
23255,107671008,107671909,True,3,901
23256,107671128,107672021,True,1,893
23257,107674046,107681076,True,1,7030
23258,107674046,107681487,True,1,7441
23259,107692045,107694393,True,7,2348
23260,107702545,107703286,True,1,741
23261,107706242,107706637,False,1,395
23262,107712615,107715978,True,1,3363
23263,107712615,107717267,True,1,4652
23264,107712627,107714818,True,1,2191
23265,107727544,107729393,False,1,1849
23266,107737979,107744433,False,1,6454
23267,107737979,107744433,True,1,6454
23268,107737979,107744560,True,1,6581
23269,107749339,107749998,True,2,659
23270,107761251,107763265,True,1,2014
23271,107767602,107869956,True,2,102354
23272,107789489,107790506,True,1,1017
23273,107789949,107790501,True,3,552
23274,107790868,107791173,True,1,305
23275,107794943,107818135,False,1,23192
23276,107794943,107818135,True,4,23192
23277,107796842,107799590,False,1,2748
23278,107796842,107799590,True,1,2748
23279,107801150,107801276,True,1,126
23280,107803450,107812436,False,1,8986
23281,107803982,107805100,True,3,1118
23282,107808763,107809488,True,1,725
23283,107815602,107815902,False,1,300
23284,107816062,107865389,True,1,49327
23285,107816980,107822900,True,2,5920
23286,107838813,107839076,True,1,263
23287,107841706,107843583,True,1,1877
23288,107850774,107852215,True,1,1441
23289,107870507,107878305,False,1,7798
23290,107870507,107880273,False,1,9766
23291,107870507,107883478,False,1,12971
23292,107870507,107883478,True,1,12971
23293,107873900,107882991,True,2,9091
23294,107883238,107885221,True,1,1983
23295,107896629,107897731,True,1,1102
23296,107896749,107937604,True,1,40855
23297,107906368,107911051,True,1,4683
23298,107927604,107928705,True,2,1101
23299,107928791,107929723,True,2,932
23300,107935917,107986744,False,1,50827
23301,107938882,107939612,True,2,730
23302,107942031,107957990,True,1,15959
23303,107944354,107946696,True,1,2342
23304,107952617,107962487,True,1,9870
23305,107952617,107965513,True,1,12896
23306,107974094,107976887,False,1,2793
23307,107990086,107993970,True,1,3884
23308,108024320,108024853,False,1,533
23309,108028576,108035547,True,3,6971
23310,108049514,108050045,True,2,531
23311,108049514,108066644,True,1,17130
23312,108082882,108083800,True,2,918
23313,108083284,108084007,True,2,723
23314,108084247,108084509,True,1,262
23315,108114280,108116878,False,1,2598
23316,108115845,108116995,True,1,1150
23317,108117395,108117657,True,1,262
23318,108118155,108121873,True,3,3718
23319,108148477,108148721,True,1,244
23320,108162051,108167012,True,1,4961
23321,108183913,108184423,False,1,510
23322,108183913,108184423,True,5,510
23323,108194476,108201419,True,2,6943
23324,108206572,108207401,True,1,829
23325,108210806,108211458,True,1,652
23326,108210806,108211783,True,5,977
23327,108211892,108212385,True,1,493
23328,108215836,108216191,True,1,355
23329,108254171,108255502,True,1,1331
23330,108270697,108273092,True,1,2395
23331,108280664,108285592,True,4,4928
23332,108313554,108314230,True,1,676
23333,108315108,108511954,False,2,196846
23334,108315108,108511954,True,1,196846
23335,108346905,108358577,True,2,11672
23336,108346905,108364800,False,1,17895
23337,108400800,108409152,True,1,8352
23338,108421913,108424980,False,1,3067
23339,108444341,108447677,True,2,3336
23340,108461726,108536111,True,1,74385
23341,108462931,108585864,True,1,122933
23342,108464839,108469133,False,1,4294
23343,108464839,108469133,True,4,4294
23344,108487909,108489057,True,3,1148
23345,108487909,108489209,True,3,1300
23346,108489400,108492412,True,1,3012
23347,108531902,108557933,False,1,26031
23348,108540339,108548274,False,2,7935
23349,108540339,108548274,True,2,7935
23350,108548957,108551517,True,1,2560
23351,108548957,108554737,True,1,5780
23352,108553837,108557162,True,1,3325
23353,108588543,108600940,True,1,12397
23354,108594244,108595965,False,1,1721
23355,108594244,108595965,True,4,1721
23356,108594244,108604054,True,1,9810
23357,108613183,108740313,True,2,127130
23358,108634863,108635367,True,1,504
23359,108635334,108638063,False,2,2729
23360,108635334,108643118,False,1,7784
23361,108635334,108643118,True,1,7784
23362,108637422,108658341,False,1,20919
23363,108637422,108658341,True,2,20919
23364,108640320,108640592,True,1,272
23365,108653645,108654036,False,1,391
23366,108653645,108654036,True,2,391
23367,108659264,108660058,False,1,794
23368,108666001,108671357,True,1,5356
23369,108685302,108704997,True,1,19695
23370,108698036,108698823,True,1,787
23371,108713999,108714104,False,1,105
23372,108713999,108715837,False,2,1838
23373,108719888,108719970,False,1,82
23374,108719888,108719970,True,1,82
23375,108719888,108730197,True,1,10309
23376,108719972,108730198,False,2,10226
23377,108720080,108730197,True,2,10117
23378,108720080,108731626,True,1,11546
23379,108720080,108735462,True,1,15382
23380,108732537,108732825,False,1,288
23381,108734616,108735872,True,1,1256
23382,108739281,108742616,True,1,3335
23383,108742333,108744078,True,1,1745
23384,108742333,108744142,True,1,1809
23385,108745511,108745665,True,1,154
23386,108745872,108749560,True,1,3688
23387,108758739,108761896,True,1,3157
23388,108771384,108771881,True,4,497
23389,108773856,108774325,True,1,469
23390,108774673,108776808,True,1,2135
23391,108776853,108781276,True,1,4423
23392,108779181,108802425,False,1,23244
23393,108788386,108790088,True,1,1702
23394,108797053,108799773,True,1,2720
23395,108806393,108807760,True,1,1367
23396,108818944,108824425,True,2,5481
23397,108818944,108824437,True,1,5493
23398,108821839,108832999,True,1,11160
23399,108821839,108838701,False,1,16862
23400,108821839,108857583,True,1,35744
23401,108824220,108825457,True,1,1237
23402,108824220,108829655,True,1,5435
23403,108832271,108833742,True,2,1471
23404,108834060,108835023,True,4,963
23405,108841486,108842810,True,1,1324
23406,108844898,108845630,True,1,732
23407,108854191,108854891,True,1,700
23408,108857244,108863617,False,1,6373
23409,108863482,108863909,False,1,427
23410,108895805,108896292,True,1,487
23411,108904385,108964423,False,1,60038
23412,108912066,108912151,False,1,85
23413,108912066,108912815,True,1,749
23414,108912207,108912803,True,1,596
23415,108912207,108915864,True,1,3657
23416,108918361,108928824,False,1,10463
23417,108932968,108947687,True,1,14719
23418,108933787,108933973,True,1,186
23419,108933787,108936683,True,1,2896
23420,108944733,108945628,True,1,895
23421,108945846,108946631,False,1,785
23422,108947773,108948923,True,5,1150
23423,108950943,108951332,True,1,389
23424,108988853,108995893,False,1,7040
23425,108992003,108997032,True,2,5029
23426,108992003,109010744,True,1,18741
23427,108995326,108999629,True,4,4303
23428,109032058,109032266,True,1,208
23429,109038704,109039325,False,1,621
23430,109038704,109039325,True,1,621
23431,109040250,109045626,True,1,5376
23432,109053409,109054144,True,1,735
23433,109054668,109055167,False,1,499
23434,109054668,109055167,True,1,499
23435,109088413,109089110,False,4,697
23436,109088413,109089110,True,2,697
23437,109104440,109107746,False,1,3306
23438,109104440,109107746,True,1,3306
23439,109112935,109113893,True,1,958
23440,109113378,109115594,True,1,2216
23441,109113495,109115594,False,1,2099
23442,109113495,109115594,True,1,2099
23443,109116208,109120022,True,2,3814
23444,109116208,109128925,False,1,12717
23445,109116208,109128925,True,1,12717
23446,109146222,109148197,True,1,1975
23447,109146614,109150370,True,1,3756
23448,109150548,109151579,True,3,1031
23449,109150669,109151524,True,4,855
23450,109152983,109157537,True,1,4554
23451,109196554,109197067,True,3,513
23452,109197350,109198079,True,3,729
23453,109207550,109221728,True,1,14178
23454,109207550,109227117,True,1,19567
23455,109210446,109211436,True,1,990
23456,109212355,109212579,False,1,224
23457,109212355,109212579,True,1,224
23458,109220520,109222331,True,2,1811
23459,109220795,109221650,True,1,855
23460,109226689,109231005,True,1,4316
23461,109237966,109240438,True,2,2472
23462,109239473,109239980,True,1,507
23463,109249650,109250203,False,1,553
23464,109256686,109284237,True,6,27551
23465,109260419,109264627,True,3,4208
23466,109278521,109282846,True,4,4325
23467,109283144,109288098,True,3,4954
23468,109287731,109289716,False,1,1985
23469,109291850,109291964,True,1,114
23470,109294880,109295135,False,1,255
23471,109319056,109319877,True,1,821
23472,109327944,109328035,True,3,91
23473,109332101,109336528,True,1,4427
23474,109332101,109341458,True,1,9357
23475,109332984,109333734,False,1,750
23476,109349093,109349655,False,1,562
23477,109349093,109349655,True,3,562
23478,109351303,109351450,True,1,147
23479,109355230,109359585,True,6,4355
23480,109364697,109366527,True,1,1830
23481,109367108,109436960,True,1,69852
23482,109368841,109437904,True,1,69063
23483,109373055,109374807,True,4,1752
23484,109383936,109385029,True,3,1093
23485,109388359,109389347,True,1,988
23486,109388419,109389328,True,1,909
23487,109389469,109389791,True,1,322
23488,109390253,109394356,False,1,4103
23489,109390561,109390673,True,1,112
23490,109397348,109399871,False,1,2523
23491,109409481,109409751,True,2,270
23492,109410158,109410362,True,1,204
23493,109410176,109410380,False,1,204
23494,109410176,109410380,True,1,204
23495,109423192,109446551,True,1,23359
23496,109437838,109453118,True,1,15280
23497,109437838,109453202,True,3,15364
23498,109437838,109454861,True,1,17023
23499,109441254,109441332,False,5,78
23500,109441254,109441332,True,11,78
23501,109441831,109442358,False,1,527
23502,109441831,109442358,True,2,527
23503,109445284,109446532,False,1,1248
23504,109447495,109467245,True,1,19750
23505,109447973,109468046,True,1,20073
23506,109481536,109482827,False,1,1291
23507,109483433,109484243,True,1,810
23508,109485662,109486845,True,1,1183
23509,109492087,109492270,True,1,183
23510,109509065,109510184,True,3,1119
23511,109509300,109510183,True,1,883
23512,109513309,109513556,True,1,247
23513,109513871,109514403,True,1,532
23514,109517497,109517744,False,1,247
23515,109527189,109527327,False,1,138
23516,109527189,109527327,True,5,138
23517,109528991,109556183,True,1,27192
23518,109528991,109616501,True,1,87510
23519,109528991,109623590,True,1,94599
23520,109528991,109631001,True,1,102010
23521,109551870,109552765,True,1,895
23522,109556357,109557477,False,1,1120
23523,109556357,109557477,True,4,1120
23524,109564529,109564778,False,1,249
23525,109571554,109611757,True,1,40203
23526,109579204,109580191,True,1,987
23527,109587085,109619496,False,1,32411
23528,109587085,109645575,True,1,58490
23529,109587085,109652664,True,1,65579
23530,109597164,109597434,False,1,270
23531,109598107,109598395,False,1,288
23532,109599958,109601779,True,2,1821
23533,109637186,109637333,True,2,147
23534,109637934,109641583,True,2,3649
23535,109640052,109643409,True,2,3357
23536,109645420,109645566,True,2,146
23537,109668405,109669904,True,1,1499
23538,109669662,109670530,True,2,868
23539,109671148,109671226,True,1,78
23540,109672800,109673406,True,1,606
23541,109689727,109689875,True,2,148
23542,109699672,109702606,True,1,2934
23543,109727467,109730282,True,2,2815
23544,109732257,109732795,True,6,538
23545,109733305,109734851,False,1,1546
23546,109733305,109742072,False,1,8767
23547,109738986,109741676,True,1,2690
23548,109752269,109755959,True,1,3690
23549,109759787,109762065,False,1,2278
23550,109759787,109762065,True,3,2278
23551,109760644,109761859,True,1,1215
23552,109770141,109771247,True,1,1106
23553,109783169,109784631,True,2,1462
23554,109785186,109785704,True,1,518
23555,109788205,109790623,True,1,2418
23556,109788205,109792470,True,1,4265
23557,109799113,109800200,False,1,1087
23558,109803181,109816062,True,1,12881
23559,109818368,109818925,False,1,557
23560,109823080,109823596,True,1,516
23561,109824758,109833516,True,1,8758
23562,109844159,109845389,False,1,1230
23563,109844159,109845389,True,4,1230
23564,109853456,109853832,True,1,376
23565,109853456,109856904,True,3,3448
23566,109861085,109862818,True,1,1733
23567,109868229,109874123,True,1,5894
23568,109886085,109887710,True,1,1625
23569,109886732,109886818,True,2,86
23570,109887852,109904619,True,1,16767
23571,109889840,109889983,False,1,143
23572,109889840,109889983,True,7,143
23573,109894306,109895629,True,2,1323
23574,109894306,109895644,False,2,1338
23575,109894306,109895644,True,2,1338
23576,109894306,109896004,True,1,1698
23577,109894306,109897877,True,1,3571
23578,109894654,109895905,True,1,1251
23579,109901871,109901984,True,1,113
23580,109904543,109992515,True,1,87972
23581,109905299,109911024,True,1,5725
23582,109905897,109906984,False,3,1087
23583,109910648,109915983,True,3,5335
23584,109911329,109912926,False,1,1597
23585,109919461,109919818,True,5,357
23586,109919615,109922507,True,3,2892
23587,109920552,109922529,True,1,1977
23588,109920879,109922860,True,1,1981
23589,109921711,109923254,False,1,1543
23590,109930469,109931074,True,1,605
23591,109930469,109931518,True,2,1049
23592,109932798,109932970,True,1,172
23593,109933332,109933994,True,1,662
23594,109934705,109942898,True,1,8193
23595,109934859,109937971,True,2,3112
23596,109935020,109938001,True,1,2981
23597,109935342,109938148,True,1,2806
23598,109935577,109938281,True,1,2704
23599,109947199,109947749,True,1,550
23600,109952940,109958973,True,1,6033
23601,109953367,109965756,True,2,12389
23602,109974437,109974558,True,1,121
23603,109974863,109999531,True,4,24668
23604,110004165,110004371,False,1,206
23605,110004165,110004405,False,1,240
23606,110004165,110005385,False,1,1220
23607,110016039,110058255,True,1,42216
23608,110018577,110024013,False,1,5436
23609,110018577,110028203,False,1,9626
23610,110019145,110023632,False,1,4487
23611,110027821,110027944,True,1,123
23612,110027821,110064132,True,2,36311
23613,110028180,110028926,True,3,746
23614,110032075,110034954,True,1,2879
23615,110039976,110041351,True,1,1375
23616,110049359,110050142,True,1,783
23617,110053767,110054732,True,2,965
23618,110059444,110062031,True,1,2587
23619,110067773,110068620,True,3,847
23620,110069159,110203107,True,3,133948
23621,110071263,110075404,True,3,4141
23622,110076914,110077040,True,1,126
23623,110076914,110077329,False,1,415
23624,110076914,110077329,True,1,415
23625,110078678,110152505,False,1,73827
23626,110078678,110152505,True,1,73827
23627,110087468,110089300,False,1,1832
23628,110087468,110091026,True,1,3558
23629,110087468,110092001,True,2,4533
23630,110087956,110088168,False,4,212
23631,110095731,110096849,True,1,1118
23632,110096501,110097302,True,1,801
23633,110111063,110113908,False,1,2845
23634,110111063,110113908,True,1,2845
23635,110111063,110113943,True,1,2880
23636,110122410,110123374,False,2,964
23637,110125506,110126419,True,1,913
23638,110133386,110136803,True,1,3417
23639,110150463,110150932,True,1,469
23640,110169383,110169777,True,1,394
23641,110170635,110170797,True,2,162
23642,110170676,110170838,True,2,162
23643,110170676,110171063,True,2,387
23644,110173782,110296701,True,7,122919
23645,110190845,110220185,False,1,29340
23646,110190845,110220185,True,3,29340
23647,110199897,110200642,True,1,745
23648,110199897,110211010,True,1,11113
23649,110203035,110203953,True,1,918
23650,110205024,110205466,True,1,442
23651,110207092,110246583,True,1,39491
23652,110210286,110210700,True,1,414
23653,110211027,110218864,True,1,7837
23654,110211404,110211565,True,1,161
23655,110215061,110225046,False,1,9985
23656,110215067,110225046,False,2,9979
23657,110215067,110225046,True,2,9979
23658,110215067,110238264,True,2,23197
23659,110216947,110219527,True,1,2580
23660,110231032,110231940,True,1,908
23661,110235116,110235984,False,1,868
23662,110238355,110249363,False,3,11008
23663,110238355,110249363,True,1,11008
23664,110257431,110270594,True,2,13163
23665,110283991,110284382,True,2,391
23666,110284051,110284442,True,1,391
23667,110285034,110285196,False,1,162
23668,110285034,110285196,True,1,162
23669,110287001,110287403,True,1,402
23670,110294667,110295227,True,1,560
23671,110294667,110296354,True,1,1687
23672,110294667,110302541,True,3,7874
23673,110296795,110300257,True,1,3462
23674,110298544,110304484,True,3,5940
23675,110304051,110310025,True,1,5974
23676,110304671,110306094,True,1,1423
23677,110309732,110311055,False,1,1323
23678,110309732,110323492,True,1,13760
23679,110310756,110314820,False,1,4064
23680,110310756,110329608,True,1,18852
23681,110325311,110345352,True,1,20041
23682,110326361,110326866,True,1,505
23683,110326512,110337027,True,1,10515
23684,110339842,110342146,False,1,2304
23685,110339842,110342146,True,2,2304
23686,110344421,110357230,True,1,12809
23687,110344421,110357234,True,1,12813
23688,110344421,110357237,True,3,12816
23689,110348062,110356738,True,1,8676
23690,110348075,110356751,False,1,8676
23691,110348642,110349111,True,2,469
23692,110348789,110349258,True,1,469
23693,110348789,110349480,True,1,691
23694,110348789,110349529,True,1,740
23695,110355190,110387516,True,1,32326
23696,110362412,110366044,False,1,3632
23697,110363186,110363765,True,1,579
23698,110363356,110363811,True,1,455
23699,110384640,110388777,True,1,4137
23700,110399660,110400023,True,5,363
23701,110409005,110410616,True,1,1611
23702,110411981,110412196,True,1,215
23703,110430150,110430617,True,3,467
23704,110439921,110440083,False,1,162
23705,110443120,110448382,True,1,5262
23706,110447433,110452702,True,1,5269
23707,110448577,110448675,False,2,98
23708,110468571,110469420,True,6,849
23709,110472018,110472694,True,1,676
23710,110486737,110488044,False,1,1307
23711,110493676,110494597,True,1,921
23712,110493874,110494596,True,1,722
23713,110494203,110494747,True,1,544
23714,110496722,110497196,True,1,474
23715,110497612,110503990,False,1,6378
23716,110498149,110508388,True,1,10239
23717,110500017,110500924,True,2,907
23718,110501540,110501877,True,1,337
23719,110501940,110504376,True,1,2436
23720,110507150,110540040,True,1,32890
23721,110520113,110532014,False,1,11901
23722,110532980,110613004,True,1,80024
23723,110536908,110537478,True,2,570
23724,110543628,110544402,True,2,774
23725,110548930,110549039,False,1,109
23726,110549284,110550974,True,2,1690
23727,110554234,110554323,True,1,89
23728,110562216,110562993,False,1,777
23729,110562600,110563563,True,2,963
23730,110562600,110627796,False,1,65196
23731,110569809,110571813,True,2,2004
23732,110582376,110588569,False,1,6193
23733,110595283,110606322,True,1,11039
23734,110595613,110613117,True,1,17504
23735,110595613,110626760,True,1,31147
23736,110599731,110603400,True,6,3669
23737,110609084,110619414,True,1,10330
23738,110613448,110615475,False,1,2027
23739,110618495,110619221,True,1,726
23740,110618495,110619440,True,1,945
23741,110618495,110621207,True,1,2712
23742,110618495,110635120,True,1,16625
23743,110619584,110621207,True,1,1623
23744,110624930,110626175,True,1,1245
23745,110629602,110631255,True,1,1653
23746,110630062,110630260,True,6,198
23747,110633358,110634404,True,4,1046
23748,110635104,110641983,False,1,6879
23749,110655881,110656879,True,4,998
23750,110666553,110667668,True,1,1115
23751,110668095,110668387,True,1,292
23752,110668872,110669198,True,1,326
23753,110679028,110680322,False,1,1294
23754,110686260,110697036,True,6,10776
23755,110688426,110690705,True,2,2279
23756,110698360,110716102,True,1,17742
23757,110705462,110706013,False,1,551
23758,110717518,110718716,True,2,1198
23759,110719633,110719957,False,1,324
23760,110723861,110724570,True,2,709
23761,110741499,110742110,True,1,611
23762,110755866,110783397,True,1,27531
23763,110771327,110772332,True,6,1005
23764,110771327,110777838,True,1,6511
23765,110771327,110782193,False,1,10866
23766,110771327,110782193,True,4,10866
23767,110771327,110784920,True,1,13593
23768,110791637,110793825,True,2,2188
23769,110802808,110804422,True,3,1614
23770,110814063,110816703,True,3,2640
23771,110827825,110833941,True,1,6116
23772,110835086,110835162,True,5,76
23773,110835086,110838109,True,1,3023
23774,110867062,110892624,True,1,25562
23775,110870116,110873847,True,4,3731
23776,110870116,110876741,True,1,6625
23777,110893217,110898232,True,1,5015
23778,110918282,110918980,True,1,698
23779,110919384,110919482,True,1,98
23780,110919821,110920310,True,1,489
23781,110927711,110928177,True,3,466
23782,110929652,110935309,True,1,5657
23783,110940721,110942425,False,1,1704
23784,110947934,110949022,True,1,1088
23785,110953396,110958016,True,1,4620
23786,110955545,110959075,True,5,3530
23787,110981776,110985478,False,1,3702
23788,110988032,110992422,True,1,4390
23789,110988032,111003511,True,1,15479
23790,110993066,111011248,True,4,18182
23791,111004320,111008105,True,4,3785
23792,111010865,111014662,False,1,3797
23793,111010865,111014662,True,1,3797
23794,111011970,111023843,False,1,11873
23795,111026469,111026648,True,1,179
23796,111026624,111029899,True,1,3275
23797,111028953,111031263,True,1,2310
23798,111030803,111034122,True,1,3319
23799,111031263,111032292,True,1,1029
23800,111033277,111033787,True,6,510
23801,111036882,111046757,True,1,9875
23802,111044500,111044700,True,1,200
23803,111045924,111046124,True,1,200
23804,111048342,111085770,True,2,37428
23805,111051607,111052119,True,1,512
23806,111051607,111052123,True,2,516
23807,111057388,111062139,True,1,4751
23808,111066811,111069516,True,2,2705
23809,111067655,111068189,True,1,534
23810,111078175,111095216,False,1,17041
23811,111079043,111098278,True,5,19235
23812,111086176,111102330,True,1,16154
23813,111087639,111183112,False,1,95473
23814,111087639,111183141,False,2,95502
23815,111087639,111260155,True,1,172516
23816,111112368,111114444,True,2,2076
23817,111123529,111125044,True,1,1515
23818,111129422,111132846,True,2,3424
23819,111132744,111134303,True,1,1559
23820,111136196,111142354,False,1,6158
23821,111137757,111138765,True,4,1008
23822,111162831,111407453,True,1,244622
23823,111163977,111164046,True,5,69
23824,111163977,111165753,True,2,1776
23825,111163977,111168010,True,3,4033
23826,111167015,111174443,True,1,7428
23827,111174507,111174994,True,3,487
23828,111175552,111177177,False,1,1625
23829,111183668,111183897,True,1,229
23830,111186327,111186518,True,1,191
23831,111186853,111186946,True,1,93
23832,111187289,111187568,True,1,279
23833,111191952,111200020,True,2,8068
23834,111205206,111205296,True,3,90
23835,111219719,111220781,False,1,1062
23836,111222743,111223603,True,1,860
23837,111222743,111233052,True,1,10309
23838,111230024,111230143,True,1,119
23839,111230024,111232348,True,1,2324
23840,111240717,111244038,True,1,3321
23841,111240717,111245490,True,1,4773
23842,111263816,111276472,False,1,12656
23843,111288488,111289413,True,4,925
23844,111296027,111299155,True,3,3128
23845,111298770,111301577,True,1,2807
23846,111300562,111304804,True,3,4242
23847,111300562,111311409,True,1,10847
23848,111301632,111303671,True,1,2039
23849,111307149,111308961,True,1,1812
23850,111326420,111328531,False,1,2111
23851,111326420,111328531,True,1,2111
23852,111338494,111339642,False,1,1148
23853,111340845,111340927,True,5,82
23854,111341012,111341094,False,1,82
23855,111369520,111370351,True,4,831
23856,111379622,111380095,True,1,473
23857,111381231,111393826,True,1,12595
23858,111381435,111394030,True,1,12595
23859,111385885,111385996,True,2,111
23860,111401706,111411141,True,1,9435
23861,111402242,111404064,True,1,1822
23862,111405763,111406027,False,1,264
23863,111411047,111413269,True,1,2222
23864,111411669,111424635,True,1,12966
23865,111420284,111437054,True,1,16770
23866,111423549,111544627,True,3,121078
23867,111425948,111545946,False,1,119998
23868,111429199,111547475,True,1,118276
23869,111435708,111451225,True,1,15517
23870,111438247,111446974,True,1,8727
23871,111445482,111447198,True,1,1716
23872,111445482,111449606,True,1,4124
23873,111467031,111469238,False,1,2207
23874,111476275,111555117,True,1,78842
23875,111476932,111477558,True,2,626
23876,111477870,111555968,True,1,78098
23877,111483045,111483125,True,2,80
23878,111488961,111489854,True,2,893
23879,111489972,111492062,True,1,2090
23880,111493731,111496881,False,1,3150
23881,111493791,111494278,True,1,487
23882,111493791,111495975,True,1,2184
23883,111496417,111498036,True,1,1619
23884,111499284,111501629,True,4,2345
23885,111509864,111534289,True,1,24425
23886,111517704,111519977,False,1,2273
23887,111537744,111691213,True,1,153469
23888,111547640,111550234,True,3,2594
23889,111552655,111561422,True,5,8767
23890,111587015,111588771,True,1,1756
23891,111589115,111593117,True,1,4002
23892,111589115,111595785,True,1,6670
23893,111591479,111593906,True,2,2427
23894,111626969,111627496,True,1,527
23895,111627352,111627664,True,1,312
23896,111633355,111649582,True,2,16227
23897,111633365,111649582,True,2,16217
23898,111637094,111638723,False,1,1629
23899,111648649,111652378,False,2,3729
23900,111648649,111652378,True,2,3729
23901,111662361,111662584,True,1,223
23902,111669751,111677643,True,2,7892
23903,111673907,111674202,True,3,295
23904,111677565,111679326,True,2,1761
23905,111684114,111699149,True,1,15035
23906,111702545,111704380,True,2,1835
23907,111706397,111706564,True,1,167
23908,111706575,111707269,True,1,694
23909,111723237,111724134,False,1,897
23910,111723237,111724516,False,1,1279
23911,111723237,111726042,True,1,2805
23912,111724724,111725882,True,1,1158
23913,111725021,111734185,True,1,9164
23914,111725586,111775278,True,1,49692
23915,111730106,111730196,True,1,90
23916,111732480,111732643,True,1,163
23917,111740859,111741571,True,1,712
23918,111753294,111755325,True,2,2031
23919,111760659,111760743,True,5,84
23920,111762102,111771804,True,1,9702
23921,111776482,111776560,True,1,78
23922,111777742,111783813,False,1,6071
23923,111777742,111801410,True,1,23668
23924,111781346,111785699,True,1,4353
23925,111794632,111795015,True,5,383
23926,111809884,111811717,True,1,1833
23927,111809884,111813072,True,1,3188
23928,111816202,111816597,True,1,395
23929,111825398,111828787,True,1,3389
23930,111825779,111828303,True,1,2524
23931,111826468,111911464,False,1,84996
23932,111833582,111834571,True,1,989
23933,111844029,111845348,True,5,1319
23934,111852622,111855230,True,3,2608
23935,111853592,111855703,True,1,2111
23936,111879249,111882436,True,2,3187
23937,111885267,111889074,True,1,3807
23938,111890755,111892546,True,1,1791
23939,111891860,111891875,True,1,15
23940,111895825,111911914,True,1,16089
23941,111910521,111929092,True,1,18571
23942,111929100,111930699,True,3,1599
23943,111933327,111934161,True,2,834
23944,111941910,111942756,True,1,846
23945,111960743,111971180,True,1,10437
23946,111975872,111978897,True,1,3025
23947,111980782,111981256,False,1,474
23948,111980782,111981256,True,2,474
23949,111981029,111982689,True,1,1660
23950,111993181,111993582,True,1,401
23951,111999850,112000240,True,2,390
23952,112030870,112285252,True,1,254382
23953,112039233,112040480,True,1,1247
23954,112051181,112052494,False,1,1313
23955,112064663,112078086,True,2,13423
23956,112082789,112083607,True,1,818
23957,112086971,112088196,False,1,1225
23958,112093576,112127301,True,1,33725
23959,112093996,112115397,True,4,21401
23960,112093996,112125659,True,2,31663
23961,112101170,112105420,True,1,4250
23962,112104360,112104361,True,1,1
23963,112113186,112114474,True,1,1288
23964,112128147,112137486,False,1,9339
23965,112128147,112142368,False,1,14221
23966,112133029,112133410,False,1,381
23967,112133561,112134645,False,1,1084
23968,112142440,112144628,True,1,2188
23969,112145977,112150713,True,1,4736
23970,112145980,112150713,True,5,4733
23971,112150075,112153099,True,3,3024
23972,112151365,112152924,True,1,1559
23973,112157425,112158337,True,1,912
23974,112157425,112160106,True,5,2681
23975,112158305,112161457,True,3,3152
23976,112161240,112161439,True,1,199
23977,112161613,112161981,True,1,368
23978,112164645,112165457,True,3,812
23979,112164696,112165457,True,1,761
23980,112164729,112165457,True,1,728
23981,112179444,112180166,False,1,722
23982,112179897,112181049,True,1,1152
23983,112180537,112183459,True,2,2922
23984,112187465,112190949,True,3,3484
23985,112187501,112187815,True,2,314
23986,112207748,112211672,True,2,3924
23987,112218967,112219394,False,1,427
23988,112219797,112220532,True,4,735
23989,112219797,112222690,False,1,2893
23990,112220576,112220790,False,1,214
23991,112220576,112222948,False,1,2372
23992,112222153,112224681,True,1,2528
23993,112222781,112263324,True,1,40543
23994,112223503,112225168,True,1,1665
23995,112228451,112229080,True,1,629
23996,112228451,112229085,True,2,634
23997,112228451,112229232,True,1,781
23998,112238636,112238821,True,8,185
23999,112239037,112239129,True,1,92
24000,112239055,112239490,True,2,435
24001,112241318,112241831,False,1,513
24002,112241318,112241831,True,5,513
24003,112254328,112261854,False,1,7526
24004,112256321,112258662,True,1,2341
24005,112260819,112264017,True,1,3198
24006,112263987,112268089,False,2,4102
24007,112263987,112268089,True,6,4102
24008,112263987,112272604,True,1,8617
24009,112266116,112267917,False,1,1801
24010,112266116,112267954,True,1,1838
24011,112272395,112272562,True,2,167
24012,112274608,112279431,True,1,4823
24013,112277097,112277848,True,1,751
24014,112285032,112285549,True,1,517
24015,112287128,112651605,True,1,364477
24016,112292870,112297411,False,2,4541
24017,112293902,112302741,True,1,8839
24018,112296967,112297296,True,5,329
24019,112297752,112313760,True,1,16008
24020,112302390,112305386,True,2,2996
24021,112304940,112306252,True,1,1312
24022,112306976,112307323,True,1,347
24023,112310125,112310902,True,1,777
24024,112318596,112319075,True,1,479
24025,112318596,112319263,True,1,667
24026,112318596,112319319,True,1,723
24027,112319951,112320077,True,1,126
24028,112321823,112325220,True,1,3397
24029,112331934,112335989,True,2,4055
24030,112338819,112339823,True,1,1004
24031,112358627,112488755,False,1,130128
24032,112358627,112554016,False,1,195389
24033,112358726,112364104,True,3,5378
24034,112364963,112366079,True,1,1116
24035,112373361,112376451,True,3,3090
24036,112374509,112374927,True,1,418
24037,112376326,112377881,True,1,1555
24038,112376574,112376904,True,1,330
24039,112392453,112398047,True,1,5594
24040,112410656,112412080,True,2,1424
24041,112423701,112424586,True,1,885
24042,112425111,112437898,True,1,12787
24043,112430714,112430898,True,2,184
24044,112434840,112434944,True,5,104
24045,112440207,112442961,True,1,2754
24046,112443533,112443958,True,1,425
24047,112451101,112451534,True,5,433
24048,112451515,112451734,True,2,219
24049,112460371,112460550,False,1,179
24050,112460371,112460550,True,2,179
24051,112460371,112460838,True,1,467
24052,112461163,112461912,False,1,749
24053,112466097,112473803,False,1,7706
24054,112485650,112489205,False,2,3555
24055,112485650,112497963,False,1,12313
24056,112497550,112507936,False,2,10386
24057,112518047,112518458,True,1,411
24058,112518595,112535483,True,1,16888
24059,112518595,112550432,True,1,31837
24060,112519364,112536252,False,1,16888
24061,112519364,112536252,True,1,16888
24062,112519364,112551201,True,1,31837
24063,112524642,112531480,True,1,6838
24064,112524642,112539858,True,1,15216
24065,112540371,112540485,True,1,114
24066,112541047,112543662,True,1,2615
24067,112566327,112566438,True,3,111
24068,112566626,112567136,True,1,510
24069,112591335,112592365,True,2,1030
24070,112593999,112596933,False,1,2934
24071,112593999,112596933,True,3,2934
24072,112595828,112598514,False,1,2686
24073,112595828,112598514,True,2,2686
24074,112606978,112619231,False,1,12253
24075,112607503,112611110,False,1,3607
24076,112615759,112628467,False,1,12708
24077,112631886,112636123,True,5,4237
24078,112646849,112647711,True,7,862
24079,112650073,112655150,True,5,5077
24080,112651718,112654898,True,1,3180
24081,112651718,112656016,True,2,4298
24082,112651805,112656046,True,2,4241
24083,112651850,112656016,True,1,4166
24084,112652958,112653345,True,1,387
24085,112659409,112661454,True,1,2045
24086,112659993,112660309,True,1,316
24087,112677701,112687017,True,2,9316
24088,112695440,112696230,True,1,790
24089,112696021,112696944,True,4,923
24090,112696243,112711323,True,1,15080
24091,112698619,112700250,True,1,1631
24092,112721463,112722194,True,2,731
24093,112721463,112722386,True,1,923
24094,112735480,112748347,True,1,12867
24095,112735717,112748445,True,3,12728
24096,112739427,112741562,True,1,2135
24097,112739654,112741789,True,1,2135
24098,112758395,112760284,True,3,1889
24099,112758395,112761007,True,1,2612
24100,112759185,112759582,False,1,397
24101,112759185,112765307,True,1,6122
24102,112771548,112773007,True,1,1459
24103,112782165,112782439,True,3,274
24104,112782165,112787036,True,1,4871
24105,112791336,112791606,True,1,270
24106,112792331,112793194,True,2,863
24107,112803953,112805364,False,2,1411
24108,112805899,112808219,False,1,2320
24109,112812733,112821105,False,2,8372
24110,112813990,112821772,False,1,7782
24111,112814795,112817444,True,1,2649
24112,112823292,112830867,True,1,7575
24113,112823882,112830757,True,1,6875
24114,112826302,112828316,True,1,2014
24115,112829233,112829369,False,2,136
24116,112829602,112838201,False,1,8599
24117,112829602,112843656,False,1,14054
24118,112829602,112843665,False,1,14063
24119,112830052,112832141,True,1,2089
24120,112830052,112833524,True,1,3472
24121,112830333,112833935,True,1,3602
24122,112837465,112839086,True,1,1621
24123,112845569,112851260,True,1,5691
24124,112846209,112847082,False,1,873
24125,112846209,112847082,True,1,873
24126,112863384,112865864,True,4,2480
24127,112870527,112871851,True,1,1324
24128,112871638,112871892,True,1,254
24129,112873961,112874440,False,1,479
24130,112918832,112923099,True,2,4267
24131,112922975,112926704,True,1,3729
24132,112929692,112931288,True,1,1596
24133,112930656,112931995,False,4,1339
24134,112939812,112941047,True,2,1235
24135,112942776,112943857,True,1,1081
24136,112943501,112981173,True,1,37672
24137,112947974,112951341,False,1,3367
24138,112947974,112951341,True,2,3367
24139,112948058,112962213,True,1,14155
24140,112954247,112954351,True,1,104
24141,112961590,112962156,True,1,566
24142,112964766,112964856,True,1,90
24143,112970914,112972608,True,1,1694
24144,112971101,112972596,True,1,1495
24145,112974462,112974674,True,1,212
24146,112975227,112975428,True,1,201
24147,112978596,112979123,True,1,527
24148,112980180,112980304,True,1,124
24149,112983726,112985222,False,1,1496
24150,112984723,112985464,True,1,741
24151,112996711,112998472,True,1,1761
24152,112997319,113033655,True,1,36336
24153,113007874,113007959,True,2,85
24154,113019920,113027101,True,1,7181
24155,113020816,113020930,True,1,114
24156,113020956,113021344,True,1,388
24157,113022244,113026171,True,2,3927
24158,113024131,113024899,True,1,768
24159,113037037,113037758,True,1,721
24160,113044478,113046349,True,2,1871
24161,113053468,113053595,True,1,127
24162,113060458,113062594,True,1,2136
24163,113060458,113062760,True,1,2302
24164,113061766,113063548,True,1,1782
24165,113062884,113063951,True,1,1067
24166,113064472,113064555,True,1,83
24167,113069068,113072208,True,1,3140
24168,113092618,113093794,True,1,1176
24169,113092618,113093858,True,2,1240
24170,113099946,113100463,True,1,517
24171,113104232,113104510,True,3,278
24172,113104640,113105514,True,1,874
24173,113113184,113113720,True,3,536
24174,113113184,113114065,True,2,881
24175,113136093,113136762,True,1,669
24176,113139198,113156606,False,1,17408
24177,113140030,113140182,False,1,152
24178,113170547,113230143,True,1,59596
24179,113176985,113177862,True,1,877
24180,113181724,113182059,True,1,335
24181,113182445,113184055,True,1,1610
24182,113182464,113184055,False,2,1591
24183,113182464,113184055,True,3,1591
24184,113195456,113195712,True,8,256
24185,113196869,113197715,True,6,846
24186,113197565,113200540,True,1,2975
24187,113198031,113200621,True,1,2590
24188,113199192,113213237,True,1,14045
24189,113206503,113207662,False,1,1159
24190,113227614,113245557,True,1,17943
24191,113230759,113236046,True,1,5287
24192,113232044,113254518,False,2,22474
24193,113236349,113236740,True,1,391
24194,113237225,113237661,True,1,436
24195,113238274,113238932,True,1,658
24196,113246799,113247046,True,1,247
24197,113247725,113247841,True,1,116
24198,113247725,113249067,True,1,1342
24199,113249157,113249486,True,1,329
24200,113268445,113269195,True,4,750
24201,113268766,113269157,True,1,391
24202,113285072,113285379,False,1,307
24203,113285072,113285379,True,1,307
24204,113295913,113296210,False,1,297
24205,113301529,113302094,True,1,565
24206,113302874,113303461,False,1,587
24207,113302874,113318622,False,1,15748
24208,113304096,113307357,True,1,3261
24209,113304096,113314840,True,1,10744
24210,113305260,113310148,True,2,4888
24211,113311753,113312664,True,3,911
24212,113312030,113312664,True,1,634
24213,113315318,113315418,True,2,100
24214,113315512,113323281,True,1,7769
24215,113319375,113319960,True,2,585
24216,113321677,113322217,True,1,540
24217,113322283,113322642,True,1,359
24218,113323189,113324306,True,1,1117
24219,113332520,113332851,True,4,331
24220,113333204,113333783,True,1,579
24221,113334559,113335538,True,1,979
24222,113339407,113339999,False,1,592
24223,113340090,113340436,False,1,346
24224,113345255,113345751,True,1,496
24225,113348918,113349824,True,1,906
24226,113355262,113355619,False,1,357
24227,113355635,113355736,False,1,101
24228,113371703,113372291,True,1,588
24229,113372068,113381095,True,1,9027
24230,113372068,113384066,True,1,11998
24231,113372549,113383734,True,1,11185
24232,113374819,113375825,True,2,1006
24233,113383852,113384439,True,1,587
24234,113401534,113401874,False,1,340
24235,113401534,113401874,True,1,340
24236,113403001,113403261,True,1,260
24237,113406049,113407140,True,1,1091
24238,113407549,113408141,True,1,592
24239,113408591,113408952,True,1,361
24240,113417007,113417169,True,1,162
24241,113420172,113421024,False,1,852
24242,113420172,113421605,False,1,1433
24243,113421433,113422025,True,4,592
24244,113421993,113422529,False,1,536
24245,113432861,113433456,False,1,595
24246,113432861,113433456,True,1,595
24247,113439778,113444293,True,2,4515
24248,113439934,113444293,True,1,4359
24249,113442319,113444497,True,2,2178
24250,113452070,113454580,True,1,2510
24251,113465652,113465870,True,1,218
24252,113466372,113466638,True,1,266
24253,113466373,113466636,True,3,263
24254,113472696,113472988,True,3,292
24255,113485550,113485834,True,1,284
24256,113510327,113510866,True,1,539
24257,113511739,113514211,False,1,2472
24258,113525095,113527709,True,6,2614
24259,113528139,113546160,True,1,18021
24260,113532072,113536831,True,1,4759
24261,113540013,113542257,False,1,2244
24262,113540111,113540672,True,1,561
24263,113540111,113542252,False,1,2141
24264,113540111,113542252,True,3,2141
24265,113585047,113646797,True,2,61750
24266,113613170,113613929,False,1,759
24267,113614391,113623867,True,3,9476
24268,113614407,113621337,False,1,6930
24269,113615721,113618074,False,1,2353
24270,113621726,113621845,True,1,119
24271,113630198,113633223,True,2,3025
24272,113631829,113648089,True,1,16260
24273,113635196,113649798,True,1,14602
24274,113640030,113666279,False,1,26249
24275,113640030,113666279,True,1,26249
24276,113640930,113643768,True,1,2838
24277,113642146,113643214,True,1,1068
24278,113644208,113644350,True,1,142
24279,113663056,113666258,True,1,3202
24280,113667051,113866237,True,2,199186
24281,113670443,113670904,False,1,461
24282,113688534,113690139,True,1,1605
24283,113693358,113693795,True,1,437
24284,113724760,113725121,True,2,361
24285,113730162,113730290,False,2,128
24286,113730162,113730290,True,5,128
24287,113757427,113757864,True,1,437
24288,113759059,113759700,True,1,641
24289,113759078,113759722,True,2,644
24290,113759318,113759722,False,1,404
24291,113759318,113759722,True,2,404
24292,113769838,113770867,True,1,1029
24293,113775035,113780121,True,3,5086
24294,113791200,113796015,True,2,4815
24295,113798547,113800098,True,2,1551
24296,113798547,113800101,True,1,1554
24297,113810466,113810628,False,1,162
24298,113810466,113814292,False,1,3826
24299,113810854,113814292,False,1,3438
24300,113822957,113823492,True,2,535
24301,113830840,113833775,True,1,2935
24302,113831481,113871807,True,2,40326
24303,113831481,113878365,True,2,46884
24304,113831514,113834086,True,1,2572
24305,113831515,113834110,True,1,2595
24306,113846693,113849764,False,1,3071
24307,113846693,113849764,True,4,3071
24308,113870999,113873857,True,1,2858
24309,113870999,113874414,True,1,3415
24310,113886228,113886337,False,1,109
24311,113890815,113891599,True,1,784
24312,113899377,113903937,True,1,4560
24313,113904802,113906190,True,1,1388
24314,113904802,113911616,True,1,6814
24315,113904802,113920214,True,2,15412
24316,113909879,113910414,True,5,535
24317,113912485,113920092,True,1,7607
24318,113917325,113917467,False,1,142
24319,113922766,113938064,True,1,15298
24320,113926792,113942550,True,1,15758
24321,113928747,113929356,False,1,609
24322,113928747,113957439,True,3,28692
24323,113932304,113935146,True,5,2842
24324,113940591,113943009,True,1,2418
24325,113948272,113948674,False,1,402
24326,113959764,113959960,False,1,196
24327,113961827,113962998,True,1,1171
24328,113962303,113997055,False,1,34752
24329,113971198,113971619,True,1,421
24330,113978992,113994772,False,1,15780
24331,113979137,113995022,False,2,15885
24332,113981946,113982029,True,5,83
24333,113984827,113984926,True,2,99
24334,113991843,113992754,True,2,911
24335,113993416,113993703,True,1,287
24336,114002383,114004315,False,1,1932
24337,114006431,114007525,False,1,1094
24338,114006431,114007813,False,2,1382
24339,114017957,114019743,True,1,1786
24340,114038500,114042095,True,1,3595
24341,114038645,114038910,True,1,265
24342,114038645,114038936,True,1,291
24343,114040445,114041661,True,1,1216
24344,114046965,114074442,True,1,27477
24345,114064165,114064846,True,1,681
24346,114071035,114076585,True,2,5550
24347,114072776,114081808,True,1,9032
24348,114074711,114083931,True,1,9220
24349,114076492,114077232,True,1,740
24350,114092728,114098054,False,1,5326
24351,114093302,114098227,False,3,4925
24352,114093302,114098227,True,3,4925
24353,114100911,114101308,True,2,397
24354,114102085,114105596,False,1,3511
24355,114102085,114105596,True,1,3511
24356,114108979,114112219,False,1,3240
24357,114108979,114112219,True,3,3240
24358,114115406,114115682,False,1,276
24359,114115406,114115682,True,4,276
24360,114115574,114135374,False,1,19800
24361,114120209,114121261,False,1,1052
24362,114120209,114121261,True,2,1052
24363,114120281,114136739,True,1,16458
24364,114134657,114135102,True,3,445
24365,114136242,114138089,False,1,1847
24366,114149191,114149956,False,1,765
24367,114152380,114154517,True,2,2137
24368,114152380,114165247,True,1,12867
24369,114153529,114154052,True,3,523
24370,114153529,114157115,True,1,3586
24371,114153898,114155874,True,1,1976
24372,114154942,114156784,True,1,1842
24373,114158296,114159014,False,1,718
24374,114158296,114159014,True,1,718
24375,114158763,114159821,True,1,1058
24376,114164913,114166067,True,1,1154
24377,114181230,114184992,False,1,3762
24378,114181230,114188657,False,1,7427
24379,114187410,114187633,True,1,223
24380,114189282,114201860,True,1,12578
24381,114200419,114200521,True,1,102
24382,114201543,114203511,True,3,1968
24383,114211983,114219856,True,1,7873
24384,114212546,114212778,False,1,232
24385,114212546,114212778,True,4,232
24386,114213459,114219536,True,1,6077
24387,114222143,114251041,True,2,28898
24388,114222143,114269018,True,1,46875
24389,114248710,114249633,True,4,923
24390,114248710,114251469,True,2,2759
24391,114250881,114253292,True,1,2411
24392,114253156,114254314,True,1,1158
24393,114253156,114271072,True,1,17916
24394,114254542,114255631,True,3,1089
24395,114264066,114266705,True,1,2639
24396,114277144,114302864,True,1,25720
24397,114288622,114289437,True,1,815
24398,114289296,114291660,True,1,2364
24399,114293178,114293783,True,1,605
24400,114293178,114293838,True,1,660
24401,114293181,114293838,True,1,657
24402,114309104,114311460,False,1,2356
24403,114309104,114311460,True,1,2356
24404,114309839,114310058,True,3,219
24405,114314305,114324723,True,1,10418
24406,114316540,114317929,True,1,1389
24407,114325117,114325773,True,1,656
24408,114349795,114351072,True,5,1277
24409,114350076,114351788,True,1,1712
24410,114350369,114351924,False,1,1555
24411,114350391,114351957,True,1,1566
24412,114350632,114356961,True,1,6329
24413,114358489,114360577,False,1,2088
24414,114364291,114364491,True,1,200
24415,114364920,114365654,True,3,734
24416,114365556,114366730,True,1,1174
24417,114368910,114379241,False,1,10331
24418,114369841,114370169,False,1,328
24419,114369841,114370169,True,1,328
24420,114370580,114373663,True,1,3083
24421,114374796,114384288,False,1,9492
24422,114374796,114384288,True,1,9492
24423,114376184,114381048,True,1,4864
24424,114377013,114383985,True,1,6972
24425,114377013,114395947,False,1,18934
24426,114377013,114395947,True,1,18934
24427,114384425,114389732,False,1,5307
24428,114409413,114413455,True,5,4042
24429,114409413,114419883,True,1,10470
24430,114412446,114412848,True,1,402
24431,114413473,114414325,False,1,852
24432,114420876,114422420,True,1,1544
24433,114421936,114422920,True,4,984
24434,114421936,114422930,True,2,994
24435,114426701,114429064,True,1,2363
24436,114426701,114430723,True,2,4022
24437,114431336,114432618,True,1,1282
24438,114440594,114458667,True,1,18073
24439,114440603,114458654,True,1,18051
24440,114440954,114458671,True,1,17717
24441,114441206,114458658,True,1,17452
24442,114442394,114522464,False,1,80070
24443,114452778,114453435,True,1,657
24444,114452798,114453435,True,2,637
24445,114453451,114460985,True,2,7534
24446,114453451,114468852,True,1,15401
24447,114453502,114460985,True,1,7483
24448,114453502,114468852,True,1,15350
24449,114456707,114463418,True,1,6711
24450,114464266,114464360,True,1,94
24451,114466025,114479966,False,1,13941
24452,114466025,114479966,True,1,13941
24453,114467102,114478456,True,1,11354
24454,114496687,114498158,True,1,1471
24455,114504718,114506569,True,2,1851
24456,114508798,114511718,True,1,2920
24457,114521242,114522311,True,1,1069
24458,114523729,114526504,True,1,2775
24459,114523729,114531356,True,2,7627
24460,114528453,114530964,True,2,2511
24461,114535967,114536652,True,1,685
24462,114536497,114538328,True,5,1831
24463,114536497,114539500,True,2,3003
24464,114537205,114537703,True,1,498
24465,114553493,114578005,False,1,24512
24466,114557697,114558751,False,1,1054
24467,114558354,114559002,False,1,648
24468,114558354,114559027,True,2,673
24469,114560087,114644156,True,1,84069
24470,114572819,114576665,True,6,3846
24471,114576541,114577070,True,1,529
24472,114580172,114581589,False,1,1417
24473,114580949,114582380,True,1,1431
24474,114592326,114593525,True,1,1199
24475,114595939,114609678,True,3,13739
24476,114604008,114604340,True,1,332
24477,114604058,114604343,True,1,285
24478,114604762,114610095,True,2,5333
24479,114605354,114610454,True,1,5100
24480,114606024,114612932,True,2,6908
24481,114620960,114621208,True,1,248
24482,114621311,114622348,True,1,1037
24483,114626559,114632038,True,1,5479
24484,114634771,114640109,True,1,5338
24485,114639109,114641035,True,2,1926
24486,114641093,114653722,True,1,12629
24487,114650391,114650556,True,5,165
24488,114650391,114651410,True,1,1019
24489,114655725,114657277,True,2,1552
24490,114658883,114659094,False,1,211
24491,114667671,114669578,True,2,1907
24492,114691245,114691824,True,2,579
24493,114705223,114711587,False,1,6364
24494,114708008,114711885,True,2,3877
24495,114716318,114716786,True,1,468
24496,114717424,114767145,False,1,49721
24497,114730221,114730746,True,2,525
24498,114730221,114732376,True,1,2155
24499,114731498,114733054,True,1,1556
24500,114731515,114735227,True,1,3712
24501,114733538,114734525,False,1,987
24502,114743049,114748723,True,1,5674
24503,114776786,114777330,True,1,544
24504,114785495,114787041,True,1,1546
24505,114788282,114810962,False,1,22680
24506,114790113,114792363,True,3,2250
24507,114791361,114792803,True,1,1442
24508,114794109,114811728,True,1,17619
24509,114807852,114808289,False,3,437
24510,114807852,114809696,False,3,1844
24511,114807852,114809940,False,1,2088
24512,114807852,114809940,True,2,2088
24513,114811993,114823617,False,1,11624
24514,114812963,114819957,True,1,6994
24515,114818237,114839626,True,2,21389
24516,114826102,114826327,False,1,225
24517,114826102,114826327,True,1,225
24518,114830735,114885459,True,2,54724
24519,114833618,114887353,True,1,53735
24520,114844965,114845214,True,3,249
24521,114850547,114852140,True,2,1593
24522,114850547,114852149,True,1,1602
24523,114858423,114858642,False,1,219
24524,114858423,114898700,True,1,40277
24525,114863456,114863555,False,1,99
24526,114871132,114874964,True,1,3832
24527,114871132,114885365,True,1,14233
24528,114877426,114886459,True,1,9033
24529,114877426,114886462,True,1,9036
24530,114898120,114898842,True,1,722
24531,114903267,114903978,True,3,711
24532,114925278,114926254,True,2,976
24533,114927379,114939929,True,5,12550
24534,114928587,114934844,True,1,6257
24535,114933345,114937090,True,4,3745
24536,114935945,114938387,True,1,2442
24537,114942759,114942953,True,1,194
24538,114943293,114943375,True,1,82
24539,114944939,114951671,True,1,6732
24540,114946534,114951078,True,1,4544
24541,114952815,114953168,True,1,353
24542,114956675,114956760,True,1,85
24543,114960273,114985072,False,1,24799
24544,114960273,114985072,True,4,24799
24545,114962826,114966286,True,5,3460
24546,114965813,114967582,True,1,1769
24547,114967995,114970776,True,1,2781
24548,114979730,114979817,True,7,87
24549,114984298,114985511,True,1,1213
24550,114993272,114993489,True,2,217
24551,115013276,115013392,True,2,116
24552,115017910,115018000,True,1,90
24553,115019915,115032046,True,1,12131
24554,115023442,115035002,True,3,11560
24555,115024605,115029520,True,2,4915
24556,115029116,115031000,False,1,1884
24557,115029116,115031000,True,1,1884
24558,115029116,115036174,False,1,7058
24559,115029116,115036174,True,5,7058
24560,115041640,115077268,True,1,35628
24561,115041728,115077221,True,1,35493
24562,115045095,115054521,True,4,9426
24563,115058751,115085740,True,2,26989
24564,115058751,115088088,True,1,29337
24565,115058751,115088197,True,5,29446
24566,115058751,115090713,True,5,31962
24567,115058751,115092280,True,1,33529
24568,115058751,115098436,True,5,39685
24569,115058773,115090713,True,1,31940
24570,115058824,115085740,True,6,26916
24571,115058824,115090713,True,1,31889
24572,115058824,115098436,True,1,39612
24573,115080492,115083759,True,2,3267
24574,115085394,115087015,True,2,1621
24575,115089086,115089854,True,1,768
24576,115092871,115095340,True,1,2469
24577,115112686,115117408,False,1,4722
24578,115112686,115117408,True,2,4722
24579,115115114,115118362,True,1,3248
24580,115122533,115123192,False,1,659
24581,115123985,115124888,False,1,903
24582,115134658,115134849,True,1,191
24583,115134658,115137068,True,1,2410
24584,115141055,115141933,True,1,878
24585,115143497,115144297,True,1,800
24586,115153179,115172532,True,2,19353
24587,115153685,115172566,True,1,18881
24588,115185684,115190077,False,2,4393
24589,115188942,115192206,True,1,3264
24590,115207628,115209088,False,2,1460
24591,115207628,115209088,True,1,1460
24592,115218380,115219723,True,2,1343
24593,115221386,115225665,True,1,4279
24594,115221386,115229236,True,1,7850
24595,115225252,115225716,True,1,464
24596,115246949,115247939,True,4,990
24597,115247854,115248411,True,2,557
24598,115248313,115248694,True,2,381
24599,115248585,115248726,True,1,141
24600,115248597,115248732,True,1,135
24601,115254079,115254295,True,1,216
24602,115258087,115258215,True,2,128
24603,115263105,115265199,True,1,2094
24604,115274934,115275110,True,4,176
24605,115286029,115286871,True,2,842
24606,115286151,115286976,True,1,825
24607,115286773,115288127,False,1,1354
24608,115292926,115293702,True,1,776
24609,115296443,115297318,True,5,875
24610,115307442,115329150,True,1,21708
24611,115307442,115337812,True,1,30370
24612,115307957,115329410,True,2,21453
24613,115325132,115337915,True,1,12783
24614,115325132,115337919,True,1,12787
24615,115325132,115346581,True,2,21449
24616,115325158,115337919,True,1,12761
24617,115328943,115329726,True,1,783
24618,115330661,115341343,True,1,10682
24619,115337467,115382034,True,1,44567
24620,115337467,115398883,True,1,61416
24621,115338706,115355492,False,1,16786
24622,115344708,115345476,True,4,768
24623,115346788,115348707,True,1,1919
24624,115346788,115357369,True,1,10581
24625,115352375,115353874,False,3,1499
24626,115352375,115353874,True,4,1499
24627,115352375,115362725,False,1,10350
24628,115352375,115363647,True,1,11272
24629,115394583,115418684,True,3,24101
24630,115404473,115409387,False,1,4914
24631,115404473,115409387,True,3,4914
24632,115406181,115408108,True,1,1927
24633,115408292,115528547,False,1,120255
24634,115427476,115427884,True,1,408
24635,115430316,115430469,True,1,153
24636,115443456,115443609,True,1,153
24637,115456602,115456755,True,1,153
24638,115457476,115459086,True,1,1610
24639,115457476,115460535,True,2,3059
24640,115469744,115469897,True,1,153
24641,115471711,115476030,True,1,4319
24642,115471711,115476565,True,2,4854
24643,115471711,115482516,True,1,10805
24644,115482874,115483027,True,1,153
24645,115484858,115485484,True,1,626
24646,115484863,115485484,True,1,621
24647,115485101,115485535,True,1,434
24648,115485101,115485544,True,1,443
24649,115486749,115560281,True,4,73532
24650,115500410,115500545,True,2,135
24651,115504341,115507341,True,1,3000
24652,115504341,115512023,True,1,7682
24653,115508270,115508465,True,1,195
24654,115535886,115536996,True,1,1110
24655,115539426,115540547,True,1,1121
24656,115548420,115550835,False,2,2415
24657,115548420,115550835,True,8,2415
24658,115548420,115557968,True,1,9548
24659,115548420,115559992,False,2,11572
24660,115548420,115559992,True,2,11572
24661,115548420,115570046,True,1,21626
24662,115548420,115572273,False,1,23853
24663,115548420,115606861,False,1,58441
24664,115550005,115550896,False,1,891
24665,115550005,115559396,True,1,9391
24666,115550283,115550402,True,1,119
24667,115550283,115551872,True,4,1589
24668,115550283,115561029,False,1,10746
24669,115550283,115561029,True,1,10746
24670,115551479,115552520,True,3,1041
24671,115551479,115561677,True,1,10198
24672,115569971,115593642,True,5,23671
24673,115574697,115576773,True,1,2076
24674,115582910,115587335,True,1,4425
24675,115582928,115614692,True,1,31764
24676,115584056,115587769,True,1,3713
24677,115584949,115585163,True,8,214
24678,115584949,115585766,False,1,817
24679,115584949,115585766,True,1,817
24680,115590772,115591374,True,1,602
24681,115611052,115611587,False,1,535
24682,115657524,115671600,True,1,14076
24683,115659342,115660085,True,1,743
24684,115664103,115666912,True,1,2809
24685,115689244,115692120,True,1,2876
24686,115690278,115696552,True,1,6274
24687,115690278,115697626,True,2,7348
24688,115698712,115698970,True,1,258
24689,115700717,115732510,True,1,31793
24690,115707901,115711363,True,2,3462
24691,115707901,115711697,False,1,3796
24692,115707901,115712371,True,1,4470
24693,115708642,115712758,False,1,4116
24694,115714693,115714943,True,1,250
24695,115714693,115720738,False,1,6045
24696,115714693,115720738,True,1,6045
24697,115725709,115726665,True,1,956
24698,115725709,115727735,True,2,2026
24699,115732508,115733421,False,1,913
24700,115732508,115733421,True,4,913
24701,115732508,115733860,True,1,1352
24702,115735783,115736028,True,1,245
24703,115741564,115741752,True,1,188
24704,115747110,115749235,True,1,2125
24705,115749949,115751059,False,1,1110
24706,115749949,115754788,True,1,4839
24707,115751417,115751961,True,5,544
24708,115751540,115757949,True,2,6409
24709,115751594,115758003,True,2,6409
24710,115752394,115752636,True,1,242
24711,115757997,115792406,True,1,34409
24712,115762684,115762794,False,1,110
24713,115763701,115764519,True,2,818
24714,115763701,115765707,True,1,2006
24715,115764134,115764272,True,2,138
24716,115768408,115780566,False,7,12158
24717,115768408,115780566,True,5,12158
24718,115794738,115795826,True,1,1088
24719,115797121,115797762,True,1,641
24720,115802699,115806771,True,1,4072
24721,115802699,115809631,True,1,6932
24722,115802699,115830495,True,1,27796
24723,115813280,115815034,True,1,1754
24724,115821333,115821420,True,6,87
24725,115833452,115834468,True,1,1016
24726,115834604,115838000,True,2,3396
24727,115839301,115839477,True,1,176
24728,115841358,115841636,False,1,278
24729,115845302,115847490,True,1,2188
24730,115845302,115851806,True,1,6504
24731,115848390,115849628,True,4,1238
24732,115874625,115877863,True,7,3238
24733,115874625,115880795,True,1,6170
24734,115874902,115878892,True,1,3990
24735,115874902,115883905,True,4,9003
24736,115888029,115901066,True,1,13037
24737,115888029,115902087,True,1,14058
24738,115891019,115892631,False,1,1612
24739,115891241,115892809,False,1,1568
24740,115893653,115899943,True,1,6290
24741,115934431,115943763,False,1,9332
24742,115941092,115941561,True,1,469
24743,115941092,115958327,True,3,17235
24744,115945883,115949493,True,1,3610
24745,115952063,116030261,False,1,78198
24746,115966742,115967343,True,1,601
24747,115966742,115967979,True,2,1237
24748,115966742,115968953,True,1,2211
24749,115966742,115969596,True,1,2854
24750,115970187,115972747,True,4,2560
24751,115977851,115979822,True,1,1971
24752,115980190,115982019,True,1,1829
24753,115988709,116056897,True,4,68188
24754,115997244,115997728,True,1,484
24755,115997244,115997955,True,1,711
24756,115997244,115998574,True,1,1330
24757,115998053,115999810,True,1,1757
24758,115998053,116000281,True,1,2228
24759,115998239,115999810,True,1,1571
24760,115998243,115999810,False,1,1567
24761,115998429,116000591,True,3,2162
24762,115998429,116001912,True,2,3483
24763,115998429,116001915,True,2,3486
24764,115998641,115998830,True,1,189
24765,116008060,116008313,True,1,253
24766,116008379,116008451,True,1,72
24767,116010991,116011754,True,1,763
24768,116010991,116011928,True,1,937
24769,116013613,116015128,False,1,1515
24770,116020876,116022055,True,2,1179
24771,116022789,116027331,True,2,4542
24772,116022789,116027334,True,1,4545
24773,116027927,116028408,False,1,481
24774,116027927,116028408,True,1,481
24775,116035924,116036461,False,1,537
24776,116040421,116041076,True,2,655
24777,116045077,116046324,True,1,1247
24778,116047228,116047372,True,1,144
24779,116050057,116050606,True,1,549
24780,116060194,116061126,False,2,932
24781,116060194,116061126,True,1,932
24782,116060998,116061967,True,1,969
24783,116061733,116063830,False,1,2097
24784,116061733,116063830,True,2,2097
24785,116070756,116071707,True,1,951
24786,116070761,116071657,False,1,896
24787,116070761,116071657,True,3,896
24788,116074273,116076643,True,1,2370
24789,116077666,116081128,True,1,3462
24790,116077666,116085202,True,1,7536
24791,116079663,116079872,True,1,209
24792,116085005,116086218,False,1,1213
24793,116106877,116107399,True,1,522
24794,116107814,116108220,True,1,406
24795,116107814,116108806,True,1,992
24796,116107814,116111026,True,1,3212
24797,116107814,116112401,True,1,4587
24798,116117185,116125421,True,1,8236
24799,116119697,116130655,True,1,10958
24800,116128228,116128424,True,2,196
24801,116168002,116170103,True,1,2101
24802,116175843,116176268,True,8,425
24803,116175843,116177298,True,1,1455
24804,116191384,116191945,True,1,561
24805,116191384,116195532,True,1,4148
24806,116191384,116197004,True,1,5620
24807,116191607,116195532,True,1,3925
24808,116222754,116226895,False,1,4141
24809,116222754,116226895,True,1,4141
24810,116235144,116235334,True,3,190
24811,116235418,116235513,True,1,95
24812,116235592,116241650,False,1,6058
24813,116236801,116236880,True,1,79
24814,116238652,116238830,True,3,178
24815,116240183,116240768,True,1,585
24816,116242046,116243935,True,3,1889
24817,116251700,116256607,True,1,4907
24818,116251700,116257355,True,1,5655
24819,116263344,116263614,False,1,270
24820,116264654,116273513,True,1,8859
24821,116269759,116387583,True,2,117824
24822,116271305,116271406,False,1,101
24823,116277783,116278309,True,2,526
24824,116277859,116278371,True,1,512
24825,116283909,116284472,False,1,563
24826,116283909,116284472,True,2,563
24827,116289148,116289923,True,1,775
24828,116289148,116290529,True,1,1381
24829,116289338,116289613,True,1,275
24830,116289338,116289686,True,2,348
24831,116289338,116289923,True,2,585
24832,116289338,116290529,True,2,1191
24833,116295430,116296208,True,1,778
24834,116298241,116298823,True,1,582
24835,116298548,116299590,True,1,1042
24836,116300117,116304497,False,1,4380
24837,116303352,116303613,True,1,261
24838,116305235,116470723,True,1,165488
24839,116313154,116313508,True,2,354
24840,116316493,116316695,True,1,202
24841,116316869,116316952,True,1,83
24842,116322053,116323340,False,1,1287
24843,116325284,116325434,True,2,150
24844,116333066,116333180,False,1,114
24845,116333066,116333180,True,2,114
24846,116347682,116347875,False,1,193
24847,116353168,116353418,True,5,250
24848,116356882,116357420,True,2,538
24849,116357519,116361899,True,1,4380
24850,116359789,116497762,True,1,137973
24851,116360873,116361913,True,1,1040
24852,116382937,116384735,True,2,1798
24853,116384068,116389767,True,1,5699
24854,116385424,116386629,False,1,1205
24855,116386826,116389964,True,1,3138
24856,116386948,116389964,True,1,3016
24857,116386948,116391183,True,1,4235
24858,116386948,116455487,True,1,68539
24859,116391828,116393239,True,1,1411
24860,116392073,116392970,True,1,897
24861,116400256,116401046,True,1,790
24862,116403522,116404669,False,1,1147
24863,116407534,116521823,True,1,114289
24864,116415033,116446388,True,2,31355
24865,116417943,116421088,False,1,3145
24866,116425965,116428028,True,1,2063
24867,116431219,116431394,True,4,175
24868,116446901,116458861,True,1,11960
24869,116446901,116465545,True,1,18644
24870,116454754,116459974,False,1,5220
24871,116454754,116459974,True,1,5220
24872,116461872,116466915,False,1,5043
24873,116464183,116464800,True,3,617
24874,116481753,116539530,True,1,57777
24875,116492355,116496851,False,1,4496
24876,116493088,116498587,True,5,5499
24877,116501563,116503396,True,1,1833
24878,116503534,116569875,True,1,66341
24879,116511479,116512594,True,2,1115
24880,116512919,116513866,False,1,947
24881,116516622,116520314,True,2,3692
24882,116535772,116536347,True,10,575
24883,116545814,116547508,False,1,1694
24884,116545814,116547553,False,2,1739
24885,116547714,116549806,True,1,2092
24886,116547732,116549736,True,4,2004
24887,116547732,116549790,True,1,2058
24888,116547779,116549736,True,2,1957
24889,116562265,116567151,True,1,4886
24890,116562265,116568928,True,1,6663
24891,116562265,116571136,True,1,8871
24892,116562265,116582659,False,1,20394
24893,116567858,116570468,True,2,2610
24894,116578490,116765617,True,1,187127
24895,116584115,116588005,True,1,3890
24896,116584115,116588203,True,2,4088
24897,116584115,116594211,True,1,10096
24898,116584221,116585180,False,1,959
24899,116584349,116588005,True,1,3656
24900,116584349,116588203,True,1,3854
24901,116589539,116589857,True,4,318
24902,116592757,116614424,True,2,21667
24903,116627022,116628935,True,1,1913
24904,116628561,116632392,True,3,3831
24905,116637433,116670215,True,3,32782
24906,116637433,116673772,True,2,36339
24907,116637433,116686855,True,2,49422
24908,116637433,116694923,True,1,57490
24909,116638920,116643109,True,2,4189
24910,116650751,116654482,False,1,3731
24911,116652809,116654391,False,1,1582
24912,116652919,116654340,False,1,1421
24913,116653535,116656161,True,1,2626
24914,116662411,116662958,True,2,547
24915,116662411,116681487,True,1,19076
24916,116662411,116698568,True,1,36157
24917,116671115,116674853,True,1,3738
24918,116674949,116675469,False,1,520
24919,116683593,116692050,True,1,8457
24920,116683593,116709134,False,1,25541
24921,116693681,116698913,False,1,5232
24922,116693681,116698913,True,2,5232
24923,116722027,116748380,False,1,26353
24924,116722619,116728650,True,1,6031
24925,116722619,116728653,True,1,6034
24926,116736667,116748963,True,1,12296
24927,116752412,116755949,False,1,3537
24928,116767340,116769028,True,1,1688
24929,116773312,116773618,True,3,306
24930,116774556,116775897,True,1,1341
24931,116779838,116787091,False,1,7253
24932,116780484,116781650,True,1,1166
24933,116822681,116826488,True,1,3807
24934,116827262,116827554,True,4,292
24935,116838623,116840567,True,3,1944
24936,116852988,116855301,True,1,2313
24937,116852988,116863297,True,1,10309
24938,116852988,116864698,True,1,11710
24939,116860874,116889264,True,1,28390
24940,116861282,116889277,True,1,27995
24941,116867248,116867809,False,1,561
24942,116867248,116867809,True,1,561
24943,116876405,116883517,True,1,7112
24944,116878060,116879058,True,1,998
24945,116906109,116929339,True,1,23230
24946,116906215,116907500,True,1,1285
24947,116906215,116911008,True,1,4793
24948,116939889,116942561,True,1,2672
24949,116942329,116942571,True,2,242
24950,116942909,116943154,True,1,245
24951,116950198,116950656,True,1,458
24952,116953870,116954290,True,1,420
24953,116955718,116962260,True,1,6542
24954,116955794,116957791,True,1,1997
24955,116968600,116970762,True,1,2162
24956,116980087,116988013,True,2,7926
24957,116981875,116985480,True,1,3605
24958,116995249,117019206,True,1,23957
24959,116996364,117019651,True,1,23287
24960,116997700,117020383,True,1,22683
24961,116999868,117003006,True,1,3138
24962,117017726,117021861,True,1,4135
24963,117028675,117028838,False,1,163
24964,117028675,117028838,True,1,163
24965,117031033,117032694,True,2,1661
24966,117045714,117049758,True,2,4044
24967,117067320,117077490,False,1,10170
24968,117067320,117077490,True,1,10170
24969,117068219,117068936,True,1,717
24970,117068219,117071654,True,1,3435
24971,117068219,117071692,True,1,3473
24972,117068219,117071746,True,3,3527
24973,117080271,117080354,True,1,83
24974,117090962,117092239,True,1,1277
24975,117090962,117092769,True,2,1807
24976,117098850,117099075,False,1,225
24977,117098850,117099075,True,4,225
24978,117102266,117102777,True,4,511
24979,117104278,117106603,True,1,2325
24980,117108789,117108934,False,1,145
24981,117108789,117108934,True,4,145
24982,117128176,117131389,True,1,3213
24983,117141284,117141941,True,2,657
24984,117141284,117141946,True,1,662
24985,117141284,117143552,True,4,2268
24986,117141284,117145418,True,1,4134
24987,117143059,117146055,True,2,2996
24988,117154863,117156319,True,1,1456
24989,117166090,117181093,True,1,15003
24990,117167424,117168656,True,1,1232
24991,117191951,117192747,True,2,796
24992,117191954,117192747,True,3,793
24993,117195413,117196439,True,2,1026
24994,117203849,117206025,True,2,2176
24995,117239641,117248684,False,1,9043
24996,117239764,117241688,True,1,1924
24997,117262042,117264939,True,1,2897
24998,117275670,117276460,False,1,790
24999,117275831,117276491,False,1,660
25000,117275945,117276491,False,1,546
25001,117278572,117291616,True,1,13044
25002,117304920,117312556,False,1,7636
25003,117317616,117319205,False,1,1589
25004,117333844,117336403,True,1,2559
25005,117346030,117347608,True,1,1578
25006,117355790,117378423,False,1,22633
25007,117355790,117378423,True,1,22633
25008,117360167,117361672,True,1,1505
25009,117360764,117362269,False,1,1505
25010,117360764,117362269,True,1,1505
25011,117389204,117389681,False,1,477
25012,117389204,117389681,True,3,477
25013,117389204,117412480,False,1,23276
25014,117389204,117412480,True,1,23276
25015,117390403,117405112,True,1,14709
25016,117401688,117404312,True,2,2624
25017,117401688,117410139,True,1,8451
25018,117404286,117447714,False,1,43428
25019,117405791,117425798,True,1,20007
25020,117405791,117426964,True,1,21173
25021,117411622,117415317,True,1,3695
25022,117421516,117421735,True,2,219
25023,117421923,117425301,True,1,3378
25024,117423181,117425988,True,2,2807
25025,117423181,117430357,True,1,7176
25026,117425150,117431483,False,1,6333
25027,117427247,117443008,False,2,15761
25028,117429694,117436497,True,1,6803
25029,117448493,117554704,True,1,106211
25030,117448510,117554721,True,1,106211
25031,117448510,117558173,True,1,109663
25032,117456035,117467230,True,2,11195
25033,117456210,117514069,True,1,57859
25034,117466193,117472777,False,2,6584
25035,117480381,117480901,False,2,520
25036,117480381,117480901,True,4,520
25037,117480962,117481172,True,1,210
25038,117481381,117499004,False,1,17623
25039,117481769,117482591,False,1,822
25040,117483231,117484353,True,2,1122
25041,117492712,117493065,False,1,353
25042,117495959,117631670,False,1,135711
25043,117504782,117507742,False,1,2960
25044,117504782,117510659,False,1,5877
25045,117510446,117511983,True,4,1537
25046,117530639,117531735,False,1,1096
25047,117530639,117531735,True,3,1096
25048,117540838,117559668,False,1,18830
25049,117567826,117573687,False,1,5861
25050,117580830,117587398,True,1,6568
25051,117582306,117587412,False,1,5106
25052,117596334,117609509,True,1,13175
25053,117620497,117766278,False,1,145781
25054,117627354,117627657,False,1,303
25055,117633550,117634191,False,2,641
25056,117669892,117684039,True,1,14147
25057,117676864,117684500,True,1,7636
25058,117692672,117695735,True,1,3063
25059,117696571,117699243,True,1,2672
25060,117716566,117716888,True,1,322
25061,117718326,117723801,False,1,5475
25062,117720325,117720763,False,1,438
25063,117725454,117725657,False,1,203
25064,117725454,117725657,True,1,203
25065,117727745,117728078,False,1,333
25066,117734737,117735575,True,1,838
25067,117734737,117739763,True,1,5026
25068,117737299,117737628,True,1,329
25069,117739124,117739574,True,1,450
25070,117746236,117771361,False,1,25125
25071,117749426,117750796,True,2,1370
25072,117749426,117766307,True,1,16881
25073,117751255,117752928,True,3,1673
25074,117759717,117760071,True,1,354
25075,117759717,117760173,True,1,456
25076,117778349,117780304,False,1,1955
25077,117778349,117780304,True,2,1955
25078,117778787,117814582,False,1,35795
25079,117788457,117789056,True,1,599
25080,117788457,117789090,True,1,633
25081,117788457,117790181,True,2,1724
25082,117789890,117790788,True,1,898
25083,117797341,117798137,True,1,796
25084,117804072,117804552,True,1,480
25085,117804772,117805239,False,1,467
25086,117812896,117815820,True,1,2924
25087,117814477,117851275,True,1,36798
25088,117819021,117820093,True,1,1072
25089,117820736,117820871,True,2,135
25090,117820759,117820871,True,2,112
25091,117824620,117825549,True,2,929
25092,117840594,117841368,True,1,774
25093,117840594,117841392,True,1,798
25094,117840594,117841433,True,1,839
25095,117877863,117888112,True,1,10249
25096,117879143,117911233,True,1,32090
25097,117880090,117889021,True,1,8931
25098,117890758,117892592,True,1,1834
25099,117893236,117918120,True,1,24884
25100,117920113,117922627,False,1,2514
25101,117926041,117927522,True,1,1481
25102,117926041,117928031,True,2,1990
25103,117928849,117931416,True,1,2567
25104,117928982,117931464,True,1,2482
25105,117956961,117958956,True,1,1995
25106,117975665,117976338,True,3,673
25107,117983050,117983307,False,1,257
25108,117998824,117998920,True,1,96
25109,118002047,118158620,True,1,156573
25110,118019757,118019849,True,1,92
25111,118050573,118052656,True,2,2083
25112,118112299,118112625,True,1,326
25113,118112299,118114576,True,1,2277
25114,118119435,118119511,True,1,76
25115,118126075,118126203,True,3,128
25116,118127826,118143495,False,2,15669
25117,118127826,118143495,True,2,15669
25118,118134674,118134759,True,1,85
25119,118134927,118160441,True,2,25514
25120,118141328,118150830,True,1,9502
25121,118147910,118153925,True,1,6015
25122,118148154,118153925,True,2,5771
25123,118160316,118160433,True,1,117
25124,118173720,118179375,True,1,5655
25125,118173720,118184285,False,1,10565
25126,118201260,118206888,True,1,5628
25127,118201688,118208237,True,1,6549
25128,118210021,118212208,True,2,2187
25129,118211534,118213006,True,1,1472
25130,118246237,118247250,False,1,1013
25131,118246237,118247250,True,2,1013
25132,118305789,118383827,True,1,78038
25133,118307696,118307785,True,1,89
25134,118315666,118324051,True,1,8385
25135,118336981,118337980,False,1,999
25136,118343549,118347066,True,5,3517
25137,118382259,118383637,True,1,1378
25138,118428065,118436073,True,6,8008
25139,118469652,118665763,False,1,196111
25140,118501799,118610037,False,1,108238
25141,118501799,118610037,True,1,108238
25142,118532534,118533771,False,1,1237
25143,118532534,118533771,True,2,1237
25144,118560131,118602865,True,3,42734
25145,118560948,118603345,True,1,42397
25146,118566771,118725800,True,1,159029
25147,118566771,118763609,True,1,196838
25148,118645308,118753523,False,1,108215
25149,118646903,118667504,True,1,20601
25150,118647850,118653229,True,1,5379
25151,118660709,118664250,True,1,3541
25152,118660709,118664328,True,1,3619
25153,118660709,118665826,True,1,5117
25154,118686062,118686146,True,1,84
25155,118688775,118689897,False,1,1122
25156,118706791,118707322,True,1,531
25157,118710114,118710352,True,1,238
25158,118717836,118718333,False,1,497
25159,118718244,118727116,True,1,8872
25160,118755769,118759649,True,1,3880
25161,118794774,118796802,True,2,2028
25162,118807069,118807646,True,1,577
25163,118810075,118810710,True,1,635
25164,118820860,118825577,True,1,4717
25165,118830941,118831360,False,1,419
25166,118833664,118834806,True,1,1142
25167,118857822,118858562,True,1,740
25168,118931589,118938568,True,1,6979
25169,118931589,118943303,True,4,11714
25170,118931589,118943306,True,2,11717
25171,118955188,118956299,True,2,1111
25172,118955188,118956321,True,1,1133
25173,118966134,119042329,True,1,76195
25174,118992822,118994272,True,2,1450
25175,119045639,119063213,True,3,17574
25176,119059716,119063625,True,1,3909
25177,119067843,119068702,True,2,859
25178,119109118,119110853,True,1,1735
25179,119147912,119148779,True,1,867
25180,119193763,119195894,True,1,2131
25181,119196025,119196508,False,1,483
25182,119220553,119221289,True,1,736
25183,119240789,119240954,True,1,165
25184,119310866,119385537,True,2,74671
25185,119311081,119385606,True,1,74525
25186,119420863,119423002,True,1,2139
25187,119424669,119451361,True,3,26692
25188,119438318,119438651,True,1,333
25189,119460536,119488091,True,1,27555
25190,119460852,119481118,True,2,20266
25191,119470329,119472980,True,1,2651
25192,119470340,119472980,True,1,2640
25193,119473467,119643490,True,1,170023
25194,119518047,119519741,True,1,1694
25195,119525446,119544014,False,1,18568
25196,119525446,119549830,True,3,24384
25197,119525658,119532921,True,1,7263
25198,119551597,119562955,True,1,11358
25199,119567789,119569025,False,1,1236
25200,119567789,119600384,False,1,32595
25201,119567789,119608768,False,1,40979
25202,119615743,119618687,True,1,2944
25203,119643933,119647995,False,1,4062
25204,119648313,119652717,True,2,4404
25205,119648313,119655833,True,1,7520
25206,119655107,119657361,True,1,2254
25207,119709787,119732907,True,3,23120
25208,119712430,119713299,True,3,869
25209,119777346,119783136,True,1,5790
25210,119786479,119787638,True,1,1159
25211,119786479,119791954,True,2,5475
25212,119791544,119818139,False,1,26595
25213,119808161,119812728,True,1,4567
25214,119808161,119812870,True,1,4709
25215,119861616,119864593,True,1,2977
25216,119878805,119879578,True,2,773
25217,119879213,119881990,True,1,2777
25218,119880572,119882843,True,3,2271
25219,119887814,119887919,True,2,105
25220,119891512,119895839,True,1,4327
25221,119902471,119902866,True,1,395
25222,119902471,119904557,True,1,2086
25223,119902471,119904589,True,1,2118
25224,119902471,119904607,True,1,2136
25225,119903120,119904715,True,1,1595
25226,119907736,119910276,True,1,2540
25227,119908457,119915645,True,1,7188
25228,119911380,119916150,True,2,4770
25229,119943817,119949146,True,1,5329
25230,119961166,119961247,False,1,81
25231,119961166,119961247,True,1,81
25232,119961166,119962603,False,1,1437
25233,119961372,119962609,True,2,1237
25234,119962767,120001094,True,1,38327
25235,119979837,120038751,True,2,58914
25236,119985179,120007918,True,5,22739
25237,120043926,120044241,True,1,315
25238,120051096,120052708,False,1,1612
25239,120057925,120065736,True,1,7811
25240,120085546,120090023,False,1,4477
25241,120096202,120098078,True,1,1876
25242,120096202,120107709,True,2,11507
25243,120098275,120100949,True,4,2674
25244,120126198,120132474,True,4,6276
25245,120149024,120393093,True,1,244069
25246,120166368,120181668,True,3,15300
25247,120176381,120194687,True,1,18306
25248,120189723,120215834,True,2,26111
25249,120204869,120207566,True,1,2697
25250,120290310,120290880,False,1,570
25251,120290310,120290880,True,2,570
25252,120290989,120463807,False,1,172818
25253,120292046,120296557,True,2,4511
25254,120292094,120296557,True,3,4463
25255,120292094,120316340,True,1,24246
25256,120327675,120328809,True,8,1134
25257,120340168,120352923,False,1,12755
25258,120340168,120352923,True,3,12755
25259,120349861,120493433,True,1,143572
25260,120382253,120397569,False,1,15316
25261,120382253,120397569,True,1,15316
25262,120394361,120395328,True,1,967
25263,120398729,120399803,True,1,1074
25264,120446699,120451824,True,1,5125
25265,120446699,120452937,True,1,6238
25266,120446699,120453111,True,4,6412
25267,120455462,120457825,True,1,2363
25268,120477175,120478187,False,1,1012
25269,120480700,120564691,False,1,83991
25270,120480700,120588041,True,4,107341
25271,120482164,120609905,True,1,127741
25272,120482288,120635850,False,1,153562
25273,120498166,120500714,True,1,2548
25274,120520551,120520641,True,1,90
25275,120520551,120525034,True,2,4483
25276,120545996,120653516,True,1,107520
25277,120560944,120561168,True,1,224
25278,120561384,120568060,True,1,6676
25279,120561866,120568371,False,1,6505
25280,120564693,120569831,True,1,5138
25281,120565965,120566325,True,3,360
25282,120587003,120587245,False,1,242
25283,120593262,120593524,True,1,262
25284,120593262,120614373,False,1,21111
25285,120685055,120686035,False,1,980
25286,120691105,120691817,True,1,712
25287,120696678,120697156,True,2,478
25288,120718480,120725614,True,1,7134
25289,120766548,120771715,False,2,5167
25290,120767163,120879937,True,1,112774
25291,120773031,120781057,False,1,8026
25292,120871057,120888748,True,1,17691
25293,120895261,120898751,True,1,3490
25294,120909561,120910448,False,1,887
25295,120909561,120910448,True,1,887
25296,120911328,120918102,True,2,6774
25297,120915887,120918235,True,1,2348
25298,120934294,120935377,True,2,1083
25299,120934294,120937545,True,1,3251
25300,121002196,121005525,False,1,3329
25301,121002618,121002823,True,1,205
25302,121002920,121004907,True,1,1987
25303,121048870,121055516,False,1,6646
25304,121048870,121055516,True,2,6646
25305,121048870,121059377,True,1,10507
25306,121072144,121094501,True,1,22357
25307,121101244,121122457,True,1,21213
25308,121105714,121110605,True,1,4891
25309,121106618,121109341,True,1,2723
25310,121113036,121114865,True,2,1829
25311,121113036,121114868,True,1,1832
25312,121117040,121156605,True,1,39565
25313,121117765,121140044,True,2,22279
25314,121170456,121172958,False,1,2502
25315,121173876,121181937,False,1,8061
25316,121174941,121182489,False,2,7548
25317,121174941,121204249,False,1,29308
25318,121219783,121224823,True,1,5040
25319,121223230,121227568,True,2,4338
25320,121239601,121241737,True,1,2136
25321,121256874,121396605,True,1,139731
25322,121270244,121271630,True,1,1386
25323,121276601,121276672,True,1,71
25324,121279237,121280621,False,1,1384
25325,121279237,121280621,True,4,1384
25326,121295823,121296969,True,1,1146
25327,121316754,121323335,True,1,6581
25328,121358102,121365964,True,1,7862
25329,121358102,121366116,True,2,8014
25330,121358102,121367716,True,1,9614
25331,121363110,121368526,True,1,5416
25332,121373887,121380193,True,2,6306
25333,121373887,121457432,True,1,83545
25334,121384117,121386586,True,2,2469
25335,121389410,121389631,True,2,221
25336,121395365,121397187,True,3,1822
25337,121396471,121397863,True,1,1392
25338,121399508,121401030,True,1,1522
25339,121409399,121409894,True,2,495
25340,121410042,121446668,True,1,36626
25341,121416432,121419105,False,1,2673
25342,121423787,121424200,True,1,413
25343,121425233,121456190,True,1,30957
25344,121425233,121461869,True,1,36636
25345,121427768,121432433,True,2,4665
25346,121432360,121433061,True,1,701
25347,121432360,121465365,True,1,33005
25348,121437766,121448156,False,1,10390
25349,121437766,121452547,False,1,14781
25350,121437766,121452547,True,2,14781
25351,121437828,121440218,False,1,2390
25352,121464776,121471077,True,1,6301
25353,121473109,121474279,False,1,1170
25354,121478498,121513156,False,1,34658
25355,121478498,121513156,True,6,34658
25356,121489276,121490493,True,1,1217
25357,121491784,121493001,True,1,1217
25358,121507635,121508371,False,1,736
25359,121516193,121526550,True,3,10357
25360,121516193,121528936,True,3,12743
25361,121516312,121516412,True,1,100
25362,121518116,121518233,True,1,117
25363,121538076,121542120,True,1,4044
25364,121542976,121552100,False,1,9124
25365,121557793,121561572,True,3,3779
25366,121565250,121570898,True,1,5648
25367,121567396,121568357,False,1,961
25368,121567396,121586953,False,1,19557
25369,121570300,121572571,True,5,2271
25370,121580896,121581498,True,3,602
25371,121581998,121583561,True,1,1563
25372,121586570,121775891,True,2,189321
25373,121616054,121617075,False,1,1021
25374,121627232,121644690,True,3,17458
25375,121708574,121710281,True,1,1707
25376,121740016,121752455,True,1,12439
25377,121756127,121756648,True,1,521
25378,121756131,121756648,True,2,517
25379,121761737,121762063,False,1,326
25380,121768651,121768890,True,2,239
25381,121797738,121798452,True,1,714
25382,121800517,121801214,True,1,697
25383,121806438,121811463,True,2,5025
25384,121841400,121842850,True,1,1450
25385,121867308,121872787,True,1,5479
25386,121873066,121902859,True,1,29793
25387,121873066,121930409,True,1,57343
25388,121874604,121931288,True,1,56684
25389,121910323,121913532,False,1,3209
25390,121918354,121922566,False,1,4212
25391,121918354,121932432,False,1,14078
25392,121924312,121924495,True,3,183
25393,121929852,121929988,True,1,136
25394,121941734,121984410,True,3,42676
25395,121942075,121942560,True,1,485
25396,121942965,121985246,True,1,42281
25397,121952625,121953737,True,1,1112
25398,121966871,121970654,True,1,3783
25399,121966994,121970631,True,1,3637
25400,121971344,121972970,True,1,1626
25401,121971371,121971591,True,1,220
25402,121974698,121976142,True,1,1444
25403,121979748,121980233,True,1,485
25404,121994104,121997458,True,2,3354
25405,122013385,122017221,True,4,3836
25406,122016401,122022002,True,1,5601
25407,122017397,122017882,True,1,485
25408,122018159,122018838,True,1,679
25409,122022364,122023485,True,1,1121
25410,122027679,122035668,True,1,7989
25411,122052541,122057714,False,1,5173
25412,122052541,122057714,True,1,5173
25413,122058189,122059818,False,1,1629
25414,122078599,122078946,True,1,347
25415,122114733,122117064,True,1,2331
25416,122128060,122130047,True,2,1987
25417,122128752,122130739,True,1,1987
25418,122134609,122135197,True,1,588
25419,122139559,122139780,True,2,221
25420,122151263,122158801,False,1,7538
25421,122163737,122164581,False,1,844
25422,122167071,122167168,True,1,97
25423,122173884,122238199,True,1,64315
25424,122178235,122178832,True,1,597
25425,122201454,122202743,True,1,1289
25426,122203966,122222729,True,1,18763
25427,122211014,122211948,True,1,934
25428,122217736,122227567,True,2,9831
25429,122224711,122226762,True,1,2051
25430,122234113,122234680,False,1,567
25431,122234113,122234680,True,3,567
25432,122241611,122241831,True,1,220
25433,122242107,122255835,True,1,13728
25434,122252444,122253957,False,1,1513
25435,122259364,122261194,False,1,1830
25436,122259364,122261194,True,2,1830
25437,122283407,122283862,False,1,455
25438,122285818,122286785,True,1,967
25439,122288421,122295796,True,2,7375
25440,122295904,122298329,True,1,2425
25441,122319968,122320532,True,2,564
25442,122320015,122320565,True,1,550
25443,122337115,122339689,True,3,2574
25444,122342295,122348527,True,3,6232
25445,122355988,122369626,True,1,13638
25446,122357176,122362731,True,1,5555
25447,122367567,122370995,True,1,3428
25448,122369414,122371164,True,1,1750
25449,122377499,122385071,True,1,7572
25450,122395250,122402691,True,1,7441
25451,122403127,122464391,True,3,61264
25452,122446952,122448975,True,2,2023
25453,122475005,122475880,False,2,875
25454,122489446,122489525,False,1,79
25455,122489797,122503363,True,1,13566
25456,122489816,122490152,False,1,336
25457,122489816,122493013,False,1,3197
25458,122497272,122497836,True,2,564
25459,122509217,122510416,True,5,1199
25460,122542851,122549481,True,1,6630
25461,122547701,122561505,True,1,13804
25462,122567390,122571732,True,2,4342
25463,122586167,122588987,True,3,2820
25464,122586955,122589344,True,1,2389
25465,122589217,122590652,False,1,1435
25466,122598358,122598923,True,1,565
25467,122609849,122610909,True,2,1060
25468,122609849,122628555,True,1,18706
25469,122611353,122615296,True,1,3943
25470,122629428,122633502,False,1,4074
25471,122633578,122636682,False,1,3104
25472,122645725,122646493,True,1,768
25473,122645725,122646932,True,1,1207
25474,122652333,122653604,True,1,1271
25475,122655213,122655407,True,1,194
25476,122681461,122726223,True,1,44762
25477,122712052,122720328,False,1,8276
25478,122739806,122740632,False,1,826
25479,122740324,122742577,True,1,2253
25480,122740324,122747495,True,2,7171
25481,122744573,122757237,False,1,12664
25482,122744573,122762217,True,1,17644
25483,122754996,122755968,True,1,972
25484,122755007,122755979,True,1,972
25485,122755007,122767639,True,1,12632
25486,122765107,122774962,True,1,9855
25487,122779372,122779603,True,1,231
25488,122810071,122810666,True,1,595
25489,122810860,122813007,True,1,2147
25490,122811393,122812137,False,2,744
25491,122812218,122812765,False,1,547
25492,122823229,122823952,True,1,723
25493,122830433,122830632,True,2,199
25494,122840634,122869867,True,1,29233
25495,122855827,122856264,True,1,437
25496,122859280,122900877,True,1,41597
25497,122859280,122914071,True,1,54791
25498,122864409,122865343,True,1,934
25499,122864894,122889220,True,1,24326
25500,122872558,122875063,True,1,2505
25501,122872558,122875068,True,1,2510
25502,122876914,122878172,True,1,1258
25503,122880078,122880357,True,1,279
25504,122885558,122892195,True,2,6637
25505,122890069,122894597,True,1,4528
25506,122895880,122935486,True,1,39606
25507,122895931,122897055,False,1,1124
25508,122895931,122897055,True,2,1124
25509,122896348,122897167,False,2,819
25510,122896373,122897188,True,1,815
25511,122896907,122897330,True,1,423
25512,122908277,122909702,True,1,1425
25513,122932113,122932662,True,1,549
25514,122933573,122939770,True,1,6197
25515,122935654,122936203,True,1,549
25516,122945915,122957832,True,2,11917
25517,122967085,122968211,True,1,1126
25518,122982506,123005673,False,1,23167
25519,122993725,122994962,False,2,1237
25520,123021619,123022109,True,7,490
25521,123021619,123022711,True,1,1092
25522,123022855,123031399,True,2,8544
25523,123040382,123053215,True,1,12833
25524,123041073,123041903,True,2,830
25525,123043417,123044605,True,1,1188
25526,123045774,123055955,True,1,10181
25527,123073310,123073594,True,1,284
25528,123073801,123074846,True,3,1045
25529,123086245,123096764,True,1,10519
25530,123090394,123090927,True,1,533
25531,123095252,123095964,True,1,712
25532,123095288,123281792,False,1,186504
25533,123095288,123281792,True,2,186504
25534,123096469,123101798,True,2,5329
25535,123101374,123102734,True,1,1360
25536,123109125,123109711,True,5,586
25537,123109942,123112008,True,1,2066
25538,123109942,123113606,True,1,3664
25539,123113308,123113856,True,1,548
25540,123120608,123122919,True,1,2311
25541,123124536,123124801,True,1,265
25542,123124604,123124772,False,1,168
25543,123124604,123124772,True,3,168
25544,123128777,123129283,True,2,506
25545,123137030,123137367,True,2,337
25546,123139045,123142281,True,1,3236
25547,123142380,123143296,True,1,916
25548,123150467,123157927,True,1,7460
25549,123165647,123167423,True,1,1776
25550,123167625,123188975,True,1,21350
25551,123168043,123189123,True,1,21080
25552,123168239,123168559,True,1,320
25553,123168239,123172113,True,1,3874
25554,123169099,123172590,True,1,3491
25555,123182964,123245139,True,1,62175
25556,123191781,123200960,True,2,9179
25557,123201544,123202192,True,5,648
25558,123204351,123206122,True,1,1771
25559,123204351,123244943,True,3,40592
25560,123233221,123237173,True,1,3952
25561,123254982,123273004,True,1,18022
25562,123255971,123283624,False,1,27653
25563,123255971,123283624,True,1,27653
25564,123255971,123290366,True,1,34395
25565,123274666,123282793,True,2,8127
25566,123274666,123284295,True,1,9629
25567,123274683,123282793,True,1,8110
25568,123281559,123352076,False,1,70517
25569,123282334,123284318,True,1,1984
25570,123287868,123289765,True,1,1897
25571,123308672,123564113,True,1,255441
25572,123309473,123347374,True,1,37901
25573,123330599,123331551,True,2,952
25574,123331588,123332201,False,1,613
25575,123338899,123349568,False,1,10669
25576,123356952,123360122,True,1,3170
25577,123369229,123371051,True,1,1822
25578,123373919,123375286,True,1,1367
25579,123377455,123378418,True,1,963
25580,123399571,123399849,True,1,278
25581,123399923,123409839,True,5,9916
25582,123411169,123413386,True,5,2217
25583,123417328,123441671,True,1,24343
25584,123429664,123447809,True,1,18145
25585,123434268,123434509,False,1,241
25586,123435254,123436596,False,1,1342
25587,123435254,123436596,True,2,1342
25588,123435254,123439932,True,7,4678
25589,123437700,123438581,False,1,881
25590,123445251,123445391,True,1,140
25591,123445562,123445891,True,1,329
25592,123454109,123454231,False,1,122
25593,123454379,123460309,False,1,5930
25594,123458005,123461509,True,1,3504
25595,123464119,123464213,True,1,94
25596,123467249,123467548,False,1,299
25597,123494878,123512308,True,2,17430
25598,123521200,123583329,True,1,62129
25599,123542793,123565941,False,1,23148
25600,123543691,123558989,False,1,15298
25601,123549319,123549405,True,2,86
25602,123561302,123561554,True,6,252
25603,123562133,123564184,True,1,2051
25604,123562462,123564187,True,1,1725
25605,123575639,123588483,True,7,12844
25606,123577696,123646455,True,1,68759
25607,123601409,123602750,False,1,1341
25608,123646930,123651907,True,2,4977
25609,123654867,123660418,True,2,5551
25610,123655459,123668021,False,1,12562
25611,123658596,123658807,True,1,211
25612,123672303,123676420,False,1,4117
25613,123680643,123682638,True,1,1995
25614,123688284,123688609,True,1,325
25615,123703302,123704032,True,1,730
25616,123703302,123715958,True,1,12656
25617,123735072,123736528,True,3,1456
25618,123739693,123745167,True,1,5474
25619,123739701,123741979,True,1,2278
25620,123744632,123777354,False,1,32722
25621,123744993,123746024,True,1,1031
25622,123749323,123749787,True,1,464
25623,123749323,123761963,True,1,12640
25624,123757116,123758154,True,1,1038
25625,123757695,123758809,True,1,1114
25626,123762598,123805768,False,1,43170
25627,123766881,123767949,True,1,1068
25628,123778208,123779226,True,1,1018
25629,123781512,123787314,False,1,5802
25630,123783079,123787065,True,4,3986
25631,123785933,123787126,True,1,1193
25632,123794146,123794229,True,2,83
25633,123797566,123825301,True,1,27735
25634,123808436,123811091,True,5,2655
25635,123809643,123810265,True,2,622
25636,123810326,123810539,True,1,213
25637,123819791,123819867,True,3,76
25638,123832239,123832969,False,1,730
25639,123849164,123850985,True,1,1821
25640,123869158,123871037,False,1,1879
25641,123874776,123876204,True,1,1428
25642,123887847,123896102,True,1,8255
25643,123899054,123899306,True,1,252
25644,123899054,123899908,True,1,854
25645,123899472,123899564,True,1,92
25646,123915449,123915701,True,2,252
25647,123915449,123915705,True,1,256
25648,123915520,123917235,True,1,1715
25649,123915867,123915958,True,1,91
25650,123944846,123945098,True,1,252
25651,123952397,123954022,True,1,1625
25652,123952876,123955664,True,4,2788
25653,123956017,123958805,True,1,2788
25654,123971917,123972976,True,2,1059
25655,123974232,123974484,True,5,252
25656,123974927,123975019,True,1,92
25657,123989395,123989786,True,1,391
25658,123989428,123989680,True,3,252
25659,123989428,123990266,True,1,838
25660,123989428,123990687,True,1,1259
25661,124012781,124012889,True,3,108
25662,124019557,124020482,True,1,925
25663,124021471,124024538,False,1,3067
25664,124035266,124036097,True,1,831
25665,124059738,124059815,False,1,77
25666,124074735,124154935,False,1,80200
25667,124075372,124075980,False,1,608
25668,124075372,124075980,True,1,608
25669,124076269,124077305,True,4,1036
25670,124105716,124106219,True,3,503
25671,124108631,124117381,False,1,8750
25672,124110845,124115004,True,1,4159
25673,124126388,124129698,True,1,3310
25674,124127644,124128695,True,1,1051
25675,124130287,124135007,True,1,4720
25676,124134456,124315813,True,2,181357
25677,124151494,124151775,True,3,281
25678,124151494,124151796,True,1,302
25679,124151494,124152036,True,1,542
25680,124151956,124152140,True,1,184
25681,124160239,124160956,True,5,717
25682,124164347,124165603,True,1,1256
25683,124191102,124191834,True,4,732
25684,124206226,124216494,False,1,10268
25685,124206226,124249429,False,1,43203
25686,124206226,124249429,True,2,43203
25687,124209819,124210133,True,1,314
25688,124209819,124210210,True,2,391
25689,124239142,124239633,True,1,491
25690,124241949,124242607,True,1,658
25691,124249074,124273725,False,1,24651
25692,124265795,124360636,True,1,94841
25693,124291346,124291657,True,2,311
25694,124293740,124295805,True,1,2065
25695,124304379,124304767,True,1,388
25696,124316650,124317360,True,2,710
25697,124320851,124321204,True,2,353
25698,124321692,124322205,True,1,513
25699,124324675,124349213,True,1,24538
25700,124324675,124349216,True,3,24541
25701,124324675,124350343,True,1,25668
25702,124329011,124351434,True,1,22423
25703,124332010,124334034,True,1,2024
25704,124344514,124344704,True,1,190
25705,124368826,124371377,True,1,2551
25706,124373128,124376197,True,1,3069
25707,124380161,124380717,True,2,556
25708,124398430,124400030,True,1,1600
25709,124401221,124412758,True,2,11537
25710,124401221,124489686,False,1,88465
25711,124402376,124460215,True,1,57839
25712,124403457,124403529,True,1,72
25713,124406807,124407779,True,1,972
25714,124416375,124436676,True,3,20301
25715,124441036,124442327,True,3,1291
25716,124451245,124452993,True,3,1748
25717,124458380,124462666,True,1,4286
25718,124474400,124477978,True,1,3578
25719,124497310,124525780,False,1,28470
25720,124497310,124527866,True,2,30556
25721,124497310,124550272,False,1,52962
25722,124542315,124545263,False,1,2948
25723,124543807,124544516,False,1,709
25724,124543807,124544516,True,2,709
25725,124578981,124579746,False,2,765
25726,124578981,124579746,True,2,765
25727,124579478,124580250,True,1,772
25728,124579478,124582315,True,1,2837
25729,124584919,124585846,True,1,927
25730,124594104,124614421,False,1,20317
25731,124609440,124610104,True,1,664
25732,124609624,124610111,True,1,487
25733,124610902,124611528,True,1,626
25734,124642665,124642747,True,1,82
25735,124652420,124652510,True,1,90
25736,124654381,124654611,True,2,230
25737,124655674,124655809,True,1,135
25738,124661876,124661946,False,5,70
25739,124661876,124661946,True,5,70
25740,124662048,124663174,True,3,1126
25741,124662048,124663480,True,1,1432
25742,124677704,124678696,True,1,992
25743,124678849,124679282,True,1,433
25744,124678900,124679282,True,1,382
25745,124678919,124679282,True,2,363
25746,124678919,124705965,True,1,27046
25747,124680420,124704473,False,1,24053
25748,124686232,124686643,True,1,411
25749,124705779,124705902,False,1,123
25750,124711363,124712236,True,2,873
25751,124718462,124718957,True,1,495
25752,124722186,124722403,True,2,217
25753,124725904,124815781,True,1,89877
25754,124734590,124735936,True,1,1346
25755,124735196,124736016,True,1,820
25756,124739840,124739919,True,5,79
25757,124742601,124742938,True,1,337
25758,124743542,124744379,True,1,837
25759,124745295,124745683,True,1,388
25760,124745295,124745944,True,1,649
25761,124747220,124747962,True,1,742
25762,124751908,124752368,False,1,460
25763,124753674,124759057,True,1,5383
25764,124761555,124761940,True,1,385
25765,124766038,124766743,False,1,705
25766,124766038,124766743,True,2,705
25767,124767250,124767514,True,1,264
25768,124769280,124772774,True,6,3494
25769,124780829,124796962,True,1,16133
25770,124785693,124785832,True,5,139
25771,124797981,124803834,False,1,5853
25772,124829182,124843199,True,2,14017
25773,124831790,124834959,True,1,3169
25774,124836008,124873763,True,2,37755
25775,124846751,124872606,True,1,25855
25776,124860919,124860994,True,1,75
25777,124865582,124865895,True,2,313
25778,124866536,124866942,True,1,406
25779,124869905,124871797,True,1,1892
25780,124878151,124894877,True,1,16726
25781,124878462,124878548,True,1,86
25782,124878949,124891542,False,1,12593
25783,124888082,124888254,True,1,172
25784,124888448,124888959,True,1,511
25785,124889275,124889368,True,1,93
25786,124889588,124889681,True,1,93
25787,124891269,124891354,True,1,85
25788,124907957,124916394,True,1,8437
25789,124909858,124910770,True,1,912
25790,124912959,124913128,True,1,169
25791,124915726,124915815,False,1,89
25792,124915726,124915815,True,5,89
25793,124923226,124924125,True,2,899
25794,124925800,124998859,True,1,73059
25795,124948006,124950305,True,2,2299
25796,124950452,124950830,True,1,378
25797,124950741,124955027,True,1,4286
25798,124962947,124963066,True,1,119
25799,124963695,124968621,True,1,4926
25800,124990817,124991038,True,4,221
25801,124991791,124991876,True,1,85
25802,124992509,124998803,True,1,6294
25803,124993317,124997227,True,11,3910
25804,124993317,124997296,True,1,3979
25805,124997059,124997434,True,1,375
25806,125006391,125007865,False,1,1474
25807,125006391,125007865,True,2,1474
25808,125039621,125039868,True,1,247
25809,125053130,125086140,True,1,33010
25810,125058082,125058189,True,1,107
25811,125058142,125058275,True,1,133
25812,125069871,125069957,False,1,86
25813,125075107,125082508,True,7,7401
25814,125076305,125077985,True,1,1680
25815,125076539,125078108,False,1,1569
25816,125076539,125078108,True,3,1569
25817,125076716,125078187,True,1,1471
25818,125076759,125077131,True,1,372
25819,125077736,125082015,True,3,4279
25820,125082799,125083113,True,3,314
25821,125092203,125093607,True,1,1404
25822,125102495,125110494,False,1,7999
25823,125109872,125111366,True,1,1494
25824,125116173,125116935,True,1,762
25825,125119583,125119708,True,2,125
25826,125123641,125124134,True,1,493
25827,125133968,125134574,True,1,606
25828,125142589,125142682,False,1,93
25829,125142589,125142682,True,2,93
25830,125144698,125144789,False,1,91
25831,125149431,125165967,True,2,16536
25832,125149469,125165967,True,1,16498
25833,125153541,125156167,True,2,2626
25834,125168380,125169481,False,1,1101
25835,125172564,125172594,False,1,30
25836,125176696,125181343,True,1,4647
25837,125179548,125180716,True,1,1168
25838,125197743,125277996,True,1,80253
25839,125200985,125201470,True,2,485
25840,125200985,125201644,True,1,659
25841,125206041,125206159,True,1,118
25842,125212350,125212508,False,1,158
25843,125212350,125212508,True,1,158
25844,125225099,125226828,True,2,1729
25845,125239612,125239740,False,4,128
25846,125247336,125261698,True,1,14362
25847,125247336,125262530,True,1,15194
25848,125247336,125271972,True,1,24636
25849,125260606,125261138,True,5,532
25850,125260606,125263907,True,1,3301
25851,125272564,125282092,False,1,9528
25852,125295299,125298680,False,2,3381
25853,125297262,125297706,True,1,444
25854,125300818,125302274,False,1,1456
25855,125308404,125342078,True,5,33674
25856,125321066,125322578,True,2,1512
25857,125333096,125333184,False,2,88
25858,125337044,125337462,False,1,418
25859,125339828,125340187,True,1,359
25860,125345981,125350106,False,1,4125
25861,125354800,125364838,True,1,10038
25862,125359393,125359588,True,1,195
25863,125376404,125376497,False,1,93
25864,125377442,125382219,True,1,4777
25865,125388746,125391836,True,1,3090
25866,125395719,125396094,True,1,375
25867,125405889,125414978,True,4,9089
25868,125409931,125410029,True,3,98
25869,125423175,125434787,True,1,11612
25870,125423175,125435509,True,1,12334
25871,125429790,125429901,True,1,111
25872,125432869,125434224,True,1,1355
25873,125448331,125453193,True,1,4862
25874,125455977,125456925,True,1,948
25875,125457446,125457585,True,2,139
25876,125488421,125488683,True,2,262
25877,125488421,125488722,True,2,301
25878,125491905,125492489,False,1,584
25879,125504870,125510311,True,1,5441
25880,125517300,125519039,False,1,1739
25881,125517300,125519039,True,1,1739
25882,125520249,125523016,True,1,2767
25883,125521103,125521189,True,4,86
25884,125521395,125521536,True,1,141
25885,125550385,125550567,False,1,182
25886,125550579,125550715,True,1,136
25887,125550740,125575833,True,1,25093
25888,125562443,125563641,True,1,1198
25889,125566406,125604557,True,1,38151
25890,125591918,125617240,True,1,25322
25891,125593152,125597063,False,1,3911
25892,125619373,125621422,False,1,2049
25893,125678364,125678455,False,1,91
25894,125678786,125681503,True,1,2717
25895,125694883,125695801,True,1,918
25896,125701249,125702443,True,4,1194
25897,125712650,125714557,True,1,1907
25898,125712650,125714575,True,8,1925
25899,125712650,125720137,True,2,7487
25900,125712650,125737761,True,2,25111
25901,125712650,125741356,True,2,28706
25902,125712650,125744204,True,1,31554
25903,125712650,125746324,True,1,33674
25904,125712936,125718705,True,6,5769
25905,125713610,125715659,False,1,2049
25906,125718153,125744814,True,1,26661
25907,125721694,125725075,True,1,3381
25908,125721694,125738544,True,4,16850
25909,125721694,125753293,True,1,31599
25910,125727787,125739231,True,1,11444
25911,125772797,125772896,True,1,99
25912,125774270,125778340,True,2,4070
25913,125790822,125797408,True,1,6586
25914,125802203,125835015,True,1,32812
25915,125804112,125807442,True,1,3330
25916,125804207,125807442,True,1,3235
25917,125805453,125807850,True,1,2397
25918,125841523,125843603,True,5,2080
25919,125843824,125847979,False,1,4155
25920,125844001,125856313,False,1,12312
25921,125846584,125862859,True,1,16275
25922,125860187,125861727,False,2,1540
25923,125862840,125863291,False,2,451
25924,125862840,125863291,True,1,451
25925,125865717,125866876,True,2,1159
25926,125866187,125867030,True,2,843
25927,125868461,125908559,True,2,40098
25928,125869047,125881645,True,1,12598
25929,125872325,125873812,False,2,1487
25930,125879154,125881790,True,1,2636
25931,125879411,125880529,True,1,1118
25932,125908582,125912704,True,1,4122
25933,125927166,125931317,False,4,4151
25934,126016353,126019775,True,2,3422
25935,126065611,126073191,True,1,7580
25936,126080178,126098718,True,1,18540
25937,126100324,126101951,True,1,1627
25938,126101646,126104666,True,1,3020
25939,126114864,126115119,False,1,255
25940,126115468,126116439,True,1,971
25941,126115788,126116759,True,1,971
25942,126126889,126127522,True,1,633
25943,126176842,126180344,False,1,3502
25944,126225493,126238385,True,1,12892
25945,126251307,126251602,False,1,295
25946,126267170,126282993,True,4,15823
25947,126275190,126275865,False,1,675
25948,126275190,126275865,True,1,675
25949,126323186,126653596,True,1,330410
25950,126336904,126339615,True,1,2711
25951,126339710,126342421,False,1,2711
25952,126345406,126345865,False,1,459
25953,126349117,126420388,True,1,71271
25954,126349117,126442989,True,1,93872
25955,126358391,126425401,True,1,67010
25956,126370254,126371112,True,1,858
25957,126425443,126439650,False,1,14207
25958,126459942,126462455,False,1,2513
25959,126459942,126462455,True,2,2513
25960,126459942,126462505,True,1,2563
25961,126499672,126519164,True,1,19492
25962,126499720,126519164,True,1,19444
25963,126528140,126528264,False,2,124
25964,126528140,126528264,True,1,124
25965,126543677,126544269,True,2,592
25966,126547522,126549546,True,3,2024
25967,126551571,126551706,True,2,135
25968,126551571,126551713,True,1,142
25969,126554478,126555573,True,1,1095
25970,126555968,126556318,True,2,350
25971,126608621,126611258,True,1,2637
25972,126640778,126646103,True,1,5325
25973,126669979,126670740,True,3,761
25974,126669979,126671061,True,4,1082
25975,126670150,126670911,True,1,761
25976,126670150,126671232,True,1,1082
25977,126680786,126680930,True,1,144
25978,126681541,126689817,True,5,8276
25979,126684461,126699513,True,3,15052
25980,126697725,126728581,False,2,30856
25981,126697725,126728581,True,3,30856
25982,126722616,126726188,False,1,3572
25983,126793313,126794946,True,3,1633
25984,126818260,126830444,True,1,12184
25985,126818712,126821658,False,1,2946
25986,126828425,126828831,True,2,406
25987,126833807,126864118,True,1,30311
25988,126835103,126847368,True,1,12265
25989,126836542,126848037,True,2,11495
25990,126845641,126863617,True,1,17976
25991,126853233,126865269,True,1,12036
25992,126857897,126859970,True,1,2073
25993,126857897,126895258,False,1,37361
25994,126857897,126895258,True,1,37361
25995,126888419,126888777,True,3,358
25996,126891797,126893356,False,1,1559
25997,126891797,126893356,True,1,1559
25998,126898171,126921242,True,2,23071
25999,126898171,126935093,True,1,36922
26000,126898171,126935372,True,1,37201
26001,126898171,126966382,False,2,68211
26002,126898171,126966382,True,3,68211
26003,126923450,126958303,True,3,34853
26004,126963674,127018680,True,2,55006
26005,126972177,126972962,False,1,785
26006,126976883,126978785,True,1,1902
26007,127011822,127035087,True,1,23265
26008,127050902,127054710,True,2,3808
26009,127058704,127058871,True,1,167
26010,127058704,127060640,True,1,1936
26011,127068680,127071790,True,1,3110
26012,127077963,127080183,True,1,2220
26013,127108777,127109993,True,1,1216
26014,127139683,127140236,True,1,553
26015,127139683,127141106,True,2,1423
26016,127162207,127166197,True,1,3990
26017,127192550,127201476,True,1,8926
26018,127213431,127269028,True,4,55597
26019,127234285,127235075,True,3,790
26020,127249694,127250583,False,1,889
26021,127262635,127291720,True,1,29085
26022,127263749,127264897,True,4,1148
26023,127264120,127265268,True,1,1148
26024,127276816,127278779,True,1,1963
26025,127312422,127313678,True,1,1256
26026,127312422,127318615,True,1,6193
26027,127322501,127322928,True,2,427
26028,127325440,127325680,True,1,240
26029,127335199,127341048,True,1,5849
26030,127342866,127406927,True,1,64061
26031,127358343,127358467,True,1,124
26032,127377881,127398255,True,1,20374
26033,127413015,127419751,True,2,6736
26034,127413814,127420118,True,1,6304
26035,127440475,127441606,False,1,1131
26036,127484344,127485773,True,1,1429
26037,127507310,127509131,True,2,1821
26038,127507818,127509639,True,1,1821
26039,127508823,127510120,True,1,1297
26040,127532188,127532337,True,1,149
26041,127546414,127547434,True,1,1020
26042,127559378,127563907,True,1,4529
26043,127593738,127617920,True,1,24182
26044,127593738,127621553,False,1,27815
26045,127593738,127621553,True,3,27815
26046,127593738,127651801,True,1,58063
26047,127604389,127605309,True,1,920
26048,127610312,127613964,True,1,3652
26049,127618211,127619614,True,1,1403
26050,127631922,127637362,True,1,5440
26051,127632802,127637904,True,2,5102
26052,127639420,127640373,True,2,953
26053,127649610,127653926,True,1,4316
26054,127658578,127663475,True,1,4897
26055,127666618,127669700,True,1,3082
26056,127684180,127690126,True,4,5946
26057,127684180,127690141,True,1,5961
26058,127697648,127699933,False,1,2285
26059,127700907,127709655,False,1,8748
26060,127700907,127734305,True,2,33398
26061,127743014,127755050,True,1,12036
26062,127743207,127762011,True,3,18804
26063,127753818,127754411,True,1,593
26064,127761207,127765854,False,1,4647
26065,127761207,127766800,False,1,5593
26066,127768247,127782336,True,1,14089
26067,127779495,127780902,True,1,1407
26068,127779495,127783044,True,1,3549
26069,127802281,127805264,True,1,2983
26070,127813214,127818915,False,1,5701
26071,127813214,127818915,True,2,5701
26072,127838590,127924232,True,1,85642
26073,127838756,127839160,True,1,404
26074,127855650,127857688,True,1,2038
26075,127886939,127900833,True,1,13894
26076,127907070,127919008,True,2,11938
26077,127907134,127915694,True,2,8560
26078,127907328,127914134,True,3,6806
26079,127911154,127912463,True,2,1309
26080,127946031,127948810,True,1,2779
26081,127948437,127948972,True,2,535
26082,127963132,127984337,True,1,21205
26083,127971928,127989116,True,1,17188
26084,127972775,127977466,True,1,4691
26085,127975779,127977610,False,1,1831
26086,127976360,127976780,True,1,420
26087,127976860,127979247,True,1,2387
26088,127976980,127981345,True,1,4365
26089,127978317,127980253,True,1,1936
26090,127981441,127985068,False,1,3627
26091,127982709,127982840,True,5,131
26092,127982709,127983025,True,1,316
26093,127987498,127987834,True,2,336
26094,127987644,127987850,True,3,206
26095,127990162,127991741,False,1,1579
26096,127991097,127999062,True,1,7965
26097,127992664,127992776,True,5,112
26098,127995543,127995654,True,1,111
26099,127996315,127997244,True,2,929
26100,127997432,127998807,True,1,1375
26101,127999173,127999261,True,1,88
26102,128004420,128004983,True,2,563
26103,128017016,128018266,True,1,1250
26104,128017313,128018457,True,1,1144
26105,128019272,128019441,True,1,169
26106,128024244,128024350,True,1,106
26107,128034377,128037909,True,1,3532
26108,128037924,128154853,True,1,116929
26109,128038214,128040879,True,2,2665
26110,128038214,128041416,True,1,3202
26111,128070298,128095107,False,1,24809
26112,128075108,128076382,True,2,1274
26113,128088608,128095745,True,1,7137
26114,128089997,128091415,True,1,1418
26115,128103724,128103961,True,1,237
26116,128105016,128106262,True,1,1246
26117,128105136,128106264,True,2,1128
26118,128107476,128134407,False,1,26931
26119,128107934,128108016,True,3,82
26120,128117830,128119204,True,1,1374
26121,128117830,128123140,True,3,5310
26122,128118351,128154040,True,1,35689
26123,128118450,128119605,False,1,1155
26124,128118450,128119605,True,1,1155
26125,128119071,128119893,True,1,822
26126,128119294,128154573,True,1,35279
26127,128120777,128124446,True,1,3669
26128,128121752,128125134,False,1,3382
26129,128128947,128129545,False,1,598
26130,128129769,128135270,True,4,5501
26131,128130447,128155400,True,3,24953
26132,128134720,128134944,True,1,224
26133,128134740,128139551,True,1,4811
26134,128136463,128151535,True,1,15072
26135,128138351,128152451,True,1,14100
26136,128139089,128152956,True,1,13867
26137,128146251,128147681,True,2,1430
26138,128147618,128148336,True,1,718
26139,128162558,128163129,True,1,571
26140,128162571,128163055,False,1,484
26141,128162571,128163055,True,4,484
26142,128163225,128163505,True,1,280
26143,128163231,128163505,True,1,274
26144,128163549,128164181,False,1,632
26145,128165126,128212029,True,1,46903
26146,128168604,128168692,True,1,88
26147,128171417,128172763,True,2,1346
26148,128171417,128173894,True,1,2477
26149,128178317,128183980,True,1,5663
26150,128178325,128179312,False,1,987
26151,128215487,128215766,True,2,279
26152,128220481,128220851,True,1,370
26153,128232826,128233103,True,1,277
26154,128240335,128244294,True,5,3959
26155,128241069,128241178,True,1,109
26156,128241790,128242007,True,1,217
26157,128253173,128255923,True,1,2750
26158,128253173,128266063,True,1,12890
26159,128253386,128253472,True,5,86
26160,128268132,128269853,True,3,1721
26161,128268132,128282068,False,1,13936
26162,128273457,128274601,True,5,1144
26163,128273457,128275640,True,1,2183
26164,128276500,128278062,True,1,1562
26165,128283110,128285973,False,1,2863
26166,128304308,128316219,True,1,11911
26167,128340962,128344653,False,1,3691
26168,128340962,128344653,True,1,3691
26169,128340962,128365503,True,1,24541
26170,128346500,128349187,False,1,2687
26171,128347491,128348379,True,1,888
26172,128348147,128348702,True,1,555
26173,128375956,128376064,False,1,108
26174,128399525,128401797,True,1,2272
26175,128400033,128403339,True,1,3306
26176,128402173,128402307,False,1,134
26177,128416452,128418715,True,1,2263
26178,128433652,128433895,False,1,243
26179,128443525,128443620,True,1,95
26180,128463381,128469372,True,1,5991
26181,128477203,128616265,True,2,139062
26182,128479868,128714664,True,2,234796
26183,128509714,128529200,True,1,19486
26184,128509714,128530059,False,1,20345
26185,128509714,128530059,True,6,20345
26186,128509714,128546592,True,1,36878
26187,128560562,128683706,True,1,123144
26188,128564543,128568258,True,1,3715
26189,128576765,128577132,False,1,367
26190,128595860,128620860,False,1,25000
26191,128598067,128601137,True,2,3070
26192,128624049,128624571,False,1,522
26193,128624049,128624639,False,1,590
26194,128639543,128695496,True,3,55953
26195,128642187,128643042,True,3,855
26196,128646961,128649702,True,2,2741
26197,128646961,128652571,True,1,5610
26198,128659105,128659212,True,1,107
26199,128661308,128670375,False,1,9067
26200,128686033,128696658,True,1,10625
26201,128691779,128702154,True,2,10375
26202,128691779,128702246,True,1,10467
26203,128691779,128735623,True,2,43844
26204,128691779,128739752,True,1,47973
26205,128693112,128702815,True,1,9703
26206,128713131,128746330,True,1,33199
26207,128717300,128717410,True,1,110
26208,128717711,128718530,True,4,819
26209,128721907,128721981,True,1,74
26210,128727374,128741036,False,1,13662
26211,128727416,128741025,True,1,13609
26212,128727416,128741576,True,2,14160
26213,128729987,128732449,True,2,2462
26214,128734252,128747400,True,1,13148
26215,128749199,128761409,True,6,12210
26216,128751760,128783145,True,1,31385
26217,128755507,128761273,True,1,5766
26218,128776453,128792852,True,5,16399
26219,128788524,128802989,False,1,14465
26220,128806264,128808564,False,2,2300
26221,128807224,128818102,False,2,10878
26222,128807224,128829388,False,1,22164
26223,128825088,128828361,False,1,3273
26224,128861568,128866285,True,2,4717
26225,128874743,128876592,True,1,1849
26226,128887964,128888355,False,1,391
26227,128887964,128888355,True,2,391
26228,128887964,128888750,True,1,786
26229,128892334,128911004,False,1,18670
26230,128892334,128911004,True,2,18670
26231,128896357,128896935,True,1,578
26232,128903868,128905710,True,1,1842
26233,128904524,128917649,True,1,13125
26234,128916210,128930476,True,2,14266
26235,128921899,128930260,False,1,8361
26236,128921899,128930260,True,1,8361
26237,128929618,128930963,False,1,1345
26238,128947007,128968657,True,1,21650
26239,128988985,128989148,True,5,163
26240,128997674,129024106,False,2,26432
26241,129004127,129009170,True,2,5043
26242,129014500,129014996,True,1,496
26243,129019065,129019745,True,1,680
26244,129020983,129021373,True,1,390
26245,129028140,129028251,True,2,111
26246,129045629,129052112,True,1,6483
26247,129065065,129065496,True,1,431
26248,129065065,129066445,True,6,1380
26249,129065702,129066445,True,2,743
26250,129072562,129083076,True,1,10514
26251,129078073,129080109,False,1,2036
26252,129081539,129083346,True,1,1807
26253,129085150,129087514,True,1,2364
26254,129087615,129089349,True,1,1734
26255,129094830,129119877,False,1,25047
26256,129102839,129143915,False,1,41076
26257,129113704,129113808,True,2,104
26258,129121011,129134125,False,1,13114
26259,129121675,129124730,False,1,3055
26260,129128561,129140744,False,1,12183
26261,129130694,129133870,False,1,3176
26262,129130981,129134090,True,1,3109
26263,129139364,129139442,True,1,78
26264,129143273,129143489,True,8,216
26265,129143727,129147336,False,1,3609
26266,129145983,129147374,True,5,1391
26267,129174856,129195874,True,1,21018
26268,129183662,129185601,True,1,1939
26269,129201711,129202184,True,1,473
26270,129203388,129214995,True,1,11607
26271,129213449,129214715,True,2,1266
26272,129216299,129216716,False,1,417
26273,129232439,129237768,False,1,5329
26274,129242536,129242999,True,4,463
26275,129250855,129251370,True,1,515
26276,129257783,129258907,True,1,1124
26277,129268569,129269805,True,1,1236
26278,129293720,129296188,False,1,2468
26279,129312745,129315993,True,1,3248
26280,129315484,129326150,True,1,10666
26281,129315484,129330365,True,1,14881
26282,129321830,129325076,True,4,3246
26283,129324684,129324763,True,2,79
26284,129339288,129340809,True,1,1521
26285,129341559,129455684,False,1,114125
26286,129352337,129352699,True,1,362
26287,129360165,129366145,True,1,5980
26288,129362046,129362860,True,2,814
26289,129362514,129362670,True,1,156
26290,129363041,129363802,True,1,761
26291,129364390,129372991,False,1,8601
26292,129365776,129367785,True,1,2009
26293,129384642,129385083,True,1,441
26294,129386318,129387095,True,1,777
26295,129388082,129395436,False,1,7354
26296,129388082,129395436,True,3,7354
26297,129388397,129395436,True,1,7039
26298,129389298,129396221,True,1,6923
26299,129399787,129401432,False,1,1645
26300,129399787,129401432,True,2,1645
26301,129403472,129417866,True,1,14394
26302,129403555,129425629,False,1,22074
26303,129404288,129404403,True,1,115
26304,129411387,129647492,False,1,236105
26305,129411973,129413060,False,1,1087
26306,129411973,129413060,True,2,1087
26307,129417903,129425624,True,1,7721
26308,129465242,129467162,True,4,1920
26309,129467315,129470327,True,1,3012
26310,129503184,129530013,True,3,26829
26311,129505977,129544430,True,1,38453
26312,129512700,129513079,True,1,379
26313,129512700,129517334,True,1,4634
26314,129559119,129573270,True,1,14151
26315,129563328,129567418,True,4,4090
26316,129583983,129706642,True,1,122659
26317,129589897,129594427,True,1,4530
26318,129596736,129601892,True,2,5156
26319,129616752,129617024,False,1,272
26320,129617713,129620070,True,1,2357
26321,129625223,129625586,True,2,363
26322,129625336,129626429,False,1,1093
26323,129626375,129626486,False,1,111
26324,129628052,129630892,True,2,2840
26325,129662602,129704580,True,1,41978
26326,129668231,129668363,False,1,132
26327,129668999,129674343,False,1,5344
26328,129677680,129691580,True,2,13900
26329,129677680,129692484,True,1,14804
26330,129677680,129702019,True,1,24339
26331,129691585,129691749,True,1,164
26332,129691806,129695457,True,1,3651
26333,129703543,129703854,True,2,311
26334,129703544,129703873,True,1,329
26335,129709944,129722267,True,3,12323
26336,129711846,129711996,True,1,150
26337,129718395,129718690,True,1,295
26338,129718395,129722400,True,1,4005
26339,129718395,129724519,True,1,6124
26340,129722763,129739506,True,1,16743
26341,129727536,129728054,False,1,518
26342,129727536,129728054,True,1,518
26343,129728472,129728724,False,1,252
26344,129746993,129748435,True,1,1442
26345,129750183,129750257,True,1,74
26346,129758864,129759310,True,3,446
26347,129759710,129760063,True,1,353
26348,129771635,129772779,True,2,1144
26349,129773281,129775852,True,1,2571
26350,129775230,129824188,True,1,48958
26351,129776376,129776549,True,1,173
26352,129779466,129781626,False,1,2160
26353,129779611,129781687,True,1,2076
26354,129779611,129782673,True,1,3062
26355,129786266,129798973,True,1,12707
26356,129786266,129804914,True,1,18648
26357,129790710,129790783,True,3,73
26358,129796645,129834914,False,1,38269
26359,129832179,129872900,True,1,40721
26360,129841490,129845850,True,1,4360
26361,129841490,129851683,True,4,10193
26362,129854881,129855180,False,1,299
26363,129854881,129855180,True,5,299
26364,129854988,129855312,False,1,324
26365,129864547,129867064,True,1,2517
26366,129873100,129952750,True,1,79650
26367,129874191,129879780,True,1,5589
26368,129875438,129876502,True,1,1064
26369,129897566,129898855,True,1,1289
26370,129898463,129899319,True,1,856
26371,129898787,129899473,True,2,686
26372,129905608,129905800,True,1,192
26373,129908329,129910631,True,2,2302
26374,129922226,129975282,True,1,53056
26375,129927938,129929494,True,1,1556
26376,129941511,129942195,True,1,684
26377,129942955,129959494,True,2,16539
26378,129943766,129987871,True,1,44105
26379,129948143,129948253,True,1,110
26380,129960805,129961053,True,1,248
26381,129962684,129963192,True,1,508
26382,129962684,129965350,False,1,2666
26383,129962684,129965350,True,2,2666
26384,129963034,129963105,True,2,71
26385,130005315,130010183,True,1,4868
26386,130007867,130008033,False,1,166
26387,130008815,130082857,False,1,74042
26388,130008815,130082857,True,1,74042
26389,130033403,130034256,True,1,853
26390,130036263,130072414,True,2,36151
26391,130046024,130101565,True,1,55541
26392,130058886,130077196,True,1,18310
26393,130059273,130063482,True,2,4209
26394,130059273,130064377,True,1,5104
26395,130065223,130071007,True,1,5784
26396,130065293,130065464,True,1,171
26397,130081656,130090761,True,1,9105
26398,130096556,130097077,True,1,521
26399,130106915,130107645,True,1,730
26400,130141255,130149496,False,1,8241
26401,130141255,130149496,True,2,8241
26402,130148009,130148192,False,1,183
26403,130163338,130165544,True,1,2206
26404,130164713,130170301,True,1,5588
26405,130202613,130209078,True,2,6465
26406,130209108,130209496,True,1,388
26407,130216388,130216603,True,4,215
26408,130217820,130221021,True,4,3201
26409,130224877,130225169,True,1,292
26410,130225736,130237368,False,1,11632
26411,130228594,130229760,True,1,1166
26412,130244709,130245543,True,1,834
26413,130260727,130261096,True,1,369
26414,130260767,130262086,True,1,1319
26415,130268308,130274871,True,1,6563
26416,130268308,130281199,True,1,12891
26417,130279955,130364966,True,1,85011
26418,130286808,130286949,True,5,141
26419,130290093,130290933,True,1,840
26420,130290093,130291366,False,1,1273
26421,130308272,130308546,True,3,274
26422,130341603,130346189,True,1,4586
26423,130342614,130365501,True,2,22887
26424,130356547,130357414,True,1,867
26425,130359615,130360928,True,1,1313
26426,130367768,130685436,False,1,317668
26427,130376714,130379356,False,1,2642
26428,130389010,130390022,True,1,1012
26429,130394032,130396164,True,1,2132
26430,130394765,130394874,True,1,109
26431,130408263,130410330,True,1,2067
26432,130408263,130412094,True,2,3831
26433,130408263,130418218,True,1,9955
26434,130409631,130410234,True,1,603
26435,130416094,130417578,True,1,1484
26436,130421881,130445114,True,1,23233
26437,130428337,130432382,False,1,4045
26438,130428337,130432382,True,1,4045
26439,130429191,130429370,True,3,179
26440,130431332,130444158,True,1,12826
26441,130432356,130433240,False,1,884
26442,130432356,130435603,False,1,3247
26443,130432356,130436856,False,1,4500
26444,130433798,130445074,True,1,11276
26445,130437164,130439964,True,3,2800
26446,130445015,130506842,True,7,61827
26447,130455205,130457666,True,1,2461
26448,130466635,130467135,True,2,500
26449,130470695,130472207,False,1,1512
26450,130470695,130473966,False,1,3271
26451,130483587,130484260,True,1,673
26452,130483921,130484260,True,2,339
26453,130484283,130486444,True,2,2161
26454,130487080,130490366,True,2,3286
26455,130511439,130513021,True,3,1582
26456,130539421,130539663,False,1,242
26457,130555198,130571908,False,1,16710
26458,130562459,130607218,True,2,44759
26459,130567156,130580025,True,4,12869
26460,130567207,130580080,True,1,12873
26461,130568972,130572998,True,1,4026
26462,130571882,130576388,False,1,4506
26463,130571882,130576388,True,1,4506
26464,130581563,130584675,False,1,3112
26465,130585282,130585590,True,4,308
26466,130589443,130591039,True,1,1596
26467,130593467,130595118,True,1,1651
26468,130596357,130597144,True,1,787
26469,130599245,130599982,True,3,737
26470,130612731,130612826,True,7,95
26471,130613806,130613894,True,1,88
26472,130629811,130630058,True,3,247
26473,130629811,130639090,True,1,9279
26474,130637743,130663716,False,2,25973
26475,130637743,130706545,False,1,68802
26476,130673786,130674918,True,3,1132
26477,130675627,130679940,True,1,4313
26478,130675923,130676015,True,1,92
26479,130676808,130751912,True,1,75104
26480,130676808,130757315,True,1,80507
26481,130680250,130680641,True,1,391
26482,130680250,130680651,True,1,401
26483,130680250,130680690,True,1,440
26484,130682712,130684642,True,1,1930
26485,130682712,130686777,True,1,4065
26486,130683700,130684957,True,1,1257
26487,130687385,130690055,True,1,2670
26488,130691955,130694081,True,2,2126
26489,130693286,130696437,True,3,3151
26490,130721006,130721104,True,1,98
26491,130721006,130721270,True,1,264
26492,130721179,130721270,True,1,91
26493,130721670,130723248,True,1,1578
26494,130730164,130732485,True,1,2321
26495,130731273,130732091,True,1,818
26496,130731324,130732088,True,3,764
26497,130747714,130902312,True,2,154598
26498,130762330,130771785,True,7,9455
26499,130765150,130772830,True,1,7680
26500,130767717,130768075,True,1,358
26501,130768390,130774476,True,2,6086
26502,130768390,130776273,True,1,7883
26503,130770910,130772152,False,1,1242
26504,130770910,130772152,True,2,1242
26505,130780327,130781943,True,1,1616
26506,130785348,130785471,True,1,123
26507,130788842,130789197,True,1,355
26508,130789465,130791661,True,1,2196
26509,130811230,130813877,True,1,2647
26510,130812425,130812578,False,1,153
26511,130812425,130813902,False,1,1477
26512,130812425,130815090,True,1,2665
26513,130814834,130815642,True,1,808
26514,130815357,130815861,True,1,504
26515,130820894,130821428,True,1,534
26516,130827761,130827915,False,2,154
26517,130827761,130827915,True,2,154
26518,130831009,130831566,True,1,557
26519,130843046,130843354,True,1,308
26520,130843330,130844223,True,1,893
26521,130843537,130844223,True,4,686
26522,130844304,130844395,True,1,91
26523,130846391,130846482,False,1,91
26524,130846624,130850240,True,1,3616
26525,130851240,130854018,True,1,2778
26526,130851722,130854980,True,2,3258
26527,130877283,130894224,True,1,16941
26528,130880410,130889334,True,3,8924
26529,130881673,130889951,True,1,8278
26530,130882027,130885209,True,1,3182
26531,130886034,130887549,False,1,1515
26532,130886034,130887549,True,1,1515
26533,130889653,130893299,True,1,3646
26534,130890810,130898203,False,1,7393
26535,130898293,130899105,True,1,812
26536,130907321,130924471,True,1,17150
26537,130909919,130921812,True,4,11893
26538,130945820,131033242,True,2,87422
26539,130959222,130959320,True,2,98
26540,130959388,130959707,True,2,319
26541,130960395,130960481,True,1,86
26542,130964734,130976469,True,2,11735
26543,130972423,130972657,False,1,234
26544,130972423,130972657,True,1,234
26545,130975644,130975971,False,1,327
26546,130975644,130980897,False,1,5253
26547,130976050,130976303,False,1,253
26548,130976050,130981138,False,1,5088
26549,130979773,130982544,True,1,2771
26550,131003431,131006104,False,1,2673
26551,131010613,131010867,True,1,254
26552,131018014,131025765,True,1,7751
26553,131079287,131081850,True,2,2563
26554,131081618,131081799,True,2,181
26555,131081913,131087621,True,5,5708
26556,131085222,131085885,True,1,663
26557,131085222,131085901,False,1,679
26558,131085222,131086470,False,1,1248
26559,131085222,131086470,True,2,1248
26560,131088207,131088690,True,1,483
26561,131088664,131104334,True,1,15670
26562,131089181,131089279,True,1,98
26563,131101473,131110880,False,1,9407
26564,131101473,131110880,True,2,9407
26565,131102316,131103657,True,2,1341
26566,131102319,131103657,True,1,1338
26567,131109448,131116004,True,1,6556
26568,131113372,131113886,False,1,514
26569,131118305,131130971,False,1,12666
26570,131122898,131123186,True,1,288
26571,131128248,131168054,True,1,39806
26572,131128248,131168057,True,1,39809
26573,131159705,131172493,True,1,12788
26574,131159761,131172493,False,1,12732
26575,131159761,131172493,True,2,12732
26576,131159761,131190232,True,1,30471
26577,131202981,131218356,True,3,15375
26578,131226579,131227190,True,1,611
26579,131226798,131269743,True,1,42945
26580,131227252,131227471,True,1,219
26581,131228084,131270240,True,1,42156
26582,131240950,131241190,True,1,240
26583,131242093,131242336,True,1,243
26584,131243662,131243789,True,1,127
26585,131245203,131245407,True,2,204
26586,131256230,131256313,True,1,83
26587,131261211,131261414,True,1,203
26588,131268094,131268225,False,1,131
26589,131268461,131269241,True,1,780
26590,131294685,131296253,True,1,1568
26591,131294695,131294954,True,1,259
26592,131302724,131303071,True,2,347
26593,131309395,131309601,True,1,206
26594,131310403,131310603,True,1,200
26595,131320458,131321174,True,1,716
26596,131320458,131327401,True,1,6943
26597,131327860,131360490,False,1,32630
26598,131340767,131375568,True,1,34801
26599,131340767,131421754,False,1,80987
26600,131345067,131373063,True,1,27996
26601,131345067,131374729,True,1,29662
26602,131345067,131393026,True,1,47959
26603,131345617,131375073,True,1,29456
26604,131350581,131351114,True,2,533
26605,131360254,131364027,False,1,3773
26606,131369968,131370661,True,1,693
26607,131369971,131370661,True,1,690
26608,131373741,131373976,True,1,235
26609,131426320,131426322,True,1,2
26610,131426407,131427463,False,1,1056
26611,131426407,131434150,False,1,7743
26612,131428264,131429848,True,2,1584
26613,131432099,131433513,True,1,1414
26614,131440479,131550463,True,1,109984
26615,131458723,131460634,True,1,1911
26616,131458723,131460702,True,2,1979
26617,131460991,131541668,True,1,80677
26618,131460991,131560692,True,1,99701
26619,131477341,131481332,False,1,3991
26620,131477341,131481332,True,8,3991
26621,131488737,131490896,True,1,2159
26622,131530229,131530834,True,7,605
26623,131539533,131540253,True,1,720
26624,131539590,131540253,True,1,663
26625,131550838,131605533,True,1,54695
26626,131559216,131559756,True,1,540
26627,131563359,131572306,False,1,8947
26628,131568609,131568751,True,1,142
26629,131619383,131620995,True,2,1612
26630,131633416,131634795,False,1,1379
26631,131633416,131634795,True,4,1379
26632,131633416,131635090,True,1,1674
26633,131639023,131641788,True,1,2765
26634,131639803,131639957,True,3,154
26635,131644232,131671833,True,3,27601
26636,131645882,131666838,True,2,20956
26637,131676136,131798778,True,2,122642
26638,131686020,131688252,True,1,2232
26639,131743092,131745385,True,7,2293
26640,131756020,131799646,False,1,43626
26641,131756020,131799646,True,2,43626
26642,131756020,131905362,True,1,149342
26643,131759082,131779254,False,1,20172
26644,131759379,131801784,True,2,42405
26645,131772553,131773139,True,1,586
26646,131772553,131777114,True,6,4561
26647,131783981,131789179,True,1,5198
26648,131785021,131947710,True,3,162689
26649,131807847,131808658,True,1,811
26650,131808654,131814919,True,1,6265
26651,131828699,131830560,True,1,1861
26652,131834600,131846756,True,1,12156
26653,131834600,131848223,True,1,13623
26654,131870586,131872005,True,1,1419
26655,131876288,131888553,False,1,12265
26656,131880753,131881788,True,2,1035
26657,131887765,131888036,True,1,271
26658,131907281,131909622,True,2,2341
26659,131907479,131913748,False,1,6269
26660,131966601,131971454,True,1,4853
26661,131975435,131976231,True,1,796
26662,131975435,131976374,True,1,939
26663,131982872,132022598,True,3,39726
26664,131990312,131999681,True,1,9369
26665,131992688,131993078,False,1,390
26666,131996034,131996174,True,1,140
26667,132015373,132017526,True,1,2153
26668,132021260,132030157,False,1,8897
26669,132022853,132023222,True,1,369
26670,132049723,132050780,True,1,1057
26671,132050291,132051143,True,1,852
26672,132050515,132051189,True,1,674
26673,132050515,132051226,True,2,711
26674,132052310,132055609,True,1,3299
26675,132057826,132057975,True,1,149
26676,132063803,132065071,True,1,1268
26677,132065006,132065558,True,1,552
26678,132072219,132075321,True,1,3102
26679,132077782,132083683,False,1,5901
26680,132081478,132084039,True,1,2561
26681,132089844,132098734,True,2,8890
26682,132091675,132095399,False,1,3724
26683,132091679,132095399,False,1,3720
26684,132091679,132095399,True,1,3720
26685,132104304,132104392,True,1,88
26686,132109829,132110232,True,1,403
26687,132118931,132121163,True,1,2232
26688,132147383,132157946,False,1,10563
26689,132188062,132192127,True,2,4065
26690,132188062,132197105,True,1,9043
26691,132195795,132196777,False,1,982
26692,132199764,132200268,True,5,504
26693,132210081,132210515,True,1,434
26694,132210163,132210515,True,1,352
26695,132211864,132213198,True,1,1334
26696,132226553,132226801,True,1,248
26697,132238943,132390450,True,1,151507
26698,132249313,132320380,True,2,71067
26699,132261009,132261685,True,4,676
26700,132294395,132324302,True,1,29907
26701,132304610,132372420,True,1,67810
26702,132323759,132331464,True,2,7705
26703,132375217,132382969,True,5,7752
26704,132377299,132378063,True,2,764
26705,132378065,132378697,True,2,632
26706,132382337,132389486,True,1,7149
26707,132394124,132397926,True,1,3802
26708,132401086,132401734,False,1,648
26709,132406132,132406834,True,1,702
26710,132406132,132407122,True,2,990
26711,132410761,132438798,True,1,28037
26712,132410761,132441850,True,1,31089
26713,132435233,132439215,False,1,3982
26714,132437400,132440018,False,2,2618
26715,132437400,132440018,True,6,2618
26716,132441939,132457743,True,1,15804
26717,132464647,132483360,False,1,18713
26718,132467713,132469394,True,1,1681
26719,132468833,132469932,True,3,1099
26720,132468833,132473046,True,1,4213
26721,132473934,132475545,True,1,1611
26722,132488343,132488923,True,1,580
26723,132488343,132488927,True,1,584
26724,132488371,132488923,True,1,552
26725,132488371,132488927,True,1,556
26726,132488543,132489024,True,1,481
26727,132488990,132490471,True,2,1481
26728,132491951,132492273,True,1,322
26729,132495419,132497145,True,1,1726
26730,132495419,132497148,True,2,1729
26731,132503594,132510308,True,1,6714
26732,132509819,132514230,True,1,4411
26733,132509819,132604927,True,1,95108
26734,132510889,132558404,True,1,47515
26735,132516505,132637118,True,2,120613
26736,132517786,132637781,True,1,119995
26737,132521317,132531236,False,1,9919
26738,132528653,132530144,True,2,1491
26739,132529716,132536849,False,1,7133
26740,132542720,132564792,False,1,22072
26741,132542720,132564792,True,1,22072
26742,132551509,132556117,False,1,4608
26743,132553334,132555031,True,1,1697
26744,132556295,132556600,False,1,305
26745,132556295,132556600,True,4,305
26746,132575344,132590717,True,1,15373
26747,132577489,132582957,True,1,5468
26748,132582475,132584714,True,1,2239
26749,132601360,132650677,False,1,49317
26750,132601360,132650677,True,1,49317
26751,132601692,132651009,True,1,49317
26752,132611254,132613815,False,1,2561
26753,132614029,132617907,True,1,3878
26754,132628122,132632573,True,1,4451
26755,132628866,132633019,False,1,4153
26756,132662412,132662491,True,1,79
26757,132685354,132687622,True,2,2268
26758,132716848,132722711,True,1,5863
26759,132721460,132721800,True,1,340
26760,132728713,132729340,True,1,627
26761,132765088,132766253,False,1,1165
26762,132765088,132766253,True,1,1165
26763,132768580,132775735,True,2,7155
26764,132768580,132777982,True,1,9402
26765,132768580,132791221,True,1,22641
26766,132768580,132794971,True,1,26391
26767,132768580,132797548,True,1,28968
26768,132772650,132793035,False,1,20385
26769,132772650,132793035,True,1,20385
26770,132793003,132793795,False,1,792
26771,132801185,132813744,True,1,12559
26772,132812310,132813256,True,4,946
26773,132813999,132817324,True,1,3325
26774,132826656,132833916,True,1,7260
26775,132835382,132839635,True,2,4253
26776,132860133,132860219,True,5,86
26777,132865518,132868553,True,2,3035
26778,132879062,132882051,False,1,2989
26779,132885143,132886607,False,1,1464
26780,132906175,132908811,True,1,2636
26781,132906294,132906586,True,1,292
26782,132906633,132907185,True,1,552
26783,132909742,132911587,False,1,1845
26784,132914643,132917094,False,1,2451
26785,132917214,133171530,True,1,254316
26786,132922533,132932695,True,1,10162
26787,132922533,132964702,False,1,42169
26788,132922533,132964702,True,3,42169
26789,132923355,132923951,True,1,596
26790,132923760,132924841,False,1,1081
26791,132923760,132924841,True,1,1081
26792,132930734,132969300,True,1,38566
26793,132958516,132959780,True,1,1264
26794,132981263,132994594,True,1,13331
26795,132993095,132996096,False,1,3001
26796,133007272,133030367,True,1,23095
26797,133007711,133013249,False,1,5538
26798,133016203,133019453,True,1,3250
26799,133017208,133019645,True,1,2437
26800,133017208,133020052,True,2,2844
26801,133017239,133020052,True,1,2813
26802,133022678,133029856,True,1,7178
26803,133023075,133038325,True,1,15250
26804,133023251,133030429,True,1,7178
26805,133024596,133028054,True,1,3458
26806,133024596,133038718,True,1,14122
26807,133027686,133028573,False,1,887
26808,133031510,133032186,True,2,676
26809,133034646,133039522,False,1,4876
26810,133034646,133039522,True,1,4876
26811,133047870,133048825,False,1,955
26812,133062662,133063218,True,4,556
26813,133062662,133070335,True,1,7673
26814,133064586,133080611,True,1,16025
26815,133065138,133066732,True,3,1594
26816,133072069,133073170,False,1,1101
26817,133087874,133089537,True,7,1663
26818,133106833,133106947,True,1,114
26819,133113906,133138993,True,2,25087
26820,133162821,133164857,True,1,2036
26821,133164360,133187984,True,1,23624
26822,133166189,133173635,True,1,7446
26823,133166189,133180466,True,1,14277
26824,133166189,133186211,True,1,20022
26825,133171337,133172956,True,2,1619
26826,133171992,133173243,True,2,1251
26827,133173161,133178556,True,4,5395
26828,133173161,133183488,True,2,10327
26829,133173161,133186252,True,1,13091
26830,133173161,133197470,True,1,24309
26831,133174804,133186558,True,1,11754
26832,133200790,133204130,False,2,3340
26833,133200790,133204130,True,2,3340
26834,133200790,133205345,False,2,4555
26835,133200790,133211298,True,2,10508
26836,133200790,133211323,False,2,10533
26837,133200790,133213041,True,1,12251
26838,133200808,133211298,True,1,10490
26839,133201197,133204186,False,5,2989
26840,133201197,133204186,True,2,2989
26841,133207835,133208850,True,1,1015
26842,133221993,133222110,True,2,117
26843,133227145,133227277,True,1,132
26844,133227145,133234248,True,1,7103
26845,133232614,133232695,True,3,81
26846,133249355,133249792,True,1,437
26847,133251439,133251981,True,1,542
26848,133258298,133262342,True,2,4044
26849,133258526,133262493,True,3,3967
26850,133269907,133270539,True,1,632
26851,133276319,133276566,True,1,247
26852,133276685,133276859,True,1,174
26853,133277421,133280776,True,1,3355
26854,133277488,133280843,False,1,3355
26855,133299913,133304615,True,1,4702
26856,133304768,133309424,False,1,4656
26857,133304777,133305957,True,1,1180
26858,133315892,133355381,False,1,39489
26859,133325531,133327398,True,2,1867
26860,133329963,133331841,False,1,1878
26861,133333255,133333425,True,1,170
26862,133334739,133334954,True,1,215
26863,133358975,133406573,True,1,47598
26864,133376972,133387595,False,1,10623
26865,133388504,133421582,True,1,33078
26866,133392904,133394843,False,2,1939
26867,133392904,133394843,True,1,1939
26868,133482353,133498565,False,1,16212
26869,133484236,133488405,True,3,4169
26870,133485862,133486402,True,1,540
26871,133505232,133509974,False,1,4742
26872,133512523,133514527,True,2,2004
26873,133514958,133518025,False,2,3067
26874,133530477,133626969,False,1,96492
26875,133530477,133626969,True,4,96492
26876,133530477,133669654,False,1,139177
26877,133531180,133536268,True,1,5088
26878,133531180,133536425,True,1,5245
26879,133532288,133534030,True,2,1742
26880,133535496,133538596,False,2,3100
26881,133565720,133567003,True,1,1283
26882,133565720,133569416,True,1,3696
26883,133577546,133651778,True,1,74232
26884,133577944,133581552,True,1,3608
26885,133580585,133587780,True,1,7195
26886,133581746,133588406,True,1,6660
26887,133583642,133584044,True,2,402
26888,133585401,133585702,False,1,301
26889,133587187,133587469,True,1,282
26890,133595159,133598512,True,2,3353
26891,133595159,133598607,True,1,3448
26892,133595159,133603754,True,1,8595
26893,133596095,133619000,True,1,22905
26894,133602061,133605397,False,1,3336
26895,133602730,133605181,True,1,2451
26896,133640646,133641277,True,1,631
26897,133648793,133657653,True,1,8860
26898,133673801,133676458,True,4,2657
26899,133681479,133682913,True,2,1434
26900,133681479,133684915,True,1,3436
26901,133701897,133702936,True,1,1039
26902,133727754,133727870,True,3,116
26903,133749113,133831225,True,1,82112
26904,133751060,133762641,False,1,11581
26905,133756125,134082305,False,1,326180
26906,133756125,134082305,True,3,326180
26907,133756711,133759212,True,1,2501
26908,133757977,133759771,True,1,1794
26909,133766211,133766415,True,1,204
26910,133774259,133775442,False,1,1183
26911,133774259,133775442,True,1,1183
26912,133777533,133788125,True,1,10592
26913,133777533,133805939,True,1,28406
26914,133780632,133781200,True,1,568
26915,133828925,133832514,True,1,3589
26916,133846014,133853128,False,1,7114
26917,133856576,133857228,True,2,652
26918,133867730,133889511,False,1,21781
26919,133867730,133889511,True,1,21781
26920,133884416,133885192,True,4,776
26921,133906378,133906481,False,3,103
26922,133911837,133912998,True,2,1161
26923,133922953,133924357,False,1,1404
26924,133932160,133932638,False,1,478
26925,133932160,133932638,True,1,478
26926,133937960,133940284,True,2,2324
26927,133938252,133940311,True,1,2059
26928,133942926,133943046,True,2,120
26929,133949433,134121947,True,5,172514
26930,133950139,133957789,True,1,7650
26931,133990423,133992211,True,2,1788
26932,133991086,133998677,False,1,7591
26933,133991086,133998677,True,1,7591
26934,133999875,134091352,True,1,91477
26935,134002005,134004933,True,1,2928
26936,134003179,134004957,True,1,1778
26937,134015345,134017983,True,1,2638
26938,134025588,134026113,True,1,525
26939,134036438,134044035,False,1,7597
26940,134040136,134040730,True,1,594
26941,134045224,134052020,True,2,6796
26942,134059262,134059491,True,1,229
26943,134068187,134078645,True,1,10458
26944,134069097,134069173,True,3,76
26945,134078912,134079692,True,1,780
26946,134078948,134079814,True,4,866
26947,134097521,134098129,True,1,608
26948,134097521,134107070,True,1,9549
26949,134113782,134114059,True,1,277
26950,134113782,134114308,True,2,526
26951,134126437,134126677,True,3,240
26952,134132624,134132838,True,1,214
26953,134132635,134132839,True,1,204
26954,134136829,134300004,True,1,163175
26955,134136864,134136997,True,1,133
26956,134142080,134142436,True,1,356
26957,134142080,134142505,False,1,425
26958,134142080,134142505,True,1,425
26959,134150061,134150195,True,1,134
26960,134170977,134174048,False,1,3071
26961,134178160,134182495,False,1,4335
26962,134178337,134179137,True,1,800
26963,134209550,134209839,False,1,289
26964,134218628,134235420,True,1,16792
26965,134218628,134245902,True,2,27274
26966,134237725,134238395,False,3,670
26967,134237725,134238395,True,1,670
26968,134237725,134238692,True,1,967
26969,134263755,134264799,True,1,1044
26970,134264739,134266567,True,2,1828
26971,134264921,134274928,False,1,10007
26972,134273379,134274302,True,1,923
26973,134287757,134287885,True,1,128
26974,134288056,134297927,True,1,9871
26975,134289213,134289319,False,2,106
26976,134289213,134289319,True,2,106
26977,134308094,134313857,True,1,5763
26978,134318971,134319052,True,1,81
26979,134321552,134345351,True,1,23799
26980,134321856,134321935,True,1,79
26981,134331767,134331842,True,4,75
26982,134342794,134343043,True,1,249
26983,134342811,134343043,True,1,232
26984,134356724,134357107,True,1,383
26985,134366382,134366793,True,2,411
26986,134366382,134368024,True,1,1642
26987,134366578,134366770,True,1,192
26988,134368794,134369546,True,1,752
26989,134376950,134377085,True,2,135
26990,134379449,134379758,True,1,309
26991,134386467,134404047,True,1,17580
26992,134387849,134389526,True,1,1677
26993,134392028,134392385,True,1,357
26994,134395042,134395207,True,2,165
26995,134397180,134397766,False,2,586
26996,134401087,134401231,True,1,144
26997,134406801,134408066,True,1,1265
26998,134408876,134409452,True,2,576
26999,134408876,134412462,True,1,3586
27000,134411489,134411657,False,1,168
27001,134411489,134411657,True,2,168
27002,134415704,134415818,True,3,114
27003,134416976,134417063,True,1,87
27004,134418039,134418141,True,1,102
27005,134420382,134421415,True,3,1033
27006,134420382,134421604,False,1,1222
27007,134426797,134427048,False,1,251
27008,134436406,134438476,False,2,2070
27009,134436406,134438476,True,1,2070
27010,134436775,134436855,True,4,80
27011,134440002,134440092,False,1,90
27012,134440002,134443063,True,1,3061
27013,134446077,134446474,True,1,397
27014,134452332,134452729,True,1,397
27015,134463950,134464090,False,1,140
27016,134463985,134464090,False,4,105
27017,134463985,134464090,True,3,105
27018,134466334,134466481,True,2,147
27019,134466907,134466996,True,1,89
27020,134468980,134469091,True,4,111
27021,134482448,134482541,True,3,93
27022,134482717,134482815,True,1,98
27023,134484360,134484976,False,1,616
27024,134484360,134484976,True,5,616
27025,134489123,134501977,True,1,12854
27026,134501232,134504979,True,1,3747
27027,134508772,134518378,False,2,9606
27028,134519005,134519641,True,4,636
27029,134522142,134522752,False,1,610
27030,134522142,134522752,True,1,610
27031,134526912,134526985,True,2,73
27032,134527351,134530151,True,1,2800
27033,134529190,134530441,True,2,1251
27034,134535729,134535817,True,1,88
27035,134540352,134543863,True,1,3511
27036,134540368,134543879,True,1,3511
27037,134543118,134551914,False,1,8796
27038,134543673,134544089,False,1,416
27039,134548443,134548794,True,3,351
27040,134558434,134566613,False,1,8179
27041,134558434,134566613,True,2,8179
27042,134565958,134569297,True,3,3339
27043,134573052,134573679,True,2,627
27044,134580023,134581152,True,1,1129
27045,134606760,134609431,True,1,2671
27046,134624254,134624717,True,1,463
27047,134625526,134626518,True,1,992
27048,134625858,134626024,True,1,166
27049,134626121,134626195,True,1,74
27050,134626228,134626826,True,1,598
27051,134627017,134627265,True,1,248
27052,134627264,134805704,False,1,178440
27053,134627790,134628274,True,1,484
27054,134646977,134648178,True,3,1201
27055,134667838,134670096,True,1,2258
27056,134689527,134697112,False,4,7585
27057,134689527,134697112,True,2,7585
27058,134689527,134699748,False,1,10221
27059,134689527,134701544,True,1,12017
27060,134702380,134702668,True,1,288
27061,134702483,134703864,False,1,1381
27062,134716892,134815425,True,1,98533
27063,134721581,134731288,False,1,9707
27064,134721581,134736604,True,1,15023
27065,134744100,134744885,True,1,785
27066,134748842,134750187,True,1,1345
27067,134748869,134750187,True,1,1318
27068,134748869,134750343,True,1,1474
27069,134748940,134750279,True,1,1339
27070,134752215,134752943,True,1,728
27071,134756708,134756902,True,1,194
27072,134760561,134760635,False,1,74
27073,134762076,134763352,False,1,1276
27074,134762751,134765360,True,3,2609
27075,134781355,134782400,True,9,1045
27076,134791131,134791201,True,1,70
27077,134791279,134791796,True,1,517
27078,134792008,134801634,True,2,9626
27079,134798138,134798560,True,1,422
27080,134798668,134832418,False,1,33750
27081,134811443,134814160,False,1,2717
27082,134811443,134814160,True,2,2717
27083,134820435,134822254,True,1,1819
27084,134821978,134912756,True,2,90778
27085,134822075,134862036,True,1,39961
27086,134836375,134875284,True,1,38909
27087,134844715,134848096,True,1,3381
27088,134847976,134848091,True,3,115
27089,134851423,134876293,True,2,24870
27090,134857117,134857224,True,1,107
27091,134858003,134859827,True,1,1824
27092,134860502,134860763,True,2,261
27093,134860796,134887589,True,1,26793
27094,134863732,134864453,True,1,721
27095,134917023,134917607,True,1,584
27096,134930451,134934564,True,1,4113
27097,134935145,134939780,True,1,4635
27098,134944508,134944610,True,3,102
27099,134947326,134947962,True,1,636
27100,134951469,134952706,True,1,1237
27101,134951469,134953326,True,2,1857
27102,134988248,134988896,True,3,648
27103,135003573,135014580,True,1,11007
27104,135023360,135033699,True,1,10339
27105,135033194,135033399,True,1,205
27106,135061867,135064783,True,3,2916
27107,135090094,135106178,True,1,16084
27108,135094422,135100745,True,6,6323
27109,135103183,135104023,False,1,840
27110,135117145,135118774,True,1,1629
27111,135117145,135119791,False,1,2646
27112,135117145,135119791,True,1,2646
27113,135120001,135123390,True,1,3389
27114,135125533,135135041,True,3,9508
27115,135127301,135135864,True,1,8563
27116,135142864,135143689,True,2,825
27117,135144433,135144553,True,1,120
27118,135144779,135144899,True,1,120
27119,135159722,135169661,True,1,9939
27120,135159722,135171740,True,1,12018
27121,135168830,135172336,True,1,3506
27122,135172290,135177061,True,1,4771
27123,135173128,135174551,True,1,1423
27124,135174816,135175554,True,1,738
27125,135176952,135177322,True,1,370
27126,135176972,135177431,True,1,459
27127,135177537,135177639,True,1,102
27128,135192936,135201358,True,2,8422
27129,135209433,135238362,True,1,28929
27130,135249244,135250740,True,1,1496
27131,135249720,135330501,True,1,80781
27132,135264392,135265941,True,1,1549
27133,135270345,135283541,False,4,13196
27134,135270345,135283541,True,4,13196
27135,135270345,135301442,True,1,31097
27136,135297160,135314936,False,2,17776
27137,135297160,135314936,True,7,17776
27138,135297160,135314941,True,2,17781
27139,135297160,135315007,False,1,17847
27140,135297160,135315007,True,2,17847
27141,135297160,135321109,True,2,23949
27142,135297160,135333773,True,3,36613
27143,135297160,135350912,True,1,53752
27144,135301345,135303133,False,1,1788
27145,135308126,135309588,False,1,1462
27146,135312395,135320095,False,3,7700
27147,135312395,135320095,True,1,7700
27148,135324727,135325571,True,1,844
27149,135326625,135338748,True,1,12123
27150,135342446,135343474,True,1,1028
27151,135342514,135343474,False,1,960
27152,135342514,135343474,True,3,960
27153,135346679,135358553,True,2,11874
27154,135358218,135358470,True,3,252
27155,135360099,135406092,True,2,45993
27156,135374969,135393264,True,2,18295
27157,135383001,135383077,True,3,76
27158,135385586,135385692,True,1,106
27159,135385604,135388830,True,1,3226
27160,135389854,135390206,True,2,352
27161,135394073,135394170,True,2,97
27162,135396761,135409619,False,2,12858
27163,135401691,135401844,False,1,153
27164,135401691,135401913,True,2,222
27165,135410646,135425358,False,2,14712
27166,135416261,135444427,True,3,28166
27167,135418391,135427793,True,1,9402
27168,135418391,135461499,True,1,43108
27169,135434323,135467682,True,1,33359
27170,135437588,135450312,True,1,12724
27171,135437588,135451790,True,1,14202
27172,135517465,135518232,True,4,767
27173,135517902,135519719,True,1,1817
27174,135530418,135533690,True,2,3272
27175,135546696,135552640,True,2,5944
27176,135546696,135559060,False,2,12364
27177,135546696,135559060,True,3,12364
27178,135552209,135558812,True,1,6603
27179,135555651,135560554,True,3,4903
27180,135566049,135569269,True,5,3220
27181,135567520,135570022,True,1,2502
27182,135569696,135569830,False,1,134
27183,135571468,135571642,False,1,174
27184,135586266,135586823,False,1,557
27185,135596283,135597700,True,2,1417
27186,135596283,135601801,False,1,5518
27187,135601345,135602548,True,1,1203
27188,135610059,135611735,True,1,1676
27189,135613047,135613718,True,1,671
27190,135613047,135615194,True,1,2147
27191,135614663,135618595,False,2,3932
27192,135614687,135615991,True,1,1304
27193,135614857,135618595,False,1,3738
27194,135621376,135621448,True,1,72
27195,135627453,135632275,True,1,4822
27196,135630384,135630460,True,1,76
27197,135634961,135635030,False,1,69
27198,135641839,135649743,True,2,7904
27199,135654206,135658515,True,1,4309
27200,135667936,135669758,True,1,1822
27201,135668513,135668721,False,1,208
27202,135670828,135677390,True,2,6562
27203,135682075,135689179,True,7,7104
27204,135682297,135689212,True,1,6915
27205,135682886,135683711,True,1,825
27206,135707872,135708638,True,1,766
27207,135710129,135713485,True,1,3356
27208,135719134,135732344,True,1,13210
27209,135724352,135724434,True,3,82
27210,135724857,135724944,True,1,87
27211,135735279,135752849,True,2,17570
27212,135752438,135754339,True,4,1901
27213,135761706,135779821,True,2,18115
27214,135801118,135823314,True,1,22196
27215,135814171,135816564,True,1,2393
27216,135814171,135816771,True,1,2600
27217,135814635,135817120,True,1,2485
27218,135822950,135823033,True,1,83
27219,135827149,135846235,True,1,19086
27220,135827833,135856762,False,1,28929
27221,135837665,135838403,True,1,738
27222,135841657,135841831,False,1,174
27223,135850144,135857953,True,4,7809
27224,135853835,135857145,True,2,3310
27225,135854448,135869755,True,2,15307
27226,135865851,135866671,True,1,820
27227,135867830,135871665,True,2,3835
27228,135877640,135890697,True,1,13057
27229,135910866,135913359,True,3,2493
27230,135912462,135947913,True,1,35451
27231,135916241,135921509,False,1,5268
27232,135926940,135932116,True,1,5176
27233,135927470,135927558,True,1,88
27234,135933202,135933326,True,1,124
27235,135948167,135950050,True,1,1883
27236,135953333,135963078,False,1,9745
27237,135953333,135963078,True,3,9745
27238,135956210,135956364,True,5,154
27239,135957510,135957657,True,1,147
27240,135959440,135959518,False,1,78
27241,135961847,135962071,False,1,224
27242,135962902,135973203,True,1,10301
27243,135972414,135974091,True,1,1677
27244,135992655,135994322,True,1,1667
27245,136000122,136008556,True,1,8434
27246,136019469,136019559,True,2,90
27247,136042955,136043045,False,1,90
27248,136042955,136043045,True,2,90
27249,136051642,136052397,True,1,755
27250,136059188,136059960,True,1,772
27251,136071682,136072385,True,1,703
27252,136075803,136076034,True,2,231
27253,136081679,136096498,True,1,14819
27254,136085473,136086086,True,1,613
27255,136085473,136093395,True,1,7922
27256,136090598,136091099,True,1,501
27257,136094968,136110741,False,1,15773
27258,136097169,136098698,True,2,1529
27259,136098586,136107297,True,2,8711
27260,136106793,136106916,True,1,123
27261,136107203,136109123,True,1,1920
27262,136111259,136521800,True,1,410541
27263,136112911,136115372,True,1,2461
27264,136114100,136116162,True,2,2062
27265,136114100,136128753,True,1,14653
27266,136120639,136126709,True,1,6070
27267,136142896,136168162,True,3,25266
27268,136153368,136161274,True,1,7906
27269,136160380,136195420,False,1,35040
27270,136160380,136195420,True,1,35040
27271,136173383,136174187,True,1,804
27272,136173553,136198375,True,1,24822
27273,136202210,136205434,True,1,3224
27274,136207291,136211926,False,1,4635
27275,136221216,136222512,True,3,1296
27276,136222656,136223608,True,1,952
27277,136224124,136226320,True,1,2196
27278,136236064,136238018,True,3,1954
27279,136237508,136274568,True,3,37060
27280,136237736,136274541,True,3,36805
27281,136238955,136275156,True,4,36201
27282,136238955,136311038,True,1,72083
27283,136239582,136275651,True,3,36069
27284,136241141,136276428,True,3,35287
27285,136241304,136276491,True,3,35187
27286,136245708,136278491,True,3,32783
27287,136248378,136251184,True,1,2806
27288,136288658,136295248,True,3,6590
27289,136302080,136302565,True,2,485
27290,136302080,136302890,True,1,810
27291,136302080,136304201,False,1,2121
27292,136329811,136335776,True,1,5965
27293,136331517,136336638,True,1,5121
27294,136337254,136356165,True,1,18911
27295,136338407,136340423,True,1,2016
27296,136369113,136372077,False,1,2964
27297,136428592,136431003,False,1,2411
27298,136428592,136431003,True,1,2411
27299,136435002,136436248,True,1,1246
27300,136455799,136456416,True,1,617
27301,136456480,136500796,True,3,44316
27302,136456480,136515152,True,5,58672
27303,136526667,136526739,False,1,72
27304,136526667,136526739,True,2,72
27305,136527421,136527678,True,1,257
27306,136529140,136529996,False,1,856
27307,136539516,136542449,True,5,2933
27308,136558702,136562437,True,2,3735
27309,136558702,136568066,True,1,9364
27310,136558702,136572293,True,1,13591
27311,136560718,136661635,True,1,100917
27312,136567731,136569636,False,1,1905
27313,136573065,136576752,True,6,3687
27314,136578576,136581730,True,1,3154
27315,136596089,136719807,False,1,123718
27316,136596089,136798298,False,1,202209
27317,136596897,136598912,False,2,2015
27318,136596897,136598912,True,2,2015
27319,136617745,136633703,False,1,15958
27320,136652180,136657802,True,1,5622
27321,136669330,136674684,True,1,5354
27322,136669330,136730405,True,1,61075
27323,136669825,136670799,True,1,974
27324,136676381,136678592,False,2,2211
27325,136676381,136678592,True,1,2211
27326,136681105,136696092,True,1,14987
27327,136686936,136698869,True,1,11933
27328,136689878,136690819,True,1,941
27329,136689878,136694674,True,1,4796
27330,136693259,136725213,True,2,31954
27331,136700210,136702402,False,1,2192
27332,136709235,136711869,True,1,2634
27333,136715857,136719112,True,1,3255
27334,136716620,136731108,True,1,14488
27335,136718828,136719997,True,1,1169
27336,136723146,136725644,True,2,2498
27337,136762804,136763367,True,1,563
27338,136763119,136763209,True,1,90
27339,136763563,136765793,True,1,2230
27340,136763889,136765793,True,1,1904
27341,136766583,136772943,False,1,6360
27342,136770277,136770514,True,1,237
27343,136772294,136773375,True,1,1081
27344,136779940,136786407,True,2,6467
27345,136779940,136788662,True,1,8722
27346,136787439,136787733,True,3,294
27347,136791609,136792428,True,1,819
27348,136797353,136802572,True,1,5219
27349,136798887,136820717,True,1,21830
27350,136814130,136819586,True,1,5456
27351,136820244,136822084,False,1,1840
27352,136823793,136823971,False,1,178
27353,136823793,136823971,True,1,178
27354,136849092,136861245,True,2,12153
27355,136855676,136856853,False,1,1177
27356,136904182,136904372,True,1,190
27357,136925946,136926569,True,3,623
27358,136950875,136953247,True,1,2372
27359,136955353,136962340,False,1,6987
27360,136966328,136970025,True,1,3697
27361,136969492,136972818,False,2,3326
27362,136969492,136972818,True,2,3326
27363,136969492,136980623,False,1,11131
27364,136970969,136972994,True,2,2025
27365,137000077,137001302,True,3,1225
27366,137000382,137001315,True,1,933
27367,137009855,137013383,True,1,3528
27368,137009855,137016056,True,1,6201
27369,137012320,137016466,True,1,4146
27370,137022918,137055589,True,1,32671
27371,137024689,137027873,True,1,3184
27372,137027270,137035735,True,1,8465
27373,137029447,137032269,True,1,2822
27374,137041299,137064428,True,1,23129
27375,137044406,137049122,True,1,4716
27376,137047548,137049385,True,1,1837
27377,137055353,137056235,True,1,882
27378,137057869,137059109,True,1,1240
27379,137061489,137061840,True,4,351
27380,137088376,137090289,True,1,1913
27381,137097816,137100240,True,1,2424
27382,137128484,137131646,True,1,3162
27383,137128577,137167602,True,1,39025
27384,137134197,137153133,False,1,18936
27385,137134197,137153133,True,1,18936
27386,137141143,137152083,True,1,10940
27387,137146487,137146774,True,2,287
27388,137146568,137146845,True,2,277
27389,137147388,137165559,True,1,18171
27390,137155379,137157680,True,4,2301
27391,137182225,137187738,False,2,5513
27392,137183058,137183771,True,1,713
27393,137183058,137194501,True,2,11443
27394,137184846,137199779,True,2,14933
27395,137189509,137190149,True,2,640
27396,137190839,137190924,True,1,85
27397,137209540,137213382,True,2,3842
27398,137210525,137219556,True,1,9031
27399,137232001,137235162,True,1,3161
27400,137284680,137287315,True,2,2635
27401,137295632,137299026,True,2,3394
27402,137317608,137319101,True,2,1493
27403,137319448,137357413,True,1,37965
27404,137320132,137320540,True,1,408
27405,137322150,137322897,True,3,747
27406,137330414,137331983,True,1,1569
27407,137331398,137332498,True,2,1100
27408,137331398,137333497,True,1,2099
27409,137331997,137332746,True,1,749
27410,137333529,137334390,True,1,861
27411,137333859,137334720,True,1,861
27412,137333859,137336516,True,1,2657
27413,137334664,137336935,True,1,2271
27414,137342824,137344853,False,1,2029
27415,137342824,137344853,True,1,2029
27416,137357477,137357687,True,1,210
27417,137357477,137388436,True,1,30959
27418,137371313,137625416,True,1,254103
27419,137372136,137372468,True,2,332
27420,137374809,137378041,True,3,3232
27421,137377491,137379046,True,3,1555
27422,137381006,137381474,True,1,468
27423,137389649,137412010,True,1,22361
27424,137389649,137424551,True,1,34902
27425,137395176,137398039,True,1,2863
27426,137400721,137401033,True,1,312
27427,137421935,137426134,True,2,4199
27428,137431134,137431481,False,1,347
27429,137439585,137443669,True,1,4084
27430,137440074,137443669,True,1,3595
27431,137451063,137473911,True,1,22848
27432,137453519,137453995,False,1,476
27433,137453519,137455375,False,1,1856
27434,137488504,137503589,False,1,15085
27435,137513632,137515250,False,1,1618
27436,137521862,137525752,True,1,3890
27437,137542560,137543392,False,1,832
27438,137542560,137543392,True,2,832
27439,137545590,137549181,True,2,3591
27440,137553239,137556322,True,2,3083
27441,137559914,137561155,False,1,1241
27442,137563218,137569138,True,2,5920
27443,137576604,137588120,True,1,11516
27444,137577316,137588591,True,1,11275
27445,137600124,137604969,False,1,4845
27446,137600124,137604969,True,1,4845
27447,137600124,137609776,True,1,9652
27448,137600124,137630522,True,1,30398
27449,137628013,137628841,False,1,828
27450,137632923,137637848,False,1,4925
27451,137632923,137637848,True,3,4925
27452,137645449,137647673,False,1,2224
27453,137672458,137676648,True,1,4190
27454,137672458,137725962,True,1,53504
27455,137672458,137916596,True,1,244138
27456,137672458,138012785,True,4,340327
27457,137712100,137716956,True,2,4856
27458,137712280,137714548,True,1,2268
27459,137712280,137716975,True,2,4695
27460,137715092,137717227,False,1,2135
27461,137715145,137715178,False,1,33
27462,137729372,137794681,True,2,65309
27463,137729372,137798871,True,1,69499
27464,137742923,137808804,True,1,65881
27465,137746231,137754803,True,1,8572
27466,137755122,137771293,True,2,16171
27467,137790116,137791252,True,1,1136
27468,137805966,137817063,False,1,11097
27469,137813606,137844380,True,1,30774
27470,137817831,137846375,True,1,28544
27471,137828360,137829015,False,1,655
27472,137838501,137845556,False,1,7055
27473,137838700,137843957,True,1,5257
27474,137842927,137857217,False,2,14290
27475,137849006,137861823,True,1,12817
27476,137853896,137853955,False,1,59
27477,137867747,137869841,False,1,2094
27478,137871482,137873319,False,1,1837
27479,137872211,137874048,False,1,1837
27480,137872653,137875984,True,1,3331
27481,137882586,137883302,False,1,716
27482,137882586,137883302,True,3,716
27483,137914024,137931419,False,1,17395
27484,137924304,137964263,True,2,39959
27485,137924812,137957364,False,1,32552
27486,138004484,138011295,True,3,6811
27487,138004523,138004770,False,1,247
27488,138009441,138047095,True,4,37654
27489,138009441,138052508,True,1,43067
27490,138009450,138047095,True,2,37645
27491,138011481,138011997,True,1,516
27492,138051282,138051849,True,4,567
27493,138073259,138074039,False,1,780
27494,138097230,138099485,False,1,2255
27495,138111275,138111364,True,1,89
27496,138123664,138124319,True,1,655
27497,138123664,138124413,True,1,749
27498,138123664,138124487,True,1,823
27499,138123664,138217897,False,1,94233
27500,138128852,138428174,True,3,299322
27501,138131549,138133405,False,1,1856
27502,138137751,138147791,False,1,10040
27503,138141448,138142181,True,2,733
27504,138143355,138143621,True,1,266
27505,138161006,138179234,False,1,18228
27506,138161583,138163470,True,2,1887
27507,138162605,138163974,True,1,1369
27508,138186160,138186828,True,1,668
27509,138186315,138190767,True,1,4452
27510,138189673,138222443,False,1,32770
27511,138208556,138208880,True,4,324
27512,138232627,138606131,False,1,373504
27513,138268463,138285077,True,1,16614
27514,138279156,138282763,True,1,3607
27515,138280347,138283425,True,1,3078
27516,138280494,138281643,True,1,1149
27517,138281129,138283808,True,1,2679
27518,138281296,138310045,False,4,28749
27519,138283040,138284739,True,1,1699
27520,138306463,138306865,True,3,402
27521,138314310,138323886,True,2,9576
27522,138333090,138333857,True,2,767
27523,138333090,138333911,True,1,821
27524,138341388,138342300,True,1,912
27525,138342136,138380973,False,1,38837
27526,138344945,138345797,True,1,852
27527,138346032,138346717,True,1,685
27528,138348736,138349903,False,1,1167
27529,138348736,138350171,False,2,1435
27530,138354363,138361509,True,1,7146
27531,138356145,138358134,True,2,1989
27532,138375517,138376422,False,2,905
27533,138401690,138405802,False,1,4112
27534,138403525,138406329,True,1,2804
27535,138404241,138404956,True,3,715
27536,138405662,138405782,True,4,120
27537,138406059,138410319,False,3,4260
27538,138406059,138410319,True,5,4260
27539,138406059,138413577,True,1,7518
27540,138406059,138417090,True,1,11031
27541,138406059,138421128,True,1,15069
27542,138406059,138432594,True,2,26535
27543,138406059,138436039,True,1,29980
27544,138409606,138409992,False,2,386
27545,138409606,138409992,True,1,386
27546,138432738,138434453,True,1,1715
27547,138440277,138444818,False,1,4541
27548,138440277,138444818,True,3,4541
27549,138442698,138500552,False,1,57854
27550,138442698,138500552,True,1,57854
27551,138445894,138460774,True,1,14880
27552,138445894,138489904,True,2,44010
27553,138445894,138541704,True,1,95810
27554,138459468,138459569,False,1,101
27555,138481031,138482586,True,1,1555
27556,138481058,138507449,True,4,26391
27557,138486530,138594688,True,3,108158
27558,138494790,138512277,True,1,17487
27559,138495414,138497656,True,3,2242
27560,138509897,138510613,True,1,716
27561,138511580,138513968,True,2,2388
27562,138513533,138515864,True,1,2331
27563,138521863,138522012,True,1,149
27564,138601034,138601134,False,2,100
27565,138601034,138602993,False,1,1959
27566,138601034,138605589,False,1,4555
27567,138601239,138602993,False,3,1754
27568,138601239,138605589,False,1,4350
27569,138614157,138625899,True,3,11742
27570,138626407,138640703,True,1,14296
27571,138642356,138643303,True,2,947
27572,138648093,138649322,False,1,1229
27573,138673794,138688299,True,1,14505
27574,138682573,138684636,True,5,2063
27575,138690721,138695195,True,1,4474
27576,138690881,138691772,True,1,891
27577,138690942,138704589,True,5,13647
27578,138691523,138692912,True,1,1389
27579,138691523,138694182,True,1,2659
27580,138701909,138702374,True,1,465
27581,138702028,138708709,True,1,6681
27582,138703091,138703631,True,1,540
27583,138706707,138706888,True,1,181
27584,138707283,138707669,True,1,386
27585,138723702,138724550,False,3,848
27586,138723702,138724910,False,4,1208
27587,138725605,138726421,True,1,816
27588,138725605,138727237,True,1,1632
27589,138730795,138732187,False,1,1392
27590,138746530,138756478,False,1,9948
27591,138746905,138756442,False,1,9537
27592,138747202,138747321,True,2,119
27593,138754691,138758837,True,1,4146
27594,138764275,138765113,False,1,838
27595,138764275,138767583,True,1,3308
27596,138779714,138783374,True,1,3660
27597,138780422,138780882,True,1,460
27598,138794852,138816454,True,1,21602
27599,138806524,138819295,True,1,12771
27600,138808643,138810281,True,1,1638
27601,138844406,138844679,False,1,273
27602,138845060,138845792,False,1,732
27603,138846812,138847467,False,1,655
27604,138870500,138873109,False,1,2609
27605,138873964,138879609,False,1,5645
27606,138892899,138893041,False,1,142
27607,138906068,138939745,False,1,33677
27608,138906068,138941724,False,1,35656
27609,138906068,138955625,True,1,49557
27610,138909125,138910068,True,1,943
27611,138912151,138913669,True,1,1518
27612,138917257,138939548,True,2,22291
27613,138935930,138936767,False,1,837
27614,138942787,138954028,True,1,11241
27615,138952547,138953011,False,1,464
27616,138962686,138962992,False,2,306
27617,138962686,138962992,True,2,306
27618,138972732,138974127,True,1,1395
27619,138976406,138977388,True,2,982
27620,138995507,138997344,False,1,1837
27621,138995507,138997344,True,1,1837
27622,138995563,138997400,False,1,1837
27623,139004212,139004405,True,1,193
27624,139013176,139013334,True,2,158
27625,139019878,139020164,True,2,286
27626,139020360,139020471,True,1,111
27627,139025415,139032067,True,1,6652
27628,139027349,139031032,True,1,3683
27629,139035599,139039190,False,1,3591
27630,139039964,139046735,True,2,6771
27631,139073506,139090897,False,1,17391
27632,139100265,139100944,True,2,679
27633,139113394,139121765,True,1,8371
27634,139113793,139114309,True,1,516
27635,139142386,139154035,True,1,11649
27636,139170850,139173835,True,1,2985
27637,139176049,139176586,True,1,537
27638,139176049,139177307,True,1,1258
27639,139182688,139220971,True,1,38283
27640,139200145,139202264,True,4,2119
27641,139200145,139260172,True,3,60027
27642,139213874,139236419,True,1,22545
27643,139246666,139250738,True,4,4072
27644,139246666,139256396,False,1,9730
27645,139250203,139255821,True,1,5618
27646,139255134,139260616,True,1,5482
27647,139266802,139278223,True,2,11421
27648,139267551,139267967,False,1,416
27649,139286112,139287704,True,3,1592
27650,139286112,139288082,True,1,1970
27651,139286112,139288491,True,1,2379
27652,139286112,139288780,True,1,2668
27653,139289335,139291599,True,1,2264
27654,139290095,139292111,True,2,2016
27655,139302471,139317077,True,1,14606
27656,139302823,139304430,False,1,1607
27657,139305243,139305575,True,1,332
27658,139316501,139328825,True,3,12324
27659,139316501,139334332,True,1,17831
27660,139316501,139353724,True,1,37223
27661,139317238,139329114,True,2,11876
27662,139317238,139334621,True,1,17383
27663,139330112,139333465,True,1,3353
27664,139344759,139345639,True,1,880
27665,139350058,139373943,True,1,23885
27666,139363915,139365457,True,1,1542
27667,139364167,139365457,True,1,1290
27668,139364551,139366495,False,1,1944
27669,139364551,139366495,True,5,1944
27670,139388221,139389136,True,1,915
27671,139394774,139742681,False,1,347907
27672,139413441,139414957,False,1,1516
27673,139413441,139414957,True,3,1516
27674,139419615,139432786,True,2,13171
27675,139422412,139427270,False,1,4858
27676,139422573,139427270,True,1,4697
27677,139430611,139430734,True,1,123
27678,139435159,139435499,True,2,340
27679,139451107,139472966,True,1,21859
27680,139453864,139514106,True,3,60242
27681,139454662,139454758,False,1,96
27682,139484457,139486019,True,1,1562
27683,139488487,139490232,True,2,1745
27684,139488487,139492168,True,1,3681
27685,139488487,139495327,True,1,6840
27686,139490517,139491142,True,1,625
27687,139490517,139492665,True,1,2148
27688,139494321,139494811,False,1,490
27689,139497826,139498472,True,3,646
27690,139507334,139510097,True,1,2763
27691,139510909,139512615,False,1,1706
27692,139510909,139515212,False,1,4303
27693,139516256,139527343,False,1,11087
27694,139521243,139618042,False,1,96799
27695,139543046,139555360,True,1,12314
27696,139552260,139554530,True,2,2270
27697,139554234,139567718,False,1,13484
27698,139554234,139589002,False,1,34768
27699,139577437,139716868,True,1,139431
27700,139589986,139590438,False,1,452
27701,139589986,139590438,True,1,452
27702,139592480,139606276,True,1,13796
27703,139592480,139617083,True,2,24603
27704,139624387,139626224,False,1,1837
27705,139625549,139740989,True,1,115440
27706,139626054,139741244,True,1,115190
27707,139649812,139660657,False,1,10845
27708,139659114,139661396,True,1,2282
27709,139666262,139683613,False,1,17351
27710,139694196,139700517,True,1,6321
27711,139708414,139709511,False,1,1097
27712,139728438,139738205,True,1,9767
27713,139728438,139788771,True,2,60333
27714,139728438,139820086,True,1,91648
27715,139730262,139755904,True,1,25642
27716,139730415,139755904,True,1,25489
27717,139731566,139756193,False,2,24627
27718,139731566,139756193,True,3,24627
27719,139731813,139732168,True,2,355
27720,139731813,139735233,True,1,3420
27721,139738473,139750186,True,1,11713
27722,139738669,139743177,True,1,4508
27723,139738669,139750382,False,1,11713
27724,139738669,139750382,True,3,11713
27725,139741147,139744867,True,2,3720
27726,139745431,139746666,True,1,1235
27727,139769119,139787759,False,1,18640
27728,139830871,139843657,True,1,12786
27729,139849227,139858263,True,1,9036
27730,139851005,139853773,False,1,2768
27731,139863167,139865375,True,1,2208
27732,139863291,139865371,False,1,2080
27733,139884818,139885477,True,1,659
27734,139903271,139910816,True,1,7545
27735,139903301,139918300,True,2,14999
27736,139908968,139912269,True,1,3301
27737,139918272,139922234,True,1,3962
27738,139925151,139926448,True,2,1297
27739,139938433,139977776,False,1,39343
27740,139938433,139977776,True,3,39343
27741,139958511,139959255,True,1,744
27742,139959250,139959509,True,1,259
27743,139969246,139969769,True,2,523
27744,139969746,139969966,True,1,220
27745,139969888,139970050,True,1,162
27746,139970408,139970951,True,1,543
27747,139970556,139971099,True,1,543
27748,139971656,139972721,True,4,1065
27749,140020836,140020913,False,1,77
27750,140020836,140022179,False,1,1343
27751,140022462,140022570,True,1,108
27752,140031545,140036749,False,1,5204
27753,140031545,140061087,False,3,29542
27754,140032343,140033061,True,1,718
27755,140033741,140034017,False,1,276
27756,140053948,140060140,False,1,6192
27757,140067191,140176929,True,1,109738
27758,140074900,140102539,True,1,27639
27759,140076897,140077787,True,1,890
27760,140086462,140087519,True,3,1057
27761,140090004,140093075,True,1,3071
27762,140095560,140098549,True,1,2989
27763,140096981,140112594,True,3,15613
27764,140097912,140110400,False,1,12488
27765,140099119,140101505,True,1,2386
27766,140114101,140121494,True,1,7393
27767,140132433,140133025,False,1,592
27768,140132487,140136196,True,1,3709
27769,140134555,140137871,False,1,3316
27770,140153620,140154138,False,1,518
27771,140155406,140164470,False,1,9064
27772,140156854,140203537,True,2,46683
27773,140183740,140188721,True,4,4981
27774,140195125,140195630,True,1,505
27775,140201908,140206320,False,2,4412
27776,140208942,140209036,True,2,94
27777,140216781,140226414,False,1,9633
27778,140233825,140235082,False,1,1257
27779,140233825,140235082,True,2,1257
27780,140235123,140236018,True,1,895
27781,140242224,140243298,False,1,1074
27782,140242224,140243298,True,1,1074
27783,140255192,140257337,False,1,2145
27784,140265441,140281792,False,1,16351
27785,140265441,140281792,True,3,16351
27786,140266828,140282341,False,1,15513
27787,140266828,140282341,True,2,15513
27788,140275376,140276128,True,2,752
27789,140284707,140285423,False,1,716
27790,140284707,140285423,True,4,716
27791,140287716,140289621,True,1,1905
27792,140291222,140291347,True,2,125
27793,140293155,140294446,True,2,1291
27794,140295871,140296250,True,1,379
27795,140295871,140308689,True,1,12818
27796,140307413,140307603,True,1,190
27797,140331723,140331887,True,1,164
27798,140344836,140345068,False,1,232
27799,140345714,140351251,True,1,5537
27800,140348682,140350282,False,1,1600
27801,140348682,140350282,True,1,1600
27802,140353075,140355252,True,1,2177
27803,140359393,140359692,True,2,299
27804,140364465,140364567,False,1,102
27805,140380026,140380755,True,1,729
27806,140380026,140405266,False,1,25240
27807,140386842,140386932,False,1,90
27808,140387526,140426447,True,1,38921
27809,140393192,140394139,True,2,947
27810,140409522,140409800,True,2,278
27811,140416232,140416775,True,1,543
27812,140416482,140416592,True,1,110
27813,140435928,140436013,True,1,85
27814,140441241,140463717,False,1,22476
27815,140441778,140455431,True,5,13653
27816,140451933,140483581,True,1,31648
27817,140451949,140483597,True,1,31648
27818,140462588,140464255,True,1,1667
27819,140466802,140467683,True,1,881
27820,140467801,140468686,True,1,885
27821,140467925,140468681,True,2,756
27822,140474550,140475398,False,3,848
27823,140474550,140475758,False,4,1208
27824,140474550,140477698,False,1,3148
27825,140485434,140488988,True,3,3554
27826,140485656,140487599,True,1,1943
27827,140489331,140495980,True,3,6649
27828,140507181,140507296,False,1,115
27829,140512314,140536973,True,1,24659
27830,140516192,140516392,False,1,200
27831,140527501,140528601,False,1,1100
27832,140530604,140534263,True,5,3659
27833,140533121,140535118,True,1,1997
27834,140537451,140539786,True,1,2335
27835,140550617,140556479,True,2,5862
27836,140551907,140554151,False,1,2244
27837,140553560,140554509,False,1,949
27838,140560064,140560787,True,3,723
27839,140560064,140561798,True,2,1734
27840,140573105,140573465,True,2,360
27841,140632547,140632711,True,1,164
27842,140632829,140636530,True,1,3701
27843,140633504,140645377,True,3,11873
27844,140633504,140650366,True,1,16862
27845,140638254,140826715,True,1,188461
27846,140640615,140652088,True,1,11473
27847,140640950,140641899,True,1,949
27848,140647580,140673539,True,1,25959
27849,140647700,140647884,True,2,184
27850,140652670,140656183,True,1,3513
27851,140655024,140655378,True,3,354
27852,140657519,140675209,True,1,17690
27853,140657704,140677538,True,1,19834
27854,140662573,140664282,True,3,1709
27855,140666318,140679571,True,3,13253
27856,140666318,140682931,True,2,16613
27857,140672762,140674708,True,2,1946
27858,140677108,140677626,True,3,518
27859,140679883,140680682,True,1,799
27860,140683085,140684270,True,8,1185
27861,140689821,140690336,False,1,515
27862,140692510,140696806,True,2,4296
27863,140692510,140698207,True,1,5697
27864,140692607,140764966,True,2,72359
27865,140699234,140699412,True,1,178
27866,140699587,140700699,False,1,1112
27867,140702169,140706400,True,1,4231
27868,140702724,140703343,True,1,619
27869,140708930,140709233,False,1,303
27870,140716909,140717311,False,1,402
27871,140728523,140729013,False,1,490
27872,140729494,140732078,True,3,2584
27873,140729494,140732591,True,1,3097
27874,140735455,140742461,True,1,7006
27875,140740182,140742165,True,1,1983
27876,140746691,140748367,True,1,1676
27877,140754712,140764771,True,1,10059
27878,140758043,140786856,True,2,28813
27879,140758043,140792965,True,1,34922
27880,140761774,140765281,True,5,3507
27881,140771803,140771980,False,1,177
27882,140771803,140771980,True,3,177
27883,140781572,140786082,True,1,4510
27884,140800419,140823837,False,1,23418
27885,140810387,140813025,True,1,2638
27886,140810387,140819134,True,1,8747
27887,140819553,140825795,True,1,6242
27888,140826389,140827237,True,1,848
27889,140829102,140830043,True,2,941
27890,140845028,140845301,False,1,273
27891,140848307,140849974,False,1,1667
27892,140860087,141233887,False,1,373800
27893,140864534,140864920,False,4,386
27894,140864534,140864920,True,3,386
27895,140865453,140865807,False,1,354
27896,140870201,140878601,True,1,8400
27897,140876552,140878054,False,1,1502
27898,140876552,140878054,True,2,1502
27899,140886240,140886595,True,1,355
27900,140887929,140895487,True,1,7558
27901,140909503,140914327,True,6,4824
27902,140912541,140913977,True,1,1436
27903,140920431,140920548,True,3,117
27904,140924713,140925324,False,2,611
27905,140938583,140938928,True,2,345
27906,140954537,140955078,False,1,541
27907,140962009,140963180,False,1,1171
27908,140962009,140963180,True,4,1171
27909,140962009,140977601,True,1,15592
27910,140962027,140963192,False,1,1165
27911,140962027,140963192,True,1,1165
27912,140968697,140971017,True,1,2320
27913,140969908,140971331,True,1,1423
27914,140970638,140971720,True,2,1082
27915,140977030,140985567,True,3,8537
27916,140977030,140991247,True,1,14217
27917,140986161,140986444,False,1,283
27918,141000269,141003860,False,1,3591
27919,141003828,141027333,True,1,23505
27920,141004433,141005920,True,1,1487
27921,141006612,141007286,True,2,674
27922,141006612,141013518,True,1,6906
27923,141006612,141014668,True,1,8056
27924,141010362,141017980,False,1,7618
27925,141017321,141023703,False,1,6382
27926,141017321,141023703,True,1,6382
27927,141023973,141026415,False,1,2442
27928,141023973,141026415,True,6,2442
27929,141028446,141030481,True,1,2035
27930,141028550,141030514,True,1,1964
27931,141029518,141029731,False,1,213
27932,141029518,141029731,True,3,213
27933,141032335,141034172,False,1,1837
27934,141043347,141043612,True,1,265
27935,141043672,141043761,True,1,89
27936,141047716,141051077,False,1,3361
27937,141047716,141051077,True,1,3361
27938,141074182,141091543,False,1,17361
27939,141080107,141080410,True,1,303
27940,141100717,141100806,True,1,89
27941,141115521,141118178,True,1,2657
27942,141152979,141165873,True,1,12894
27943,141170128,141173409,False,1,3281
27944,141170128,141173409,True,2,3281
27945,141170128,141176178,True,1,6050
27946,141172457,141173460,True,2,1003
27947,141174983,141229005,True,4,54022
27948,141175960,141229646,True,1,53686
27949,141185603,141188902,True,1,3299
27950,141189462,141193419,False,1,3957
27951,141195548,141398056,True,1,202508
27952,141216314,141216672,True,1,358
27953,141222072,141224652,True,1,2580
27954,141227749,141294246,True,2,66497
27955,141234590,141284783,True,1,50193
27956,141253083,141253909,False,4,826
27957,141253083,141253909,True,1,826
27958,141273826,141273920,True,1,94
27959,141274033,141308683,True,1,34650
27960,141275595,141309403,True,2,33808
27961,141275724,141277115,True,1,1391
27962,141285885,141287024,True,2,1139
27963,141286055,141286788,False,1,733
27964,141297431,141389151,False,2,91720
27965,141315926,141338343,True,1,22417
27966,141322260,141327498,True,2,5238
27967,141342827,141358657,True,1,15830
27968,141342827,141358660,True,4,15833
27969,141343454,141343723,False,2,269
27970,141343454,141344942,False,4,1488
27971,141352409,141354759,True,4,2350
27972,141353203,141355309,True,1,2106
27973,141353203,141356798,True,2,3595
27974,141358959,141359875,False,1,916
27975,141363217,141370615,False,1,7398
27976,141374666,141381247,True,1,6581
27977,141393458,141393605,True,1,147
27978,141393618,141393909,True,1,291
27979,141414753,141416806,True,1,2053
27980,141417866,141418282,False,1,416
27981,141421664,141422476,True,1,812
27982,141430124,141434776,True,1,4652
27983,141431946,141435438,True,1,3492
27984,141432699,141435755,True,1,3056
27985,141443334,141448063,True,4,4729
27986,141453214,141461221,True,2,8007
27987,141461952,141463330,True,1,1378
27988,141462461,141463389,True,1,928
27989,141497490,141508654,True,1,11164
27990,141503357,141505845,True,3,2488
27991,141506097,141508937,True,2,2840
27992,141506097,141508967,True,1,2870
27993,141520911,141554048,True,1,33137
27994,141531626,141566261,True,1,34635
27995,141534943,141541431,True,2,6488
27996,141578114,141578876,True,1,762
27997,141584963,141587686,True,5,2723
27998,141593633,141595058,True,2,1425
27999,141596245,141598541,True,1,2296
28000,141596585,141598189,True,1,1604
28001,141636357,141636771,False,1,414
28002,141637232,141639128,False,1,1896
28003,141641282,141652617,False,1,11335
28004,141641282,141652617,True,1,11335
28005,141641286,141652617,True,1,11331
28006,141641383,141652617,True,1,11234
28007,141642283,141643003,True,2,720
28008,141644462,141648066,False,1,3604
28009,141656388,141663001,False,1,6613
28010,141669714,141703216,False,1,33502
28011,141673060,141675603,True,1,2543
28012,141673074,141674051,True,1,977
28013,141673318,141674051,True,1,733
28014,141683251,141684970,False,1,1719
28015,141683251,141684970,True,1,1719
28016,141695819,141704665,True,1,8846
28017,141695819,141711452,True,1,15633
28018,141713939,141716965,False,2,3026
28019,141713939,141716965,True,3,3026
28020,141723389,141725785,True,2,2396
28021,141723971,141765854,False,1,41883
28022,141743732,141745282,True,1,1550
28023,141754166,141758537,False,1,4371
28024,141754166,141758537,True,3,4371
28025,141766495,141771865,False,1,5370
28026,141766495,141771865,True,2,5370
28027,141767943,141776559,True,4,8616
28028,141780082,141789223,True,3,9141
28029,141788362,141790572,True,1,2210
28030,141796792,141798513,True,1,1721
28031,141800938,141802267,True,1,1329
28032,141806232,141807103,True,2,871
28033,141825922,141828880,True,5,2958
28034,141832370,141834937,True,1,2567
28035,141834196,141837714,False,1,3518
28036,141837853,141842937,True,1,5084
28037,141852526,141861375,True,3,8849
28038,141866248,141867869,False,1,1621
28039,141868617,141868722,True,1,105
28040,141869599,141870909,True,1,1310
28041,141873904,141885745,True,1,11841
28042,141880310,141882266,True,1,1956
28043,141880310,141885733,True,1,5423
28044,141896358,141899380,True,3,3022
28045,141905971,141907016,True,1,1045
28046,141906526,141907571,True,1,1045
28047,141920863,141922438,True,1,1575
28048,141928424,141931418,True,1,2994
28049,141940629,141942745,False,1,2116
28050,141944118,141964927,True,1,20809
28051,141960312,141967019,True,1,6707
28052,141967636,141968211,True,1,575
28053,141971838,141973758,True,1,1920
28054,141980727,141990589,True,1,9862
28055,141984603,141991873,False,1,7270
28056,141985647,141991554,True,1,5907
28057,141998697,142001083,True,1,2386
28058,142008955,142009208,True,1,253
28059,142012406,142018903,False,1,6497
28060,142012406,142018903,True,9,6497
28061,142014889,142033586,True,1,18697
28062,142030268,142030694,True,1,426
28063,142034264,142035612,False,1,1348
28064,142035646,142037872,True,1,2226
28065,142039361,142043624,True,1,4263
28066,142040046,142041672,True,1,1626
28067,142050144,142057801,True,2,7657
28068,142059619,142060516,True,1,897
28069,142059619,142072038,False,1,12419
28070,142059619,142072038,True,3,12419
28071,142064909,142082334,False,2,17425
28072,142064909,142082334,True,4,17425
28073,142072116,142072644,True,1,528
28074,142072290,142072645,True,1,355
28075,142102616,142103427,True,3,811
28076,142109706,142110992,True,1,1286
28077,142115673,142116172,True,1,499
28078,142118714,142120788,True,1,2074
28079,142118932,142119238,True,1,306
28080,142119389,142122620,True,1,3231
28081,142122790,142126592,True,1,3802
28082,142124554,142124650,True,1,96
28083,142131133,142159718,True,2,28585
28084,142151379,142179190,True,1,27811
28085,142153581,142175991,False,1,22410
28086,142157368,142182183,True,2,24815
28087,142183686,142188697,True,1,5011
28088,142201672,142203547,True,1,1875
28089,142216714,142218859,True,1,2145
28090,142217755,142242782,True,1,25027
28091,142235619,142249636,True,1,14017
28092,142246511,142248098,True,1,1587
28093,142246511,142259246,True,1,12735
28094,142249343,142252520,True,1,3177
28095,142255717,142275945,True,1,20228
28096,142262154,142482864,True,1,220710
28097,142272376,142274146,True,1,1770
28098,142276128,142300199,True,2,24071
28099,142287826,142289993,True,1,2167
28100,142291425,142310862,True,1,19437
28101,142292341,142294312,True,2,1971
28102,142303906,142306948,True,1,3042
28103,142322586,142326524,True,1,3938
28104,142326199,142333783,True,2,7584
28105,142328643,142330370,False,1,1727
28106,142328643,142330370,True,1,1727
28107,142328797,142330795,True,2,1998
28108,142332371,142335627,True,1,3256
28109,142337127,142338832,True,1,1705
28110,142344349,142345544,False,1,1195
28111,142348669,142348778,True,1,109
28112,142370208,142370848,True,3,640
28113,142376016,142376163,True,1,147
28114,142376051,142376163,True,1,112
28115,142378695,142381816,True,3,3121
28116,142381659,142382138,True,1,479
28117,142383560,142387571,True,1,4011
28118,142392434,142394107,True,4,1673
28119,142402733,142403351,True,1,618
28120,142409398,142412306,True,1,2908
28121,142409398,142426793,True,1,17395
28122,142411519,142411799,True,2,280
28123,142422671,142454670,True,1,31999
28124,142428912,142429110,True,2,198
28125,142453051,142454309,True,2,1258
28126,142456999,142457728,True,2,729
28127,142457631,142458132,True,3,501
28128,142467493,142468301,True,1,808
28129,142471034,142472626,True,1,1592
28130,142476149,142480855,True,1,4706
28131,142489262,142493354,True,1,4092
28132,142494252,142494384,True,1,132
28133,142497362,142519794,True,3,22432
28134,142497723,142499006,True,1,1283
28135,142502534,142502638,False,2,104
28136,142527355,142528584,True,1,1229
28137,142532966,142535817,True,1,2851
28138,142553331,142565739,True,1,12408
28139,142562024,142562233,True,1,209
28140,142562513,142586780,True,1,24267
28141,142562513,142587792,True,1,25279
28142,142591249,142593037,True,2,1788
28143,142592612,142634138,True,1,41526
28144,142593495,142593648,True,1,153
28145,142636044,142638981,True,3,2937
28146,142636577,142646021,False,3,9444
28147,142636577,142737479,True,2,100902
28148,142636577,142796021,True,1,159444
28149,142641007,142677744,True,1,36737
28150,142641007,142753704,True,1,112697
28151,142656067,142805973,True,1,149906
28152,142664590,142664754,True,1,164
28153,142665601,142675258,True,2,9657
28154,142674057,142688139,True,1,14082
28155,142675483,142675604,True,1,121
28156,142675841,142677555,True,1,1714
28157,142678041,142680585,False,1,2544
28158,142694520,142694972,True,1,452
28159,142699142,142701359,False,1,2217
28160,142699204,142701397,True,1,2193
28161,142699204,142768882,True,1,69678
28162,142707851,142711329,True,1,3478
28163,142708008,142708297,True,1,289
28164,142708052,142711787,True,1,3735
28165,142714479,142714624,False,1,145
28166,142715327,142717469,True,2,2142
28167,142728421,142743718,True,1,15297
28168,142748841,142787751,True,3,38910
28169,142755322,142819557,False,1,64235
28170,142755322,142819557,True,3,64235
28171,142756653,142820313,True,1,63660
28172,142768668,142768775,True,2,107
28173,142780071,142781236,True,1,1165
28174,142785404,142798669,False,1,13265
28175,142785404,142798669,True,2,13265
28176,142803203,142807834,True,2,4631
28177,142803203,142818158,False,1,14955
28178,142806347,142807067,True,1,720
28179,142806659,142814640,True,3,7981
28180,142825532,142826840,True,1,1308
28181,142836856,142837558,True,2,702
28182,142853054,142882185,True,1,29131
28183,142853054,142883198,True,1,30144
28184,142867682,142880987,True,1,13305
28185,142873879,142876441,True,1,2562
28186,142916064,142917016,True,1,952
28187,142949703,142983898,True,1,34195
28188,142951188,142955022,True,1,3834
28189,142957886,142959108,False,1,1222
28190,142959635,142965440,True,1,5805
28191,142965287,142968646,True,2,3359
28192,142965293,142966000,True,1,707
28193,142965293,142968649,True,2,3356
28194,142965293,142972170,True,1,6877
28195,142972692,142980849,True,2,8157
28196,142985074,142985532,True,1,458
28197,142989141,142989616,True,1,475
28198,142989331,142989723,True,1,392
28199,142992469,142993339,False,1,870
28200,142997234,142999383,False,2,2149
28201,142997234,142999383,True,3,2149
28202,143007606,143079603,True,1,71997
28203,143007606,143094003,True,1,86397
28204,143011708,143019310,False,1,7602
28205,143014031,143020762,False,1,6731
28206,143018150,143020104,True,4,1954
28207,143025460,143026683,False,1,1223
28208,143032210,143034743,True,4,2533
28209,143038043,143041985,True,3,3942
28210,143039186,143041391,False,1,2205
28211,143041879,143084857,True,1,42978
28212,143043513,143044183,True,2,670
28213,143043581,143044145,True,4,564
28214,143044017,143045410,False,1,1393
28215,143047784,143051857,True,1,4073
28216,143059793,143060332,True,1,539
28217,143059793,143061430,True,1,1637
28218,143070422,143083937,True,1,13515
28219,143088548,143092688,True,1,4140
28220,143094102,143104351,False,1,10249
28221,143099291,143120946,False,1,21655
28222,143099291,143120946,True,3,21655
28223,143099638,143100281,True,1,643
28224,143117879,143134439,True,1,16560
28225,143117879,143134765,True,2,16886
28226,143117889,143134765,True,2,16876
28227,143120237,143130583,True,1,10346
28228,143120551,143130714,True,1,10163
28229,143124116,143143766,True,12,19650
28230,143137636,143138809,True,1,1173
28231,143137864,143139943,False,1,2079
28232,143141664,143198887,True,1,57223
28233,143142520,143142599,True,1,79
28234,143143046,143175194,True,1,32148
28235,143153283,143158729,True,1,5446
28236,143153454,143203672,True,1,50218
28237,143163372,143168650,True,3,5278
28238,143176163,143195037,True,1,18874
28239,143176163,143215929,True,2,39766
28240,143178652,143306588,False,1,127936
28241,143179054,143184949,True,1,5895
28242,143200497,143207529,True,1,7032
28243,143202940,143203365,True,1,425
28244,143218935,143219088,True,1,153
28245,143219656,143220236,True,1,580
28246,143232535,143234196,False,1,1661
28247,143232535,143234196,True,4,1661
28248,143233205,143234196,True,1,991
28249,143241416,143242079,False,1,663
28250,143246471,143248979,True,1,2508
28251,143256462,143257569,True,1,1107
28252,143279937,143308038,True,1,28101
28253,143279937,143311561,True,3,31624
28254,143291120,143297129,True,1,6009
28255,143301341,143311777,True,3,10436
28256,143320491,143323323,True,1,2832
28257,143320654,143323323,True,3,2669
28258,143344023,143346160,False,1,2137
28259,143361968,143388763,False,1,26795
28260,143361968,143388763,True,7,26795
28261,143362798,143365542,True,2,2744
28262,143368076,143371507,True,3,3431
28263,143368459,143392659,True,1,24200
28264,143368989,143393189,True,1,24200
28265,143387844,143402046,True,2,14202
28266,143387894,143401842,True,7,13948
28267,143420022,143420260,True,1,238
28268,143420022,143420928,True,2,906
28269,143421166,143421503,True,2,337
28270,143421370,143421633,True,1,263
28271,143422030,143422367,True,1,337
28272,143424264,143424666,True,1,402
28273,143428494,143428841,True,5,347
28274,143438125,143438245,True,1,120
28275,143451246,143451392,True,2,146
28276,143456917,143457271,True,3,354
28277,143461202,143462787,True,1,1585
28278,143462318,143467598,True,5,5280
28279,143472460,143502744,True,1,30284
28280,143473026,143502950,True,1,29924
28281,143475992,143504528,True,1,28536
28282,143479351,143482301,True,1,2950
28283,143481552,143489747,False,1,8195
28284,143481552,143489747,True,2,8195
28285,143492045,143502480,True,1,10435
28286,143529966,143531414,True,5,1448
28287,143536323,143584471,True,1,48148
28288,143536323,143592645,True,2,56322
28289,143562622,143565804,False,1,3182
28290,143566913,143569149,False,1,2236
28291,143575077,143575168,True,1,91
28292,143575311,143576033,True,1,722
28293,143578318,143616432,True,3,38114
28294,143583307,143590717,False,1,7410
28295,143583307,143590717,True,6,7410
28296,143583307,143595916,True,1,12609
28297,143583307,143597368,False,1,14061
28298,143585534,143588123,False,1,2589
28299,143599688,143600909,True,4,1221
28300,143600690,143603865,True,1,3175
28301,143606965,143620113,True,1,13148
28302,143617297,143617670,True,1,373
28303,143625112,143647710,True,1,22598
28304,143632089,143638123,True,1,6034
28305,143636074,143638555,True,1,2481
28306,143640075,143647388,True,1,7313
28307,143640307,143647539,True,1,7232
28308,143641606,143641764,True,1,158
28309,143641614,143641760,True,1,146
28310,143642784,143644399,True,1,1615
28311,143642784,143651421,True,1,8637
28312,143657059,143658305,True,1,1246
28313,143667621,143731941,False,1,64320
28314,143667621,143731941,True,3,64320
28315,143679386,143792433,True,2,113047
28316,143693584,143693761,True,2,177
28317,143717353,143731877,True,1,14524
28318,143718907,143723046,True,1,4139
28319,143719013,143723061,True,1,4048
28320,143723075,143724295,True,1,1220
28321,143741877,143927122,True,3,185245
28322,143746107,143746696,True,2,589
28323,143759900,143761804,True,1,1904
28324,143788157,143789259,True,6,1102
28325,143788157,143791621,True,1,3464
28326,143797633,143800158,False,1,2525
28327,143797633,143800158,True,4,2525
28328,143797633,143800255,False,2,2622
28329,143797633,143802911,True,1,5278
28330,143797633,143804023,False,1,6390
28331,143797633,143804143,False,1,6510
28332,143801404,143802219,True,1,815
28333,143801404,143803809,True,1,2405
28334,143801933,143804166,True,1,2233
28335,143806557,143809485,True,1,2928
28336,143822308,143823552,True,3,1244
28337,143823379,143831446,False,1,8067
28338,143841426,143843500,True,3,2074
28339,143855781,143857421,True,1,1640
28340,143855781,143857433,True,1,1652
28341,143855787,143857421,True,1,1634
28342,143855787,143857433,True,1,1646
28343,143856694,143856932,True,1,238
28344,143858887,143878922,True,3,20035
28345,143858887,143884035,True,1,25148
28346,143858887,143884639,True,1,25752
28347,143867865,143913359,True,1,45494
28348,143872091,143875113,True,1,3022
28349,143878221,143878314,True,1,93
28350,143879033,143890614,True,1,11581
28351,143888855,143895367,True,1,6512
28352,143901362,143902264,True,1,902
28353,143912959,143915050,True,1,2091
28354,143925527,143927212,True,1,1685
28355,143927021,143927393,True,1,372
28356,143966453,143968176,True,1,1723
28357,143981431,143982935,True,1,1504
28358,143992115,144050314,True,2,58199
28359,143997349,144001470,True,1,4121
28360,144003529,144003682,False,1,153
28361,144007723,144007851,True,1,128
28362,144008128,144008533,True,6,405
28363,144026921,144061368,True,3,34447
28364,144030295,144035106,True,1,4811
28365,144047601,144105383,True,1,57782
28366,144080195,144121146,True,2,40951
28367,144085326,144088589,True,1,3263
28368,144088762,144089898,True,1,1136
28369,144100466,144100786,True,1,320
28370,144100585,144107528,True,1,6943
28371,144101204,144106914,True,1,5710
28372,144106120,144155293,True,3,49173
28373,144106642,144107283,True,1,641
28374,144110374,144139759,True,1,29385
28375,144116036,144125657,True,1,9621
28376,144119989,144142342,False,1,22353
28377,144119989,144142342,True,6,22353
28378,144119989,144159032,False,1,39043
28379,144119989,144159032,True,1,39043
28380,144125741,144127673,True,1,1932
28381,144129908,144130206,True,1,298
28382,144129998,144150422,True,1,20424
28383,144144157,144144429,False,1,272
28384,144160467,144163246,True,2,2779
28385,144170340,144189679,False,1,19339
28386,144177063,144178565,True,4,1502
28387,144184256,144185240,True,2,984
28388,144194283,144204913,True,1,10630
28389,144204615,144223184,True,1,18569
28390,144206094,144206714,True,2,620
28391,144206916,144212147,True,1,5231
28392,144221322,144233056,True,7,11734
28393,144224996,144256627,False,1,31631
28394,144224996,144256627,True,2,31631
28395,144237744,144238583,True,2,839
28396,144239456,144241639,True,3,2183
28397,144242052,144326021,True,1,83969
28398,144250410,144251169,False,1,759
28399,144255564,144257650,True,2,2086
28400,144261628,144263262,False,1,1634
28401,144288007,144288139,True,1,132
28402,144288093,144288229,True,1,136
28403,144297725,144312235,True,1,14510
28404,144306248,144306743,False,1,495
28405,144306248,144306743,True,2,495
28406,144306983,144309806,True,1,2823
28407,144316140,144316316,False,1,176
28408,144317498,144317800,True,1,302
28409,144327165,144330614,True,1,3449
28410,144327165,144330669,True,1,3504
28411,144328162,144343528,True,1,15366
28412,144334090,144335384,True,1,1294
28413,144336310,144338510,True,1,2200
28414,144367330,144367830,True,1,500
28415,144380603,144381256,True,1,653
28416,144384535,144386731,True,1,2196
28417,144387688,144403247,False,1,15559
28418,144399643,144399849,True,1,206
28419,144399678,144399849,True,2,171
28420,144400976,144408917,False,1,7941
28421,144403617,144425262,True,1,21645
28422,144409991,144420396,True,2,10405
28423,144413955,144414795,False,1,840
28424,144419550,144428317,True,1,8767
28425,144423619,144430390,True,1,6771
28426,144467077,144482049,True,1,14972
28427,144467077,144488669,True,1,21592
28428,144467077,144499334,True,3,32257
28429,144469056,144472807,True,1,3751
28430,144477378,144524240,True,1,46862
28431,144489723,144489985,True,1,262
28432,144503290,144511176,True,1,7886
28433,144503763,144516130,True,3,12367
28434,144520084,144522671,False,1,2587
28435,144520133,144523670,False,1,3537
28436,144530300,144608048,True,1,77748
28437,144540869,144548329,False,1,7460
28438,144540869,144548329,True,1,7460
28439,144540869,144548332,True,1,7463
28440,144563654,144563773,True,1,119
28441,144575821,144576458,True,6,637
28442,144598853,144600191,True,1,1338
28443,144600313,144601221,False,2,908
28444,144600313,144602131,False,2,1818
28445,144602898,144606707,False,1,3809
28446,144603254,144605183,True,1,1929
28447,144626812,144629466,True,1,2654
28448,144632823,144698765,False,1,65942
28449,144644877,144646912,True,5,2035
28450,144657921,144658001,True,1,80
28451,144658042,144662682,True,1,4640
28452,144665496,144667987,True,1,2491
28453,144670858,144673417,True,1,2559
28454,144684304,144695417,False,1,11113
28455,144690584,144695884,True,3,5300
28456,144696492,144698143,True,1,1651
28457,144700391,144711099,True,1,10708
28458,144706424,144708660,True,1,2236
28459,144708598,144713913,True,1,5315
28460,144716040,144717221,True,2,1181
28461,144716114,144716516,True,3,402
28462,144723120,144758269,True,1,35149
28463,144727531,144729249,True,2,1718
28464,144791962,144792457,True,1,495
28465,144792839,144793198,True,6,359
28466,144797766,145217617,True,1,419851
28467,144798813,144830642,True,2,31829
28468,144799804,144831272,False,1,31468
28469,144799804,144831272,True,8,31468
28470,144813033,144817645,True,1,4612
28471,144813482,144838514,True,1,25032
28472,144818648,144840896,True,1,22248
28473,144818698,144840842,True,1,22144
28474,144821435,144842281,True,1,20846
28475,144821435,144842546,True,1,21111
28476,144832910,144835518,True,2,2608
28477,144837967,144838032,False,1,65
28478,144837967,144838036,True,3,69
28479,144838183,144838265,True,3,82
28480,144849067,144849446,True,1,379
28481,144851531,144851932,True,1,401
28482,144855946,144863548,True,2,7602
28483,144859731,144865717,True,1,5986
28484,144860451,144860565,True,1,114
28485,144860851,144860962,True,1,111
28486,144865198,144866868,True,2,1670
28487,144869500,144869787,False,1,287
28488,144869503,144869884,False,1,381
28489,144871677,144895161,True,2,23484
28490,144871677,144907199,False,1,35522
28491,144871677,144907199,True,2,35522
28492,144872849,144875838,True,1,2989
28493,144879274,144882209,True,1,2935
28494,144879296,144882025,False,1,2729
28495,144879296,144889118,False,1,9822
28496,144880592,144880677,False,1,85
28497,144880592,144880677,True,2,85
28498,144891601,144895563,False,1,3962
28499,144906499,144906758,True,2,259
28500,144909322,144910209,True,1,887
28501,144925403,144932194,True,1,6791
28502,144925403,144933190,True,2,7787
28503,144925403,144939947,True,1,14544
28504,144926132,144929083,False,1,2951
28505,144927213,145030107,False,1,102894
28506,144931960,144932517,True,4,557
28507,144936875,144937185,False,3,310
28508,144938511,144938774,False,1,263
28509,144938718,144938907,True,1,189
28510,144953285,144953692,False,1,407
28511,144953285,144956551,False,2,3266
28512,144953285,144984527,False,2,31242
28513,144953285,144984532,False,1,31247
28514,144981988,144982840,True,3,852
28515,144983466,144984182,True,9,716
28516,144985810,144988175,True,1,2365
28517,144987668,144988636,True,1,968
28518,145020017,145021649,False,1,1632
28519,145036351,145037028,True,1,677
28520,145038293,145039145,True,2,852
28521,145039081,145041176,True,1,2095
28522,145051058,145053221,True,5,2163
28523,145062211,145063262,False,1,1051
28524,145062211,145063262,True,3,1051
28525,145067419,145067761,False,2,342
28526,145067419,145067761,True,2,342
28527,145067670,145068506,False,1,836
28528,145069058,145069456,True,1,398
28529,145070000,145077319,True,1,7319
28530,145072249,145073015,True,1,766
28531,145075079,145076202,True,1,1123
28532,145075667,145076622,True,1,955
28533,145076845,145077659,True,1,814
28534,145084793,145085906,True,1,1113
28535,145097708,145099709,True,3,2001
28536,145108371,145108490,True,1,119
28537,145118248,145118899,False,1,651
28538,145138442,145158464,True,2,20022
28539,145142579,145208932,False,1,66353
28540,145151585,145152268,False,1,683
28541,145151585,145152268,True,1,683
28542,145152362,145154465,True,1,2103
28543,145155750,145156643,False,1,893
28544,145155750,145156643,True,6,893
28545,145162184,145167712,True,1,5528
28546,145193295,145275089,True,1,81794
28547,145214933,145216083,True,1,1150
28548,145214997,145219276,True,3,4279
28549,145258123,145258489,False,1,366
28550,145269425,145272584,False,1,3159
28551,145269425,145272584,True,1,3159
28552,145272258,145273562,True,2,1304
28553,145275435,145276118,True,1,683
28554,145276983,145277183,True,2,200
28555,145287071,145288173,True,1,1102
28556,145314727,145321927,True,1,7200
28557,145315805,145319509,True,1,3704
28558,145317643,145317994,False,1,351
28559,145317643,145317994,True,1,351
28560,145333865,145346987,True,1,13122
28561,145334680,145340440,True,1,5760
28562,145335052,145392648,True,3,57596
28563,145381072,145396347,True,1,15275
28564,145381415,145381659,True,1,244
28565,145381415,145389608,False,1,8193
28566,145381841,145382313,False,1,472
28567,145381841,145382313,True,5,472
28568,145383861,145386369,True,1,2508
28569,145387985,145392478,False,1,4493
28570,145398299,145446297,False,1,47998
28571,145427600,145428027,False,1,427
28572,145434034,145434108,True,1,74
28573,145434039,145434108,True,1,69
28574,145434250,145434334,True,2,84
28575,145454040,145457096,True,3,3056
28576,145465606,145469641,True,1,4035
28577,145466214,145469863,True,1,3649
28578,145466859,145470260,True,1,3401
28579,145466859,145471746,True,1,4887
28580,145484471,145484730,True,1,259
28581,145484787,145484875,False,1,88
28582,145484787,145484875,True,1,88
28583,145485382,145485382,True,1,0
28584,145489809,145489957,False,1,148
28585,145490176,145502899,True,1,12723
28586,145490633,145526904,False,1,36271
28587,145508758,145509654,True,1,896
28588,145511296,145511819,False,1,523
28589,145513007,145631506,False,2,118499
28590,145534021,145577072,True,1,43051
28591,145534682,145534782,True,2,100
28592,145537206,145540475,False,1,3269
28593,145545337,145546022,True,3,685
28594,145545337,145546025,True,1,688
28595,145566399,145580224,False,1,13825
28596,145566399,145580224,True,3,13825
28597,145570598,145572032,False,1,1434
28598,145588632,145589206,True,1,574
28599,145588873,145589206,True,2,333
28600,145598414,145640492,True,2,42078
28601,145618384,145640113,False,1,21729
28602,145639532,145643937,True,2,4405
28603,145662311,145675102,False,1,12791
28604,145677859,145678580,False,1,721
28605,145677859,145678580,True,1,721
28606,145680817,145682373,True,1,1556
28607,145696701,145697253,True,1,552
28608,145697940,145703264,True,1,5324
28609,145710750,145711236,True,1,486
28610,145717687,145717814,False,1,127
28611,145717687,145717814,True,8,127
28612,145723334,145724682,True,2,1348
28613,145723334,145725655,True,1,2321
28614,145726338,145727137,True,1,799
28615,145748056,145753095,True,1,5039
28616,145748078,145749004,True,2,926
28617,145775579,145775980,False,1,401
28618,145777724,145810056,True,1,32332
28619,145784838,145835460,True,3,50622
28620,145795437,145891820,True,1,96383
28621,145795437,145901275,True,1,105838
28622,145809978,145839476,True,1,29498
28623,145809978,145899148,True,1,89170
28624,145823572,145826423,True,1,2851
28625,145823572,145830080,True,1,6508
28626,145826346,145827722,True,2,1376
28627,145840797,145841062,True,2,265
28628,145844129,145902646,True,2,58517
28629,145845438,145865987,True,2,20549
28630,145845907,145920110,True,1,74203
28631,145852485,145869618,True,1,17133
28632,145853408,145869936,True,2,16528
28633,145858819,145868366,True,2,9547
28634,145859202,145868525,True,1,9323
28635,145862826,145863865,True,1,1039
28636,145863898,145869415,True,1,5517
28637,145863931,145869382,True,1,5451
28638,145868836,145869532,True,1,696
28639,145875043,145894900,True,1,19857
28640,145894199,145895888,True,1,1689
28641,145894566,145894836,True,3,270
28642,145902402,145902944,False,2,542
28643,145902402,145902944,True,3,542
28644,145910151,145910979,True,1,828
28645,145920195,145920654,True,6,459
28646,145923059,145923474,True,1,415
28647,145924998,145930289,True,1,5291
28648,145936850,145940476,False,1,3626
28649,145940877,145964155,True,1,23278
28650,145945112,146011867,True,2,66755
28651,145951243,145958899,True,2,7656
28652,145951243,145958932,True,1,7689
28653,145951243,145982322,True,1,31079
28654,145952790,145983053,True,1,30263
28655,145954372,145954729,False,1,357
28656,145957111,145966035,True,2,8924
28657,145957111,145980558,True,1,23447
28658,145957424,145966035,True,1,8611
28659,145961374,146026325,True,2,64951
28660,145962138,145964288,True,1,2150
28661,145966697,145989959,True,1,23262
28662,145966697,145990714,True,1,24017
28663,145967943,145979323,True,1,11380
28664,145968578,145968793,True,5,215
28665,146002433,146027285,True,1,24852
28666,146015836,146016125,False,2,289
28667,146015836,146016125,True,4,289
28668,146016264,146017496,True,1,1232
28669,146017746,146021950,True,1,4204
28670,146022301,146022549,True,1,248
28671,146030322,146032001,True,1,1679
28672,146042537,146077588,True,1,35051
28673,146057525,146058832,False,1,1307
28674,146057888,146058820,False,1,932
28675,146070112,146070256,True,2,144
28676,146086672,146086790,False,1,118
28677,146086962,146088591,True,1,1629
28678,146088304,146089386,False,1,1082
28679,146088940,146091602,True,3,2662
28680,146088943,146091602,True,3,2659
28681,146092340,146093344,True,2,1004
28682,146152712,146154936,False,1,2224
28683,146152999,146176729,True,1,23730
28684,146158076,146161520,True,4,3444
28685,146164599,146165920,True,1,1321
28686,146167812,146169065,True,1,1253
28687,146168174,146169279,True,1,1105
28688,146170431,146174714,True,1,4283
28689,146172078,146172612,True,1,534
28690,146174948,146187559,True,1,12611
28691,146175626,146187867,True,1,12241
28692,146179078,146179179,True,1,101
28693,146195900,146195992,False,2,92
28694,146195900,146195992,True,4,92
28695,146203765,146203986,True,1,221
28696,146209250,146209567,False,1,317
28697,146212555,146212637,True,2,82
28698,146218840,146237503,True,1,18663
28699,146221117,146235155,False,1,14038
28700,146228348,146228592,True,2,244
28701,146229376,146229952,True,1,576
28702,146230417,146232329,True,1,1912
28703,146234816,146235583,True,3,767
28704,146235135,146238762,False,1,3627
28705,146244690,146252565,True,1,7875
28706,146244690,146261214,True,1,16524
28707,146253051,146253457,True,1,406
28708,146253056,146253165,False,1,109
28709,146253056,146253165,True,1,109
28710,146253131,146253225,False,1,94
28711,146258108,146265225,False,2,7117
28712,146258119,146258711,True,1,592
28713,146263688,146274102,True,2,10414
28714,146263688,146274992,True,1,11304
28715,146274705,146277605,True,2,2900
28716,146290104,146296039,True,1,5935
28717,146296106,146301151,True,1,5045
28718,146298818,146298967,False,1,149
28719,146300332,146302001,True,1,1669
28720,146301445,146301681,True,4,236
28721,146302286,146314421,True,9,12135
28722,146304525,146304779,True,1,254
28723,146313765,146356272,True,5,42507
28724,146313765,146426527,True,1,112762
28725,146328100,146333573,True,1,5473
28726,146328320,146334669,True,1,6349
28727,146328320,146340974,True,1,12654
28728,146328458,146328575,False,2,117
28729,146341392,146353271,True,1,11879
28730,146341392,146357422,True,5,16030
28731,146341392,146364739,False,2,23347
28732,146359291,146361255,True,1,1964
28733,146363603,146365100,True,1,1497
28734,146399238,146405656,True,1,6418
28735,146403485,146406216,True,1,2731
28736,146403485,146407512,True,1,4027
28737,146449481,146451688,True,1,2207
28738,146449796,146451211,True,1,1415
28739,146466320,146467424,True,1,1104
28740,146466703,146466703,True,4,0
28741,146468481,146468742,True,1,261
28742,146476249,146476605,True,1,356
28743,146484224,146485001,False,1,777
28744,146497356,146499399,False,1,2043
28745,146498252,146503279,True,1,5027
28746,146507818,146509182,True,1,1364
28747,146508360,146509308,True,1,948
28748,146515812,146516324,True,1,512
28749,146525357,146525926,True,4,569
28750,146538780,146542492,True,6,3712
28751,146551084,146551285,False,1,201
28752,146551084,146554809,True,1,3725
28753,146566977,146575582,True,1,8605
28754,146603361,146603628,True,3,267
28755,146604186,146605103,True,3,917
28756,146604439,146605103,True,1,664
28757,146630790,146631894,True,2,1104
28758,146663555,146664204,True,2,649
28759,146663885,147045199,True,7,381314
28760,146666480,146666788,False,1,308
28761,146689970,146753703,True,5,63733
28762,146712716,146713788,False,1,1072
28763,146712716,146713788,True,2,1072
28764,146712716,146765608,True,1,52892
28765,146714893,146717277,True,2,2384
28766,146717376,146718648,True,3,1272
28767,146719866,146721330,True,1,1464
28768,146727543,146735280,True,1,7737
28769,146752244,146774623,True,1,22379
28770,146775689,146777379,True,4,1690
28771,146786290,146797716,True,6,11426
28772,146786290,146799547,True,1,13257
28773,146797972,146824861,True,1,26889
28774,146797972,146841538,True,1,43566
28775,146809456,146811186,True,1,1730
28776,146817599,146832002,False,1,14403
28777,146841856,146854739,True,1,12883
28778,146841856,146874693,False,1,32837
28779,146845180,146883202,False,1,38022
28780,146859561,146864911,True,1,5350
28781,146865732,146866469,True,5,737
28782,146873980,146876944,True,3,2964
28783,146882293,146897276,True,1,14983
28784,146882388,146912129,True,1,29741
28785,146882855,146887352,True,2,4497
28786,146885025,146892118,False,3,7093
28787,146885025,146892118,True,13,7093
28788,146899745,146929500,True,1,29755
28789,146905495,146920542,True,1,15047
28790,146910835,146911054,True,1,219
28791,146922875,146924039,True,1,1164
28792,146922875,146928132,True,3,5257
28793,146922875,146931493,True,1,8618
28794,146922875,146936251,True,1,13376
28795,146944930,146956160,True,1,11230
28796,146945402,146954085,True,1,8683
28797,146947556,146950839,True,1,3283
28798,146947556,146968940,True,1,21384
28799,146967981,146968116,True,1,135
28800,146971399,146971969,True,1,570
28801,146984176,146984433,True,1,257
28802,146993591,146993887,True,2,296
28803,146996481,146998182,False,1,1701
28804,146996481,146998182,True,1,1701
28805,146997953,146999294,True,1,1341
28806,146997953,147014986,True,2,17033
28807,146998537,146998972,False,1,435
28808,147003131,147003299,True,1,168
28809,147015114,147018435,True,1,3321
28810,147018360,147018736,True,2,376
28811,147022928,147024769,True,1,1841
28812,147023371,147024695,True,1,1324
28813,147025305,147025433,True,2,128
28814,147037965,147038364,True,1,399
28815,147038392,147038794,True,1,402
28816,147043688,147051503,True,1,7815
28817,147043688,147061258,True,3,17570
28818,147050633,147061779,True,1,11146
28819,147050633,147063553,True,2,12920
28820,147057220,147068049,True,1,10829
28821,147076789,147081359,True,1,4570
28822,147108202,147108476,True,1,274
28823,147111363,147112386,True,2,1023
28824,147113589,147114721,True,1,1132
28825,147119719,147120264,True,1,545
28826,147143758,147143874,True,2,116
28827,147153287,147154426,True,1,1139
28828,147168151,147171512,True,1,3361
28829,147170462,147170843,False,1,381
28830,147170462,147171389,False,1,927
28831,147170604,147170843,False,1,239
28832,147170604,147171124,False,1,520
28833,147170604,147171124,True,1,520
28834,147175529,147177565,True,1,2036
28835,147176126,147177835,True,3,1709
28836,147176126,147177839,True,1,1713
28837,147177477,147190644,True,3,13167
28838,147196958,147197192,True,1,234
28839,147197936,147198021,False,1,85
28840,147206433,147217643,True,3,11210
28841,147207455,147218025,True,1,10570
28842,147218344,147218426,True,1,82
28843,147226205,147248633,True,1,22428
28844,147226205,147259134,True,1,32929
28845,147228489,147228627,True,1,138
28846,147229476,147252177,False,1,22701
28847,147229488,147252177,False,1,22689
28848,147231596,147231674,True,1,78
28849,147233802,147233969,True,1,167
28850,147237143,147239945,False,1,2802
28851,147242362,147604035,False,1,361673
28852,147246526,147246625,True,3,99
28853,147248504,147253236,True,2,4732
28854,147248504,147254361,False,1,5857
28855,147248504,147254361,True,1,5857
28856,147258409,147265110,True,1,6701
28857,147259795,147265757,True,1,5962
28858,147266867,147269138,True,1,2271
28859,147283229,147382150,True,1,98921
28860,147285511,147286094,True,1,583
28861,147292377,147295691,True,2,3314
28862,147292591,147293057,True,2,466
28863,147293138,147300169,True,1,7031
28864,147323545,147330723,True,1,7178
28865,147326956,147327992,False,2,1036
28866,147326956,147327992,True,3,1036
28867,147356283,147357376,True,2,1093
28868,147371881,147372249,True,1,368
28869,147407868,147435612,True,2,27744
28870,147408504,147410683,False,2,2179
28871,147408504,147410683,True,1,2179
28872,147412863,147417673,True,2,4810
28873,147422677,147422955,False,1,278
28874,147423896,147426195,True,1,2299
28875,147428863,147429338,True,1,475
28876,147435207,147438287,True,2,3080
28877,147435231,147438360,True,2,3129
28878,147441635,147444046,True,2,2411
28879,147448332,147463092,False,1,14760
28880,147448571,147489611,True,1,41040
28881,147454953,147455278,True,1,325
28882,147455946,147456134,True,1,188
28883,147458640,147459456,True,1,816
28884,147471183,147501669,True,2,30486
28885,147485918,147487904,True,4,1986
28886,147485918,147490982,True,6,5064
28887,147485918,147495733,True,2,9815
28888,147488837,147489776,True,1,939
28889,147491132,147494000,True,1,2868
28890,147494044,147508850,True,1,14806
28891,147501870,147504604,True,1,2734
28892,147502041,147504784,True,1,2743
28893,147506954,147512372,True,1,5418
28894,147508225,147508306,True,1,81
28895,147518304,147518760,True,1,456
28896,147543809,147544701,False,1,892
28897,147547318,147547403,True,1,85
28898,147561984,147568758,False,1,6774
28899,147561984,147569311,False,1,7327
28900,147561984,147586758,True,1,24774
28901,147581368,147585350,True,1,3982
28902,147615706,147616949,True,2,1243
28903,147641454,147641572,True,2,118
28904,147647474,147648173,True,1,699
28905,147649182,147649672,True,1,490
28906,147654428,147654500,True,1,72
28907,147656507,147657535,True,1,1028
28908,147663632,147663875,True,1,243
28909,147664282,147664371,True,1,89
28910,147670606,147670849,False,1,243
28911,147684647,147684766,True,3,119
28912,147686870,147687055,True,1,185
28913,147689275,147689533,False,1,258
28914,147692733,147693879,True,1,1146
28915,147705732,147706578,True,5,846
28916,147712997,147717879,True,1,4882
28917,147712997,147718395,True,1,5398
28918,147712997,147743627,True,3,30630
28919,147736625,147790522,True,3,53897
28920,147736678,147737292,True,1,614
28921,147741448,147741723,True,2,275
28922,147744326,147770250,True,1,25924
28923,147764674,147796878,True,2,32204
28924,147772468,147772932,True,1,464
28925,147772468,147773130,True,1,662
28926,147789790,147789960,False,2,170
28927,147789790,147789960,True,1,170
28928,147812541,147813925,False,1,1384
28929,147812541,147813925,True,3,1384
28930,147827743,147827822,True,1,79
28931,147839273,147845710,False,1,6437
28932,147842327,147842724,True,1,397
28933,147842536,147846185,False,1,3649
28934,147842536,147847224,True,2,4688
28935,147842727,147877862,True,1,35135
28936,147844419,147847943,True,4,3524
28937,147849047,147853737,True,4,4690
28938,147849047,147859360,False,1,10313
28939,147855563,147855565,True,1,2
28940,147858497,147859324,False,1,827
28941,147866829,147867154,True,1,325
28942,147872230,147920998,True,1,48768
28943,147880464,147881918,True,4,1454
28944,147882508,147883156,True,4,648
28945,147883876,147888773,True,1,4897
28946,147890735,147904956,True,2,14221
28947,147902488,147902813,True,2,325
28948,147912023,147912623,True,1,600
28949,147914112,147914641,True,4,529
28950,147915549,147916974,True,1,1425
28951,147915623,147915624,True,1,1
28952,147917591,147929511,False,1,11920
28953,147929906,147930631,True,1,725
28954,147946088,147953068,False,1,6980
28955,147951587,147959401,True,2,7814
28956,147951587,147965879,False,1,14292
28957,147951653,147955567,True,1,3914
28958,147951653,147959401,True,1,7748
28959,147951653,147965879,False,1,14226
28960,147953422,147968546,True,4,15124
28961,147953422,147971215,True,1,17793
28962,147956064,147956889,True,2,825
28963,147956470,147958815,True,1,2345
28964,147957828,147958307,True,1,479
28965,147958023,147972152,False,1,14129
28966,147962352,147966119,True,1,3767
28967,147968738,147968991,False,1,253
28968,147979310,147982867,True,1,3557
28969,147990624,147990935,True,1,311
28970,147994034,147994477,True,1,443
28971,148008509,148012122,True,2,3613
28972,148009550,148010581,True,3,1031
28973,148022848,148051917,True,1,29069
28974,148028303,148028847,False,1,544
28975,148028303,148030366,False,1,2063
28976,148034638,148035232,False,1,594
28977,148034638,148035232,True,3,594
28978,148044900,148045274,False,1,374
28979,148065123,148075454,True,1,10331
28980,148065303,148066634,True,1,1331
28981,148067494,148067589,True,1,95
28982,148069156,148070303,True,1,1147
28983,148070869,148071353,True,4,484
28984,148071775,148073165,True,1,1390
28985,148072349,148075852,True,1,3503
28986,148089159,148090871,True,1,1712
28987,148112165,148114012,True,1,1847
28988,148112310,148112643,True,1,333
28989,148112761,148114094,True,1,1333
28990,148117529,148118813,True,1,1284
28991,148125885,148126358,True,1,473
28992,148126003,148127569,False,1,1566
28993,148126003,148127569,True,2,1566
28994,148142223,148143606,True,1,1383
28995,148144148,148152117,True,1,7969
28996,148144148,148153056,False,1,8908
28997,148144423,148175485,True,6,31062
28998,148145020,148145215,True,1,195
28999,148150704,148150780,False,2,76
29000,148150704,148150780,True,1,76
29001,148151231,148152152,True,3,921
29002,148156865,148157206,True,2,341
29003,148156916,148157170,True,8,254
29004,148167443,148169483,True,1,2040
29005,148179057,148182270,True,1,3213
29006,148186962,148188123,True,1,1161
29007,148186962,148188177,True,1,1215
29008,148188276,148188867,True,1,591
29009,148194549,148194850,True,1,301
29010,148209162,148211694,False,1,2532
29011,148209162,148211694,True,1,2532
29012,148223322,148231448,True,1,8126
29013,148223322,148233125,False,1,9803
29014,148223322,148233125,True,1,9803
29015,148228501,148255529,False,1,27028
29016,148239417,148456184,False,1,216767
29017,148240270,148243969,True,1,3699
29018,148240270,148248493,True,3,8223
29019,148255196,148262622,False,1,7426
29020,148255196,148262622,True,3,7426
29021,148266615,148268391,True,1,1776
29022,148270156,148273285,True,1,3129
29023,148273397,148275945,False,1,2548
29024,148279967,148286967,True,2,7000
29025,148307498,148316159,True,2,8661
29026,148307498,148322864,True,1,15366
29027,148308131,148319987,True,2,11856
29028,148308131,148327796,False,1,19665
29029,148326788,148326964,True,1,176
29030,148332077,148339705,True,1,7628
29031,148332077,148339950,True,1,7873
29032,148334533,148338883,True,1,4350
29033,148335991,148340341,True,1,4350
29034,148343008,148347421,True,1,4413
29035,148343247,148347383,True,4,4136
29036,148343702,148347736,True,1,4034
29037,148368028,148369822,True,3,1794
29038,148371259,148371554,True,1,295
29039,148372211,148374005,False,1,1794
29040,148376758,148379919,True,3,3161
29041,148379507,148379697,False,1,190
29042,148405813,148406149,True,1,336
29043,148406331,148407203,True,1,872
29044,148409502,148412176,True,1,2674
29045,148414649,148416263,True,1,1614
29046,148415218,148415709,True,1,491
29047,148419002,148440667,True,1,21665
29048,148421532,148421985,False,2,453
29049,148421532,148422107,False,3,575
29050,148423087,148426807,True,2,3720
29051,148427220,148429688,True,1,2468
29052,148427363,148443765,True,1,16402
29053,148439014,148453981,True,1,14967
29054,148448772,148450939,False,1,2167
29055,148452915,148466092,False,1,13177
29056,148453129,148453223,False,1,94
29057,148453129,148453223,True,2,94
29058,148454820,148456845,False,1,2025
29059,148454841,148456369,True,1,1528
29060,148468022,148468392,True,1,370
29061,148473927,148476052,True,1,2125
29062,148481531,148482950,False,1,1419
29063,148495821,148499155,True,1,3334
29064,148522991,148523271,True,1,280
29065,148529956,148549651,True,2,19695
29066,148529956,148599221,True,1,69265
29067,148540094,148540802,True,3,708
29068,148540453,148542027,True,2,1574
29069,148541701,148543155,True,1,1454
29070,148546426,148553062,True,5,6636
29071,148548942,148574078,True,2,25136
29072,148552029,148552556,True,6,527
29073,148552029,148553215,True,1,1186
29074,148574295,148577356,True,13,3061
29075,148574383,148612095,True,1,37712
29076,148579456,148585858,False,1,6402
29077,148581161,148605511,True,1,24350
29078,148593854,148597039,False,1,3185
29079,148597409,148597715,False,1,306
29080,148597833,148598512,False,1,679
29081,148598590,148598938,False,1,348
29082,148598590,148598938,True,4,348
29083,148599774,148600081,False,1,307
29084,148600201,148600410,False,2,209
29085,148603996,148604807,True,1,811
29086,148607337,148608678,True,2,1341
29087,148607731,148608753,True,1,1022
29088,148608038,148613173,False,1,5135
29089,148608038,148613173,True,2,5135
29090,148613858,148617124,False,2,3266
29091,148613858,148617124,True,1,3266
29092,148613858,148617129,False,1,3271
29093,148614648,148615816,True,2,1168
29094,148616150,148617067,True,1,917
29095,148620237,148635109,True,1,14872
29096,148625373,148627351,True,1,1978
29097,148630917,148632364,True,1,1447
29098,148634465,148642692,True,1,8227
29099,148637179,148644050,True,1,6871
29100,148637253,148644063,True,1,6810
29101,148637443,148644137,True,1,6694
29102,148637492,148644190,False,1,6698
29103,148661558,148664144,True,1,2586
29104,148661558,148664683,True,1,3125
29105,148664782,148683473,True,1,18691
29106,148666303,148667450,True,4,1147
29107,148695041,148697117,True,1,2076
29108,148706935,148712045,False,2,5110
29109,148706935,148712045,True,6,5110
29110,148706935,148713815,False,1,6880
29111,148725312,148731924,True,1,6612
29112,148725312,148734841,True,1,9529
29113,148725575,148725660,True,1,85
29114,148728610,148740512,True,1,11902
29115,148729753,148735449,True,1,5696
29116,148732857,148735091,False,1,2234
29117,148732857,148735091,True,1,2234
29118,148745634,148748207,True,1,2573
29119,148749488,148749909,False,1,421
29120,148750457,148750582,False,1,125
29121,148750712,148750930,False,1,218
29122,148750712,148751126,False,1,414
29123,148758277,148801240,True,1,42963
29124,148758667,148760587,True,1,1920
29125,148761576,148762219,True,2,643
29126,148761939,148762219,True,1,280
29127,148763023,148763352,True,1,329
29128,148766982,148769426,True,1,2444
29129,148773306,148773447,True,2,141
29130,148774439,148806977,True,1,32538
29131,148783626,148785287,True,1,1661
29132,148784354,148785330,True,1,976
29133,148800791,148802344,True,1,1553
29134,148805914,148807183,False,1,1269
29135,148808923,148809178,False,1,255
29136,148811519,148812628,True,3,1109
29137,148815103,148815721,True,3,618
29138,148823807,148831108,True,1,7301
29139,148827850,148828186,False,1,336
29140,148827850,148829367,True,1,1517
29141,148833519,148836772,True,2,3253
29142,148834152,148837090,True,4,2938
29143,148839678,148840017,True,1,339
29144,148844011,148844607,True,1,596
29145,148844309,148844888,True,1,579
29146,148845205,148845482,True,1,277
29147,148845704,148846288,True,1,584
29148,148850968,148861423,True,1,10455
29149,148851558,148854196,True,1,2638
29150,148851558,148858519,True,1,6961
29151,148851558,148860518,True,1,8960
29152,148851558,148861383,False,1,9825
29153,148866897,148869891,True,1,2994
29154,148877684,148880257,False,1,2573
29155,148879293,148879391,True,4,98
29156,148884003,148884322,False,1,319
29157,148885469,148885974,True,2,505
29158,148889287,148891927,True,1,2640
29159,148890577,148890707,True,1,130
29160,148891204,148891581,True,1,377
29161,148895050,148899431,True,1,4381
29162,148897188,148898553,True,3,1365
29163,148899296,148904759,True,1,5463
29164,148903947,148919927,False,1,15980
29165,148903947,148926755,False,1,22808
29166,148903947,148927498,False,1,23551
29167,148903947,149046003,True,2,142056
29168,148904104,148906048,True,1,1944
29169,148905200,149046491,True,1,141291
29170,148913499,148923098,True,2,9599
29171,148920339,148960581,True,1,40242
29172,148926390,148956839,True,5,30449
29173,148927438,148928381,True,1,943
29174,148928800,148959249,True,1,30449
29175,148929744,148929950,False,1,206
29176,148932446,148933276,True,1,830
29177,148933898,148934094,True,1,196
29178,148935108,148935740,True,2,632
29179,148935899,148936063,True,1,164
29180,148939862,148941315,True,1,1453
29181,148940901,148941025,True,1,124
29182,148944391,148944928,True,10,537
29183,148945110,148945264,True,1,154
29184,148949484,148950275,False,1,791
29185,148954890,148959080,True,1,4190
29186,148961989,148965064,True,1,3075
29187,148967354,148968392,True,2,1038
29188,148968557,148971870,True,2,3313
29189,148972295,148975675,True,1,3380
29190,148974744,148975075,True,1,331
29191,148984354,148998596,True,1,14242
29192,148984354,148999074,False,1,14720
29193,148988368,149007198,False,1,18830
29194,148988368,149007198,True,3,18830
29195,148990780,148997068,False,1,6288
29196,148997113,148999228,False,1,2115
29197,149014301,149035396,False,1,21095
29198,149016902,149033096,True,4,16194
29199,149038014,149073176,False,1,35162
29200,149047582,149060252,True,1,12670
29201,149048122,149050488,True,1,2366
29202,149049606,149052940,True,1,3334
29203,149053174,149059761,False,1,6587
29204,149053174,149088342,False,1,35168
29205,149053174,149088342,True,1,35168
29206,149053174,149112841,False,1,59667
29207,149053951,149071735,True,1,17784
29208,149054320,149058394,True,3,4074
29209,149057710,149064953,True,1,7243
29210,149072417,149072705,True,1,288
29211,149072477,149097595,False,1,25118
29212,149072477,149097595,True,1,25118
29213,149080336,149081494,False,1,1158
29214,149083228,149083598,True,1,370
29215,149103351,149109588,True,1,6237
29216,149103966,149109595,False,1,5629
29217,149106452,149106851,True,4,399
29218,149106452,149107165,True,1,713
29219,149106979,149107186,True,1,207
29220,149107784,149108870,False,2,1086
29221,149107784,149111213,False,2,3429
29222,149108984,149111227,False,1,2243
29223,149109342,149110130,True,1,788
29224,149118146,149119699,True,1,1553
29225,149122778,149124883,True,1,2105
29226,149123813,149124993,True,1,1180
29227,149130632,149145715,True,1,15083
29228,149130632,149149841,True,1,19209
29229,149140530,149187484,True,1,46954
29230,149145104,149145437,True,1,333
29231,149156954,149159057,True,2,2103
29232,149177043,149177457,True,7,414
29233,149181041,149187214,True,2,6173
29234,149187204,149272154,False,1,84950
29235,149197987,149235874,False,1,37887
29236,149203351,149204043,True,1,692
29237,149204122,149204899,True,1,777
29238,149212661,149213479,True,1,818
29239,149221929,149233458,False,1,11529
29240,149221929,149233458,True,3,11529
29241,149225721,149231128,False,1,5407
29242,149242453,149242743,False,1,290
29243,149242453,149242743,True,2,290
29244,149260546,149261012,True,4,466
29245,149263233,149263503,False,1,270
29246,149264021,149267243,True,1,3222
29247,149264595,149270559,True,1,5964
29248,149266117,149271398,True,2,5281
29249,149274696,149277351,True,1,2655
29250,149282881,149284425,True,1,1544
29251,149284047,149284136,True,1,89
29252,149293822,149300649,False,1,6827
29253,149297827,149298162,True,1,335
29254,149306688,149307281,True,3,593
29255,149306955,149311758,False,1,4803
29256,149306955,149311758,True,1,4803
29257,149309133,149309474,True,1,341
29258,149309133,149310289,True,1,1156
29259,149313265,149315535,True,3,2270
29260,149318302,149318369,True,1,67
29261,149318674,149325557,True,1,6883
29262,149318674,149327712,True,1,9038
29263,149320735,149336368,True,1,15633
29264,149327939,149329241,True,6,1302
29265,149333647,149337284,True,2,3637
29266,149336943,149342087,True,3,5144
29267,149340911,149368878,True,1,27967
29268,149345592,149352960,True,1,7368
29269,149350362,149351959,True,1,1597
29270,149352611,149355577,True,1,2966
29271,149352611,149356802,True,2,4191
29272,149364450,149364680,False,1,230
29273,149364450,149364680,True,2,230
29274,149364944,149365162,True,1,218
29275,149371324,149372294,True,1,970
29276,149372274,149372353,False,1,79
29277,149378322,149378498,True,4,176
29278,149380512,149382020,True,1,1508
29279,149383215,149387517,False,1,4302
29280,149383215,149387517,True,4,4302
29281,149385083,149410215,True,1,25132
29282,149390433,149395862,True,2,5429
29283,149390823,149396255,True,1,5432
29284,149391273,149391621,True,1,348
29285,149396644,149397870,False,1,1226
29286,149396644,149399661,False,1,3017
29287,149398463,149398567,False,1,104
29288,149398463,149398567,True,1,104
29289,149399093,149399384,True,1,291
29290,149400148,149405501,True,1,5353
29291,149400148,149416405,True,1,16257
29292,149400899,149407941,False,1,7042
29293,149401887,149401999,True,2,112
29294,149402245,149402854,True,1,609
29295,149403158,149403266,True,1,108
29296,149404804,149406478,False,1,1674
29297,149404804,149407294,False,1,2490
29298,149404804,149416338,False,1,11534
29299,149404804,149416338,True,2,11534
29300,149404848,149404951,True,1,103
29301,149404955,149405263,True,3,308
29302,149405886,149410474,False,2,4588
29303,149405886,149683917,False,1,278031
29304,149412188,149414608,True,2,2420
29305,149412808,149414057,True,1,1249
29306,149420461,149420646,True,3,185
29307,149421714,149423132,False,1,1418
29308,149421717,149423726,True,1,2009
29309,149429466,149430964,True,1,1498
29310,149438191,149438510,True,1,319
29311,149445872,149448681,True,1,2809
29312,149446171,149448681,True,1,2510
29313,149446171,149451969,True,1,5798
29314,149446171,149452284,False,1,6113
29315,149446206,149448681,True,1,2475
29316,149446206,149451969,True,1,5763
29317,149446350,149451969,True,1,5619
29318,149450088,149451101,True,1,1013
29319,149450088,149454435,True,1,4347
29320,149453962,149502990,True,1,49028
29321,149459259,149539924,True,1,80665
29322,149460849,149461346,False,1,497
29323,149461436,149462430,True,2,994
29324,149462742,149463075,True,1,333
29325,149464486,149464633,True,2,147
29326,149465444,149466633,False,1,1189
29327,149465444,149466633,True,1,1189
29328,149467547,149467944,True,1,397
29329,149467640,149467944,True,2,304
29330,149467829,149467944,True,2,115
29331,149468112,149468600,True,1,488
29332,149470395,149470469,False,1,74
29333,149470395,149470492,True,1,97
29334,149476885,149479134,True,4,2249
29335,149481557,149481807,True,1,250
29336,149483928,149484353,True,1,425
29337,149490986,149491422,True,2,436
29338,149495022,149497098,False,1,2076
29339,149495022,149497098,True,2,2076
29340,149505211,149505381,True,2,170
29341,149506546,149507538,True,1,992
29342,149507737,149507840,False,1,103
29343,149507737,149507840,True,4,103
29344,149507977,149511980,False,1,4003
29345,149508044,149511980,False,1,3936
29346,149508315,149508440,True,1,125
29347,149512089,149512167,True,1,78
29348,149514170,149514273,True,4,103
29349,149514195,149515981,True,1,1786
29350,149515691,149515779,True,1,88
29351,149518068,149518241,False,1,173
29352,149520751,149520952,True,4,201
29353,149521974,149522079,True,1,105
29354,149528864,149574680,False,1,45816
29355,149528864,149574680,True,3,45816
29356,149528864,149574684,True,1,45820
29357,149531897,149533133,True,1,1236
29358,149535029,149536542,True,6,1513
29359,149552445,149558425,True,1,5980
29360,149558470,149835955,False,1,277485
29361,149563452,149563790,True,2,338
29362,149563452,149563792,True,2,340
29363,149563862,149564157,True,1,295
29364,149564862,149564982,True,1,120
29365,149571010,149571832,True,2,822
29366,149571010,149572285,True,1,1275
29367,149603167,149603486,False,1,319
29368,149605092,149605967,True,1,875
29369,149611482,149636661,False,1,25179
29370,149615274,149615372,True,1,98
29371,149615395,149650489,True,1,35094
29372,149615395,149655951,False,2,40556
29373,149616664,149638544,True,1,21880
29374,149617811,149619155,True,1,1344
29375,149623439,149685237,False,1,61798
29376,149630520,149638649,True,1,8129
29377,149667218,149669746,True,3,2528
29378,149685816,149691129,False,2,5313
29379,149685816,149691129,True,6,5313
29380,149693012,149703813,True,1,10801
29381,149693549,149693673,True,1,124
29382,149705246,149705387,True,1,141
29383,149716427,149725516,True,9,9089
29384,149724473,149735729,True,1,11256
29385,149724473,149738861,True,2,14388
29386,149724473,149742247,True,1,17774
29387,149724473,149745453,True,1,20980
29388,149724730,149725085,True,1,355
29389,149729976,149733728,True,3,3752
29390,149737773,149746959,True,1,9186
29391,149740534,149744322,False,1,3788
29392,149740534,149744322,True,6,3788
29393,149741792,149744541,True,1,2749
29394,149746991,149747145,True,1,154
29395,149761930,149858824,False,1,96894
29396,149763002,149765013,True,7,2011
29397,149767266,149767390,True,1,124
29398,149777102,149779365,False,1,2263
29399,149777102,149779365,True,2,2263
29400,149782720,149784773,False,1,2053
29401,149788852,149790741,True,4,1889
29402,149801479,149812248,True,2,10769
29403,149805305,149806119,True,1,814
29404,149806915,149807012,True,1,97
29405,149807352,149820592,True,1,13240
29406,149807352,149825797,True,1,18445
29407,149814952,149819927,True,1,4975
29408,149814952,149856265,False,1,41313
29409,149815573,149818870,True,2,3297
29410,149815812,149827019,True,3,11207
29411,149816535,149819781,True,1,3246
29412,149823226,149823885,True,1,659
29413,149825173,149826400,False,1,1227
29414,149825173,149828190,False,1,3017
29415,149829427,149836470,False,1,7043
29416,149833319,149834101,True,1,782
29417,149834481,149839070,False,1,4589
29418,149840892,149850251,False,1,9359
29419,149843302,149846351,True,1,3049
29420,149848185,149850646,True,3,2461
29421,149850244,149851677,False,1,1433
29422,149856020,149862319,True,2,6299
29423,149873182,149874406,False,1,1224
29424,149875336,149889915,True,1,14579
29425,149881212,149882438,True,1,1226
29426,149881212,149884232,True,1,3020
29427,149884863,149886241,True,1,1378
29428,149885473,149892515,False,1,7042
29429,149885505,149886027,True,1,522
29430,149890527,149895115,False,1,4588
29431,149892162,149895668,True,1,3506
29432,149893633,149894045,True,1,412
29433,149893633,149897758,True,1,4125
29434,149899346,149902395,True,1,3049
29435,149906288,149907724,False,1,1436
29436,149920970,149921173,True,2,203
29437,149925177,149930119,True,1,4942
29438,149926241,149927069,True,1,828
29439,149932617,149933027,True,1,410
29440,149936920,149938383,True,1,1463
29441,149937258,149938485,True,1,1227
29442,149937258,149940274,True,1,3016
29443,149937357,149938185,True,8,828
29444,149940426,149943620,True,2,3194
29445,149940426,149951053,True,1,10627
29446,149946566,149951156,False,1,4590
29447,149946566,149954291,False,1,7725
29448,149948483,149949859,True,2,1376
29449,149955388,149958433,True,1,3045
29450,149959995,149960098,True,1,103
29451,149976170,149980000,False,1,3830
29452,149977106,149979070,False,1,1964
29453,149977341,149979188,False,1,1847
29454,149978200,149980215,False,1,2015
29455,149982390,150016926,True,1,34536
29456,149982599,149985141,True,1,2542
29457,149986674,149986887,False,1,213
29458,149988941,149992933,True,1,3992
29459,149989744,149990051,False,1,307
29460,150005858,150006180,True,2,322
29461,150013031,150013211,False,1,180
29462,150014265,150015173,False,1,908
29463,150019349,150020119,False,1,770
29464,150019349,150020119,True,1,770
29465,150024997,150025188,False,2,191
29466,150024997,150025188,True,4,191
29467,150024997,150025420,True,1,423
29468,150025401,150026197,False,1,796
29469,150026454,150026598,True,1,144
29470,150027328,150029640,True,5,2312
29471,150042780,150045509,False,1,2729
29472,150045141,150045747,True,1,606
29473,150047826,150049598,False,1,1772
29474,150047826,150049598,True,1,1772
29475,150047826,150064049,True,1,16223
29476,150049986,150053100,True,2,3114
29477,150054955,150055615,True,1,660
29478,150066907,150160382,True,4,93475
29479,150069917,150070575,True,1,658
29480,150082421,150083252,True,1,831
29481,150086306,150124001,False,1,37695
29482,150089917,150090126,True,1,209
29483,150094240,150094665,True,1,425
29484,150109951,150111683,True,1,1732
29485,150110774,150120387,True,1,9613
29486,150121551,150141199,True,1,19648
29487,150133756,150135212,True,1,1456
29488,150140624,150140939,False,1,315
29489,150148913,150149431,True,1,518
29490,150149485,150164996,True,2,15511
29491,150165742,150168030,False,2,2288
29492,150169755,150169957,False,4,202
29493,150169755,150169957,True,2,202
29494,150170587,150174558,True,1,3971
29495,150179648,150180801,False,1,1153
29496,150183444,150184363,True,1,919
29497,150210356,150210441,True,2,85
29498,150210563,150213689,True,2,3126
29499,150221155,150222270,True,4,1115
29500,150221155,150223216,True,1,2061
29501,150237024,150238189,True,1,1165
29502,150248991,150250293,True,1,1302
29503,150254019,150255727,False,1,1708
29504,150254019,150255771,False,1,1752
29505,150258043,150258166,True,6,123
29506,150258479,150258554,True,1,75
29507,150261378,150262138,True,1,760
29508,150265556,150266318,True,2,762
29509,150267249,150268171,True,1,922
29510,150271163,150273855,True,3,2692
29511,150273545,150329532,True,1,55987
29512,150274006,150277011,True,1,3005
29513,150274140,150275730,True,1,1590
29514,150274193,150275730,True,2,1537
29515,150274193,150275734,True,1,1541
29516,150274257,150277319,False,2,3062
29517,150274754,150275008,True,1,254
29518,150278966,150279041,True,1,75
29519,150279747,150282719,True,1,2972
29520,150280688,150282163,False,1,1475
29521,150288508,150339926,False,1,51418
29522,150292176,150292255,True,2,79
29523,150292384,150293663,True,5,1279
29524,150295928,150296379,True,1,451
29525,150296208,150296379,True,1,171
29526,150298980,150306204,True,1,7224
29527,150300234,150302299,False,1,2065
29528,150308139,150309264,True,1,1125
29529,150314028,150315151,False,1,1123
29530,150330163,150331259,True,2,1096
29531,150343312,150343752,True,4,440
29532,150348479,150348994,False,1,515
29533,150348479,150348994,True,6,515
29534,150348479,150352086,True,1,3607
29535,150359752,150360035,False,2,283
29536,150359752,150360035,True,2,283
29537,150362759,150368177,True,1,5418
29538,150364839,150365275,True,4,436
29539,150364839,150366127,True,2,1288
29540,150364961,150369225,True,3,4264
29541,150364961,150383086,True,1,18125
29542,150365039,150369284,True,1,4245
29543,150365343,150365961,True,1,618
29544,150367866,150368190,True,3,324
29545,150371793,150372240,True,1,447
29546,150385756,150424099,True,1,38343
29547,150386736,150387275,True,1,539
29548,150387454,150389330,True,1,1876
29549,150387456,150389335,True,1,1879
29550,150393135,150397629,False,1,4494
29551,150394740,150396190,True,3,1450
29552,150394740,150401043,True,1,6303
29553,150397937,150401059,True,2,3122
29554,150397937,150416809,True,1,18872
29555,150398076,150401085,False,1,3009
29556,150405690,150408168,True,1,2478
29557,150408139,150409807,True,2,1668
29558,150410485,150412957,True,1,2472
29559,150425399,150428603,True,1,3204
29560,150461133,150475216,True,1,14083
29561,150461951,150476022,True,2,14071
29562,150476213,150476662,True,1,449
29563,150485815,150546459,False,2,60644
29564,150485815,150546459,True,2,60644
29565,150497064,150512317,False,1,15253
29566,150505840,150509547,True,1,3707
29567,150510856,150511179,False,1,323
29568,150516241,150517706,False,2,1465
29569,150516241,150517706,True,4,1465
29570,150525324,150526148,True,1,824
29571,150525430,150526124,True,2,694
29572,150526848,150530669,True,10,3821
29573,150546464,150547870,True,2,1406
29574,150546464,150550459,True,1,3995
29575,150548229,150550773,True,1,2544
29576,150550439,150551965,True,1,1526
29577,150552582,150552693,True,1,111
29578,150555127,150580712,True,1,25585
29579,150555127,150675630,True,1,120503
29580,150556736,150558892,True,1,2156
29581,150558246,150559160,True,1,914
29582,150558700,150558808,True,1,108
29583,150568264,150587193,True,1,18929
29584,150575889,150577448,True,1,1559
29585,150575889,150590105,True,1,14216
29586,150575889,150592006,True,3,16117
29587,150578615,150578845,True,1,230
29588,150592153,150595158,True,1,3005
29589,150597191,150614813,True,1,17622
29590,150621975,150623101,True,1,1126
29591,150630953,150633056,True,1,2103
29592,150631893,150636512,True,1,4619
29593,150632026,150713735,True,1,81709
29594,150641740,150643237,True,2,1497
29595,150655547,150666527,True,2,10980
29596,150697312,150697885,True,5,573
29597,150697312,150700880,True,1,3568
29598,150738905,150767410,True,1,28505
29599,150744483,150744792,True,1,309
29600,150744644,150770303,True,1,25659
29601,150745200,150745491,False,1,291
29602,150746579,150747897,True,1,1318
29603,150755675,150756087,True,1,412
29604,150758641,150806777,True,1,48136
29605,150783288,150785025,True,1,1737
29606,150785773,150786188,False,1,415
29607,150785773,150786188,True,1,415
29608,150796925,150876364,True,1,79439
29609,150797948,150800046,True,1,2098
29610,150802380,150879382,True,1,77002
29611,150813280,150815307,True,1,2027
29612,150813280,150817538,True,1,4258
29613,150817968,150821446,True,1,3478
29614,150817968,150821612,True,1,3644
29615,150830117,150830889,True,2,772
29616,150857686,150874300,True,1,16614
29617,150857957,150859968,True,2,2011
29618,150861633,150868896,True,1,7263
29619,150868843,150869915,True,2,1072
29620,150868843,150875788,True,1,6945
29621,150869864,150870507,True,2,643
29622,150870878,150875788,True,1,4910
29623,150870878,150878025,True,1,7147
29624,150871450,150875788,True,1,4338
29625,150882395,150883735,True,1,1340
29626,150893480,150924836,True,1,31356
29627,150894935,150925549,True,1,30614
29628,150900519,150928298,True,1,27779
29629,150918254,150923650,False,2,5396
29630,150939187,150942677,False,1,3490
29631,150939467,150939587,True,1,120
29632,150942914,150946301,False,2,3387
29633,150942914,150946301,True,2,3387
29634,150943309,150949548,True,1,6239
29635,150951538,150953371,False,1,1833
29636,150956605,150957024,False,1,419
29637,150958727,150962706,True,1,3979
29638,150958727,150962775,True,1,4048
29639,150959934,150975438,True,1,15504
29640,150959934,150981008,True,1,21074
29641,150961466,150965445,True,1,3979
29642,150964370,150965996,True,2,1626
29643,150979111,150979212,False,1,101
29644,150982734,150989570,True,1,6836
29645,150988620,150992558,True,1,3938
29646,151001238,151003109,True,1,1871
29647,151008325,151010516,True,2,2191
29648,151008325,151010691,True,3,2366
29649,151008325,151023508,False,1,15183
29650,151008325,151032696,True,1,24371
29651,151014841,151017971,False,1,3130
29652,151016894,151018997,True,1,2103
29653,151016894,151019461,True,1,2567
29654,151020763,151022734,True,1,1971
29655,151024243,151037186,False,1,12943
29656,151024690,151026661,True,1,1971
29657,151031773,151036449,True,2,4676
29658,151031773,151036505,True,1,4732
29659,151040289,151048312,True,1,8023
29660,151040289,151050098,True,1,9809
29661,151052097,151053384,False,1,1287
29662,151052780,151089137,True,1,36357
29663,151064847,151064994,True,2,147
29664,151064847,151064998,True,1,151
29665,151072750,151073554,True,2,804
29666,151083764,151083886,True,2,122
29667,151086196,151100047,False,1,13851
29668,151088916,151127724,True,1,38808
29669,151091225,151093807,True,4,2582
29670,151100075,151112914,True,1,12839
29671,151100206,151102536,True,3,2330
29672,151101921,151103610,True,1,1689
29673,151102338,151102696,False,1,358
29674,151104226,151104960,True,2,734
29675,151119318,151119442,True,1,124
29676,151124002,151124098,True,3,96
29677,151124512,151124618,True,1,106
29678,151125270,151125376,True,1,106
29679,151125568,151125674,True,1,106
29680,151126664,151127901,True,1,1237
29681,151127965,151129412,True,1,1447
29682,151146086,151147260,True,3,1174
29683,151146521,151147017,False,1,496
29684,151146521,151147017,True,6,496
29685,151149765,151151539,True,1,1774
29686,151150481,151152170,True,1,1689
29687,151150600,151151745,True,1,1145
29688,151153111,151153471,True,1,360
29689,151154548,151156524,True,2,1976
29690,151156619,151157254,True,1,635
29691,151186984,151187720,True,1,736
29692,151188411,151190027,True,1,1616
29693,151192327,151198196,True,1,5869
29694,151193296,151193695,False,1,399
29695,151194606,151197463,False,1,2857
29696,151199879,151200534,False,1,655
29697,151199879,151200631,False,1,752
29698,151199879,151200631,True,2,752
29699,151200666,151200996,False,1,330
29700,151200666,151200996,True,1,330
29701,151201205,151202852,True,2,1647
29702,151219462,151220489,True,1,1027
29703,151222651,151222768,True,1,117
29704,151232757,151232830,True,1,73
29705,151232843,151232978,True,1,135
29706,151233046,151233154,True,1,108
29707,151235059,151235137,True,1,78
29708,151251571,151255860,True,5,4289
29709,151251571,151258728,True,2,7157
29710,151256061,151257839,True,1,1778
29711,151256314,151258068,True,1,1754
29712,151256806,151258774,True,4,1968
29713,151257416,151272790,False,1,15374
29714,151259505,151259876,True,1,371
29715,151266492,151269227,True,2,2735
29716,151279144,151280553,True,1,1409
29717,151280299,151280719,True,1,420
29718,151280326,151281182,True,1,856
29719,151283859,151314389,False,1,30530
29720,151296505,151296581,True,4,76
29721,151304076,151304202,True,1,126
29722,151307348,151307569,False,1,221
29723,151312868,151313166,False,1,298
29724,151323512,151324086,True,2,574
29725,151326269,151329723,True,3,3454
29726,151336058,151337444,True,1,1386
29727,151337333,151344966,True,4,7633
29728,151339785,151345787,True,3,6002
29729,151341579,151341682,True,1,103
29730,151341837,151342142,True,3,305
29731,151341897,151342198,False,1,301
29732,151341897,151342198,True,1,301
29733,151342652,151343079,True,1,427
29734,151343332,151344695,True,1,1363
29735,151343850,151347034,True,3,3184
29736,151344478,151349225,True,3,4747
29737,151351082,151357825,True,1,6743
29738,151354936,151361538,True,2,6602
29739,151354936,151364118,True,1,9182
29740,151364084,151369803,True,1,5719
29741,151381651,151384998,True,1,3347
29742,151388987,151409477,True,1,20490
29743,151398564,151456541,True,1,57977
29744,151426714,151434076,True,1,7362
29745,151427188,151427448,True,1,260
29746,151440178,151464623,True,3,24445
29747,151443351,151443774,False,2,423
29748,151457144,151465933,True,2,8789
29749,151459188,151507036,False,1,47848
29750,151473681,151474214,True,1,533
29751,151474777,151493234,True,1,18457
29752,151491306,151492058,True,2,752
29753,151493176,151493606,True,1,430
29754,151509939,151511888,True,1,1949
29755,151516004,151560710,True,3,44706
29756,151516004,151588297,True,1,72293
29757,151519260,151524361,False,1,5101
29758,151520785,151521592,True,1,807
29759,151522350,151522484,False,1,134
29760,151533620,151540216,True,2,6596
29761,151546086,151546178,True,1,92
29762,151569979,151581644,True,1,11665
29763,151569979,151589061,True,2,19082
29764,151574524,151576453,True,1,1929
29765,151590314,151591332,True,4,1018
29766,151654002,151675179,True,1,21177
29767,151662600,151695559,True,1,32959
29768,151716864,151795917,True,1,79053
29769,151719969,151721876,True,5,1907
29770,151747944,151748134,True,1,190
29771,151749346,151750124,True,2,778
29772,151754702,151755084,True,1,382
29773,151756906,151791561,False,1,34655
29774,151763682,151764150,True,4,468
29775,151763752,151773135,False,1,9383
29776,151775018,151778020,True,1,3002
29777,151781445,151783900,True,5,2455
29778,151781740,151782884,True,4,1144
29779,151785149,151786919,True,2,1770
29780,151789060,151799107,True,1,10047
29781,151789467,151791255,True,1,1788
29782,151789874,151799518,True,1,9644
29783,151790368,151799658,True,1,9290
29784,151793862,151794866,True,1,1004
29785,151795652,151799975,True,2,4323
29786,151797875,151803435,True,1,5560
29787,151800332,151800503,True,1,171
29788,151805507,151808216,True,1,2709
29789,151809947,151811786,True,1,1839
29790,151809974,151811762,True,2,1788
29791,151822043,151871462,True,2,49419
29792,151824121,151824211,True,1,90
29793,151825044,151837066,True,2,12022
29794,151825773,151830296,True,1,4523
29795,151825773,151830426,True,1,4653
29796,151858457,151862555,True,1,4098
29797,151864037,151871630,True,1,7593
29798,151864267,151864991,True,1,724
29799,151865937,151866010,False,1,73
29800,151872890,151896766,True,2,23876
29801,151884261,151890648,True,1,6387
29802,151884745,151884966,True,1,221
29803,151895094,151897405,False,1,2311
29804,151895094,151897405,True,1,2311
29805,151915657,151944144,True,1,28487
29806,151928648,151931131,True,2,2483
29807,151936387,151936704,True,1,317
29808,151940835,151949239,True,1,8404
29809,151973397,153133807,True,1,1160410
29810,151977871,151980208,True,1,2337
29811,151989754,151994697,False,1,4943
29812,152000667,152001454,False,1,787
29813,152000667,152001454,True,2,787
29814,152010272,152023160,True,1,12888
29815,152024087,152040004,True,1,15917
29816,152032976,152033765,True,1,789
29817,152036412,152039910,True,3,3498
29818,152038337,152039924,True,2,1587
29819,152042785,152044316,False,2,1531
29820,152047030,152066469,True,1,19439
29821,152053954,152081207,True,1,27253
29822,152090923,152133359,True,1,42436
29823,152092454,152105726,True,1,13272
29824,152108864,152113101,True,1,4237
29825,152116904,152120196,True,1,3292
29826,152124841,152127663,True,1,2822
29827,152135911,152137583,True,1,1672
29828,152143771,152160224,True,1,16453
29829,152182124,152183831,True,3,1707
29830,152182124,152200707,True,1,18583
29831,152184774,152207058,False,1,22284
29832,152200124,152201296,True,1,1172
29833,152200124,152203597,False,1,3473
29834,152200124,152203597,True,1,3473
29835,152207403,152208612,False,1,1209
29836,152208575,152209773,False,1,1198
29837,152218290,152218625,True,6,335
29838,152219831,152221560,True,1,1729
29839,152229921,152243345,True,1,13424
29840,152233164,152233343,True,2,179
29841,152233502,152233892,True,1,390
29842,152235209,152235344,True,1,135
29843,152241121,152241227,True,1,106
29844,152242882,152251068,True,1,8186
29845,152244253,152244409,True,1,156
29846,152247421,152247725,True,1,304
29847,152247883,152247995,True,1,112
29848,152253447,152256412,True,1,2965
29849,152253790,152254218,True,3,428
29850,152255280,152256946,True,4,1666
29851,152258955,152260731,True,1,1776
29852,152261119,152261423,True,1,304
29853,152263080,152264048,True,1,968
29854,152268478,152268571,True,1,93
29855,152271808,152282346,True,2,10538
29856,152272253,152324880,False,1,52627
29857,152273210,152283109,True,1,9899
29858,152279798,152279962,True,2,164
29859,152280113,152280716,True,1,603
29860,152284958,152285391,True,1,433
29861,152291805,152311814,True,2,20009
29862,152304541,152313508,True,1,8967
29863,152312240,152314010,True,6,1770
29864,152312331,152313178,True,1,847
29865,152315995,152320843,True,4,4848
29866,152329466,152331566,True,2,2100
29867,152331143,152338889,False,1,7746
29868,152341190,152341288,True,1,98
29869,152357630,152359436,False,1,1806
29870,152357835,152359392,False,1,1557
29871,152366911,152370446,False,1,3535
29872,152366911,152370446,True,4,3535
29873,152380544,152384114,True,1,3570
29874,152380544,152384126,True,4,3582
29875,152380544,152388369,True,2,7825
29876,152390573,152391974,True,1,1401
29877,152392643,152393029,True,3,386
29878,152392643,152401741,True,1,9098
29879,152396626,152396736,True,1,110
29880,152420784,152421035,False,2,251
29881,152420784,152421035,True,7,251
29882,152421320,152497774,True,2,76454
29883,152422988,152423268,True,1,280
29884,152423089,152426592,False,1,3503
29885,152454812,152454901,True,3,89
29886,152470322,152482598,True,1,12276
29887,152471208,152471295,False,1,87
29888,152475184,152476815,True,2,1631
29889,152478834,152480071,False,1,1237
29890,152478834,152480071,True,1,1237
29891,152478834,152486800,True,1,7966
29892,152497719,152498103,True,2,384
29893,152499362,152508743,True,1,9381
29894,152502843,152505529,False,1,2686
29895,152503837,152505058,False,1,1221
29896,152503837,152505058,True,1,1221
29897,152506670,152508560,True,1,1890
29898,152515423,152516755,False,1,1332
29899,152519633,152519908,False,1,275
29900,152525469,152531969,True,1,6500
29901,152558610,152559811,False,1,1201
29902,152622777,152622778,True,1,1
29903,152622819,152661483,True,1,38664
29904,152623913,152642867,True,3,18954
29905,152640381,152722504,True,1,82123
29906,152640667,152722592,True,1,81925
29907,152652745,152656554,False,1,3809
29908,152653010,152656450,True,2,3440
29909,152669380,152669645,False,1,265
29910,152669822,152669921,True,1,99
29911,152669970,152704331,True,1,34361
29912,152686738,152687717,True,1,979
29913,152687537,152694042,True,2,6505
29914,152700496,152739289,True,1,38793
29915,152704655,152778805,True,2,74150
29916,152708122,152708687,True,1,565
29917,152741119,152745480,True,2,4361
29918,152741801,152741842,True,1,41
29919,152746251,152746948,True,1,697
29920,152749623,152763289,True,1,13666
29921,152749623,152763327,False,1,13704
29922,152753084,152756694,False,1,3610
29923,152757101,152760038,True,1,2937
29924,152765351,152765932,False,2,581
29925,152766705,152777739,False,1,11034
29926,152768180,152778361,False,1,10181
29927,152769400,152772320,False,1,2920
29928,152769400,152772320,True,1,2920
29929,152782622,152785025,True,1,2403
29930,152790987,152792125,False,1,1138
29931,152791046,152792184,False,1,1138
29932,152791046,152792242,True,1,1196
29933,152793751,152796462,True,1,2711
29934,152812122,152820035,False,2,7913
29935,152812122,152820035,True,6,7913
29936,152840011,152841202,False,1,1191
29937,152840011,152841202,True,2,1191
29938,152843098,152843514,True,1,416
29939,152850129,152851705,True,1,1576
29940,152859233,152861332,True,1,2099
29941,152860283,152878990,True,1,18707
29942,152879383,152880294,True,3,911
29943,152879383,152881633,False,2,2250
29944,152879383,152881633,True,2,2250
29945,152879930,152880370,True,1,440
29946,152880169,152880842,True,1,673
29947,152880915,152881649,True,4,734
29948,152886360,152886589,True,1,229
29949,152886911,152887655,True,1,744
29950,152890552,152892964,True,1,2412
29951,152904278,152907321,False,3,3043
29952,152904278,152907321,True,4,3043
29953,152904517,152908246,True,1,3729
29954,152918048,152986124,True,2,68076
29955,152962235,152966446,False,1,4211
29956,152962616,152963006,False,1,390
29957,152962616,152963006,True,1,390
29958,152962616,152969675,False,1,7059
29959,152962616,152970579,True,2,7963
29960,152968307,152978350,True,1,10043
29961,152986833,153000007,True,1,13174
29962,152988732,153000935,True,1,12203
29963,153006091,153008721,True,2,2630
29964,153013794,153114522,True,4,100728
29965,153013794,153128067,True,1,114273
29966,153017566,153026816,True,2,9250
29967,153046656,153048723,False,1,2067
29968,153054598,153059714,True,1,5116
29969,153079915,153087451,True,1,7536
29970,153080957,153319876,True,2,238919
29971,153080957,153418079,True,1,337122
29972,153138838,153139472,True,3,634
29973,153144039,153151078,False,1,7039
29974,153144039,153151078,True,2,7039
29975,153144039,153209515,False,1,65476
29976,153144039,153209515,True,3,65476
29977,153144039,153241937,True,1,97898
29978,153144088,153209581,True,1,65493
29979,153172713,153184609,True,3,11896
29980,153208624,153211735,True,1,3111
29981,153220715,153229722,False,2,9007
29982,153236582,153238959,True,1,2377
29983,153236592,153238953,True,2,2361
29984,153241356,153252992,True,1,11636
29985,153242064,153253700,False,1,11636
29986,153258428,153259263,False,1,835
29987,153258428,153259263,True,1,835
29988,153262944,153264410,True,1,1466
29989,153281603,153284102,True,3,2499
29990,153284166,153286825,True,1,2659
29991,153298056,153298154,False,1,98
29992,153299894,153299894,True,1,0
29993,153337940,153338286,False,1,346
29994,153338202,153340088,False,1,1886
29995,153342380,153343204,False,1,824
29996,153342380,153346399,True,2,4019
29997,153346005,153368912,True,1,22907
29998,153357371,153370239,True,1,12868
29999,153357375,153360394,True,1,3019
30000,153388812,153389250,True,2,438
30001,153419397,153421412,True,1,2015
30002,153457180,153460152,True,3,2972
30003,153466409,153467223,False,1,814
30004,153473459,153482220,False,1,8761
30005,153479832,153480205,True,1,373
30006,153480630,153492346,True,1,11716
30007,153490956,153496028,True,1,5072
30008,153495378,153495981,True,3,603
30009,153503982,153548906,True,1,44924
30010,153507958,153508173,True,1,215
30011,153524462,153536619,True,3,12157
30012,153527018,153528642,True,1,1624
30013,153556132,153560645,True,1,4513
30014,153556132,153562026,True,1,5894
30015,153556132,153573887,True,2,17755
30016,153563098,153566616,False,1,3518
30017,153563098,153566616,True,1,3518
30018,153575012,153575805,True,1,793
30019,153585718,153586214,True,1,496
30020,153586929,153587448,True,1,519
30021,153587031,153587386,True,1,355
30022,153595428,153601146,True,1,5718
30023,153597022,153597870,True,1,848
30024,153599526,153601702,True,1,2176
30025,153645983,153647531,True,1,1548
30026,153648989,153651183,True,1,2194
30027,153658925,153685870,True,3,26945
30028,153658925,153699749,False,1,40824
30029,153662407,153663430,True,1,1023
30030,153664313,153672867,True,1,8554
30031,153670299,153670827,True,1,528
30032,153675618,153708426,False,1,32808
30033,153675618,153708426,True,1,32808
30034,153677558,153679692,False,1,2134
30035,153677558,153679692,True,1,2134
30036,153678844,153680942,True,4,2098
30037,153681622,153682383,True,1,761
30038,153694984,153703780,False,1,8796
30039,153701004,153702660,True,3,1656
30040,153708825,153709520,True,7,695
30041,153713739,153717503,True,1,3764
30042,153742872,153781662,True,1,38790
30043,153742928,153781662,True,1,38734
30044,153743017,153748193,True,3,5176
30045,153746594,153759505,True,1,12911
30046,153747824,153779567,True,1,31743
30047,153771603,153772059,True,1,456
30048,153775202,153784526,True,1,9324
30049,153775263,153784526,True,1,9263
30050,153778837,153780720,True,1,1883
30051,153781779,153782198,False,1,419
30052,153781779,153782198,True,1,419
30053,153819277,153821635,True,1,2358
30054,153823717,153827728,True,1,4011
30055,153830394,153831710,False,1,1316
30056,153847474,153848582,True,1,1108
30057,153851155,153857180,True,1,6025
30058,153855961,153866509,True,1,10548
30059,153864805,153911473,True,1,46668
30060,153864805,153912075,True,1,47270
30061,153864805,153929364,True,1,64559
30062,153875954,153876040,True,1,86
30063,153877096,153877440,True,1,344
30064,153880833,153881223,True,3,390
30065,153885369,153885785,True,1,416
30066,153910808,153911037,True,1,229
30067,153916123,153952090,True,1,35967
30068,153918333,153937315,True,1,18982
30069,153936120,153936384,True,2,264
30070,153939881,153940801,True,1,920
30071,153940995,153941189,True,4,194
30072,153950891,154720291,True,2,769400
30073,153974317,153976083,True,1,1766
30074,153976023,153976291,False,1,268
30075,153976250,153991138,True,1,14888
30076,153977799,153978895,True,3,1096
30077,153987711,153988094,True,1,383
30078,153990533,153993432,True,1,2899
30079,153991819,153992879,True,3,1060
30080,153994144,154015828,False,1,21684
30081,153994144,154017139,False,1,22995
30082,153994144,154018979,False,1,24835
30083,154006664,154021771,True,2,15107
30084,154006664,154023082,True,1,16418
30085,154030988,154031329,False,1,341
30086,154030988,154031376,False,1,388
30087,154038185,154059050,True,1,20865
30088,154040733,154060192,True,1,19459
30089,154040733,154062792,True,1,22059
30090,154043761,154061779,True,1,18018
30091,154060995,154070415,True,1,9420
30092,154067260,154076834,True,1,9574
30093,154067464,154069430,True,2,1966
30094,154067464,154076832,True,2,9368
30095,154072463,154074631,True,5,2168
30096,154079879,154082309,True,1,2430
30097,154112549,154114848,False,1,2299
30098,154112549,154174406,False,3,61857
30099,154114714,154114977,True,1,263
30100,154142190,154144528,True,3,2338
30101,154152734,154153293,True,1,559
30102,154162795,154164267,True,2,1472
30103,154166593,154168161,False,1,1568
30104,154166593,154168161,True,1,1568
30105,154172393,154175957,True,1,3564
30106,154179290,154236456,True,4,57166
30107,154180949,154181931,True,1,982
30108,154208618,154209690,True,1,1072
30109,154210999,154211200,True,1,201
30110,154215694,154215899,False,1,205
30111,154225150,154357447,True,1,132297
30112,154247750,154249907,True,1,2157
30113,154270769,154273922,True,1,3153
30114,154310050,154313098,True,1,3048
30115,154312122,154326172,True,5,14050
30116,154312122,154349348,True,1,37226
30117,154315962,154349065,False,1,33103
30118,154315962,154349065,True,1,33103
30119,154315962,154356948,False,1,40986
30120,154317734,154318463,True,1,729
30121,154320804,154330726,True,4,9922
30122,154320804,154353902,True,1,33098
30123,154323304,154328296,False,1,4992
30124,154327328,154330524,False,1,3196
30125,154332525,154384311,False,1,51786
30126,154332525,154393309,True,2,60784
30127,154333734,154367165,True,1,33431
30128,154334774,154367744,True,2,32970
30129,154345825,154350181,True,2,4356
30130,154345825,154357707,True,4,11882
30131,154400897,154413264,False,1,12367
30132,154400897,154415252,False,1,14355
30133,154448287,154448661,True,2,374
30134,154449990,154450206,True,2,216
30135,154449990,154453065,True,1,3075
30136,154455320,154457473,True,1,2153
30137,154456915,154457294,True,1,379
30138,154457707,154464538,True,2,6831
30139,154461021,154475662,True,1,14641
30140,154462698,154534615,True,1,71917
30141,154466757,154473684,True,1,6927
30142,154468590,154478644,True,1,10054
30143,154473161,154476623,True,1,3462
30144,154492437,154492640,False,1,203
30145,154497201,154500508,False,1,3307
30146,154505303,154505820,True,1,517
30147,154509316,154510537,True,1,1221
30148,154574176,154574764,False,1,588
30149,154574520,154574644,False,1,124
30150,154575414,154587650,True,1,12236
30151,154575414,154597951,True,2,22537
30152,154575695,154579545,False,1,3850
30153,154575695,154598232,True,1,22537
30154,154576607,154613183,False,1,36576
30155,154585650,154587356,True,2,1706
30156,154585803,154587358,False,3,1555
30157,154593186,154596770,True,1,3584
30158,154595263,154600093,False,1,4830
30159,154597028,154609381,True,2,12353
30160,154601160,154602007,False,1,847
30161,154602335,154615278,True,1,12943
30162,154626735,154627684,False,1,949
30163,154633992,154639183,True,1,5191
30164,154649373,154652485,False,1,3112
30165,154652114,154691467,True,1,39353
30166,154653993,154655656,True,1,1663
30167,154654935,154657844,True,1,2909
30168,154662497,154665343,True,1,2846
30169,154666560,154667365,True,2,805
30170,154668608,154844068,False,1,175460
30171,154675628,154681084,True,3,5456
30172,154677072,154680563,False,1,3491
30173,154677072,154680563,True,7,3491
30174,154713625,154833012,True,1,119387
30175,154719567,154725027,True,1,5460
30176,154724026,154727220,True,1,3194
30177,154755809,154760358,True,2,4549
30178,154772514,154774077,True,1,1563
30179,154779810,154783049,False,1,3239
30180,154808158,154825842,True,1,17684
30181,154832990,154834361,True,1,1371
30182,154832990,154836686,True,1,3696
30183,154846784,154850613,True,1,3829
30184,154856396,154897644,True,4,41248
30185,154880061,154895023,True,3,14962
30186,154882946,154896652,True,1,13706
30187,154885480,154891527,True,1,6047
30188,154898579,154918671,True,1,20092
30189,154914552,154915265,True,1,713
30190,154939063,154953494,True,1,14431
30191,154939063,154992369,True,3,53306
30192,154939154,154953585,True,1,14431
30193,154948828,155004666,True,1,55838
30194,155029278,155061996,False,1,32718
30195,155045398,155049315,True,1,3917
30196,155047375,155051668,False,1,4293
30197,155053408,155054356,True,1,948
30198,155057399,155067078,True,2,9679
30199,155057399,155110929,True,1,53530
30200,155064422,155085719,True,1,21297
30201,155064494,155084270,True,1,19776
30202,155064494,155085730,True,1,21236
30203,155071390,155072746,True,1,1356
30204,155072711,155073573,False,1,862
30205,155076384,155077669,True,1,1285
30206,155085298,155338282,True,1,252984
30207,155095547,155100412,False,1,4865
30208,155112841,155142624,True,3,29783
30209,155124620,155128598,True,1,3978
30210,155129281,155136575,True,2,7294
30211,155132464,155135254,True,1,2790
30212,155135917,155158660,False,1,22743
30213,155161311,155168930,True,1,7619
30214,155179938,155184641,False,1,4703
30215,155179938,155184641,True,1,4703
30216,155187369,155209790,True,2,22421
30217,155196656,155197693,True,1,1037
30218,155197903,155203166,True,1,5263
30219,155199748,155211183,False,1,11435
30220,155221465,155241917,True,1,20452
30221,155235190,155236134,True,1,944
30222,155238419,155243921,True,3,5502
30223,155239526,155246198,True,1,6672
30224,155239727,155239968,False,1,241
30225,155247958,155282705,True,1,34747
30226,155271425,155274873,True,1,3448
30227,155274716,155289108,True,1,14392
30228,155275985,155282192,True,1,6207
30229,155295666,155354635,True,2,58969
30230,155296338,155327888,True,1,31550
30231,155296338,155327891,True,1,31553
30232,155299367,155300597,False,1,1230
30233,155310438,155310665,False,1,227
30234,155312890,155340997,False,2,28107
30235,155312890,155340997,True,1,28107
30236,155312890,155367680,False,1,54790
30237,155322950,155330039,True,1,7089
30238,155326602,155341601,True,3,14999
30239,155326602,155365746,True,1,39144
30240,155344652,155363977,True,1,19325
30241,155352598,155357786,True,3,5188
30242,155362539,155363353,True,1,814
30243,155379098,155381455,False,1,2357
30244,155407039,155435815,True,1,28776
30245,155407151,155435918,True,1,28767
30246,155410035,155412185,True,1,2150
30247,155416101,155462708,True,1,46607
30248,155426588,155453301,True,1,26713
30249,155426588,155463986,True,2,37398
30250,155435408,155472690,False,1,37282
30251,155449367,155451191,True,1,1824
30252,155455076,155460964,True,1,5888
30253,155455076,155476468,True,2,21392
30254,155455076,155510802,True,1,55726
30255,155464846,155466640,True,1,1794
30256,155466722,155469582,True,1,2860
30257,155466722,155470462,False,1,3740
30258,155466722,155470462,True,2,3740
30259,155485122,155486033,True,2,911
30260,155490776,155492578,True,1,1802
30261,155490776,155493019,True,1,2243
30262,155495719,155500285,True,2,4566
30263,155497582,155500912,True,1,3330
30264,155504082,155504157,True,2,75
30265,155507391,155508683,True,1,1292
30266,155512902,155515714,True,5,2812
30267,155531701,155533228,True,1,1527
30268,155537532,155538029,True,1,497
30269,155550293,155553609,True,1,3316
30270,155560348,155563515,True,1,3167
30271,155560474,155563434,True,2,2960
30272,155566013,155586642,True,1,20629
30273,155574755,155576117,True,1,1362
30274,155574755,155578440,True,2,3685
30275,155575611,155576593,True,1,982
30276,155588998,155591011,True,2,2013
30277,155588998,155624141,False,1,35143
30278,155614324,155615011,False,1,687
30279,155615531,155616719,True,1,1188
30280,155615625,155616813,True,1,1188
30281,155616148,155616397,True,1,249
30282,155624228,155625905,True,1,1677
30283,155624228,155627011,True,1,2783
30284,155629808,155639010,True,1,9202
30285,155645294,155673298,True,1,28004
30286,155649966,155650241,False,1,275
30287,155654563,155657051,False,1,2488
30288,155689211,155690485,True,1,1274
30289,155701956,155703477,False,1,1521
30290,155701956,155710859,False,1,8903
30291,155721512,155732618,True,1,11106
30292,155734270,155742325,True,1,8055
30293,155741977,155764435,True,1,22458
30294,155741977,155779854,True,1,37877
30295,155741977,155788470,True,1,46493
30296,155746163,155746751,True,1,588
30297,155767926,155781914,True,1,13988
30298,155770984,155858179,True,2,87195
30299,155786530,155789643,False,1,3113
30300,155786996,155787728,True,5,732
30301,155788924,155790914,True,3,1990
30302,155788924,155804717,True,1,15793
30303,155800060,155807137,True,1,7077
30304,155800060,155808837,True,1,8777
30305,155800060,155816743,True,1,16683
30306,155800060,155820349,True,1,20289
30307,155811943,155826203,False,1,14260
30308,155811943,155839567,False,1,27624
30309,155813610,155830018,True,1,16408
30310,155813610,155874797,True,1,61187
30311,155815245,155816261,True,1,1016
30312,155820785,155821192,True,1,407
30313,155821047,155821998,True,3,951
30314,155825710,155826321,True,1,611
30315,155833605,155875707,True,1,42102
30316,155835557,155836356,True,1,799
30317,155843113,155848724,False,1,5611
30318,155848984,155850329,True,2,1345
30319,155856796,155857698,True,2,902
30320,155868404,155872833,True,1,4429
30321,155872178,155876324,True,1,4146
30322,155882037,155901595,True,1,19558
30323,155883192,155885320,True,3,2128
30324,155904918,155911693,False,1,6775
30325,155938991,155945477,True,2,6486
30326,155951085,155956718,True,1,5633
30327,155953201,155954250,False,1,1049
30328,156006736,156008874,True,1,2138
30329,156006736,156013491,True,1,6755
30330,156020920,156022350,True,3,1430
30331,156044728,156045871,True,1,1143
30332,156061658,156061953,True,3,295
30333,156100541,156147719,True,1,47178
30334,156111098,156113781,True,1,2683
30335,156113080,156118444,True,1,5364
30336,156126029,156127327,True,1,1298
30337,156149521,156150709,True,1,1188
30338,156150778,156150962,True,1,184
30339,156150778,156153706,True,1,2928
30340,156151043,156153706,True,1,2663
30341,156156751,156156883,True,1,132
30342,156157015,156158040,True,1,1025
30343,156159272,156159967,True,2,695
30344,156218317,156218813,True,2,496
30345,156219767,156239798,True,3,20031
30346,156223270,156246510,True,1,23240
30347,156237051,156457218,False,1,220167
30348,156267108,156275644,True,4,8536
30349,156267108,156276999,True,1,9891
30350,156279332,156280745,True,1,1413
30351,156287645,156296095,False,1,8450
30352,156288408,156290778,False,1,2370
30353,156294866,156299141,True,2,4275
30354,156304734,156307496,True,2,2762
30355,156304760,156307522,True,2,2762
30356,156315748,156319885,False,1,4137
30357,156323320,156323772,True,1,452
30358,156324364,156325571,True,1,1207
30359,156324832,156325219,True,3,387
30360,156348964,156351309,False,1,2345
30361,156348964,156351592,True,3,2628
30362,156354877,156356220,True,2,1343
30363,156367888,156368946,True,2,1058
30364,156368572,156368651,True,2,79
30365,156369168,156371347,True,1,2179
30366,156371207,156371492,True,1,285
30367,156371405,156372933,True,1,1528
30368,156388494,156388912,True,1,418
30369,156388494,156388915,True,1,421
30370,156388494,156389414,True,1,920
30371,156388494,156389544,True,1,1050
30372,156401820,156404138,True,1,2318
30373,156401820,156416831,True,1,15011
30374,156414211,156414296,True,2,85
30375,156450552,156559165,True,2,108613
30376,156454631,156461965,True,1,7334
30377,156454631,156462911,True,1,8280
30378,156469360,156472030,True,3,2670
30379,156488570,156501774,False,1,13204
30380,156490729,156494229,True,2,3500
30381,156490729,156512322,True,1,21593
30382,156490918,156497606,False,1,6688
30383,156523775,156524043,True,1,268
30384,156532938,156551734,False,1,18796
30385,156532938,156551734,True,2,18796
30386,156538045,156541612,True,1,3567
30387,156544662,156565653,True,1,20991
30388,156546207,156566680,True,1,20473
30389,156577971,156581285,True,1,3314
30390,156578023,156581285,True,1,3262
30391,156587548,156594522,True,1,6974
30392,156590671,156596176,True,1,5505
30393,156630869,156632443,True,1,1574
30394,156630869,156633710,True,3,2841
30395,156634003,156636591,True,3,2588
30396,156634450,156635566,True,1,1116
30397,156651019,156678829,True,1,27810
30398,156654718,156714357,True,1,59639
30399,156708643,156735937,True,4,27294
30400,156720279,156720537,True,1,258
30401,156731184,156738847,True,2,7663
30402,156734188,156736819,True,2,2631
30403,156767367,156767452,True,1,85
30404,156767767,156774680,True,1,6913
30405,156770028,156771378,True,1,1350
30406,156778016,156778414,True,4,398
30407,156778569,156778699,False,1,130
30408,156778667,156785261,False,1,6594
30409,156778667,156786575,False,2,7908
30410,156780523,156781679,True,1,1156
30411,156786221,156795452,False,1,9231
30412,156794621,156795026,True,3,405
30413,156795919,156799218,True,1,3299
30414,156797890,156800232,True,1,2342
30415,156815344,156819191,True,2,3847
30416,156824427,156825302,False,1,875
30417,156828049,156828428,True,2,379
30418,156861808,156874413,True,1,12605
30419,156865848,156959882,True,1,94034
30420,156883490,156889271,True,5,5781
30421,156885466,156886162,True,1,696
30422,156889910,156923666,True,1,33756
30423,156899222,156901681,False,1,2459
30424,156904859,156906232,True,1,1373
30425,156927057,156929119,True,3,2062
30426,156940308,156943607,True,1,3299
30427,156941640,156949368,True,1,7728
30428,156942084,156943607,True,3,1523
30429,156946374,156947405,True,1,1031
30430,156987876,157342209,False,1,354333
30431,157011848,157052852,False,1,41004
30432,157011848,157052852,True,3,41004
30433,157023606,157057945,True,1,34339
30434,157023883,157024821,True,1,938
30435,157038215,157118113,True,4,79898
30436,157065429,157105655,True,1,40226
30437,157110019,157117405,False,1,7386
30438,157113221,157113583,True,1,362
30439,157114225,157119825,True,1,5600
30440,157117194,157121396,True,1,4202
30441,157125377,157127793,True,1,2416
30442,157135408,157139723,True,1,4315
30443,157147631,157159667,True,1,12036
30444,157151440,157153178,True,2,1738
30445,157169330,157169610,False,1,280
30446,157169545,157169922,True,1,377
30447,157174099,157174825,False,1,726
30448,157175145,157178980,True,1,3835
30449,157201894,157215140,True,1,13246
30450,157232554,157232704,True,2,150
30451,157258188,157392730,False,1,134542
30452,157265505,157266048,True,1,543
30453,157267009,157276405,True,2,9396
30454,157273732,157345447,False,1,71715
30455,157275005,157284404,True,2,9399
30456,157276337,157281859,True,2,5522
30457,157276743,157278544,False,1,1801
30458,157279972,157352588,False,1,72616
30459,157288172,157290890,True,1,2718
30460,157291907,157293841,True,4,1934
30461,157294464,157295648,True,5,1184
30462,157294681,157297164,True,1,2483
30463,157295840,157309361,False,1,13521
30464,157312073,157319678,True,1,7605
30465,157326743,157332762,True,1,6019
30466,157341666,157362290,True,3,20624
30467,157341666,157404477,True,1,62811
30468,157390695,157411148,False,2,20453
30469,157419499,157420229,True,1,730
30470,157441615,157473417,False,1,31802
30471,157461215,157462652,True,3,1437
30472,157551695,157556408,True,1,4713
30473,157567837,157576700,True,1,8863
30474,157592820,157595902,True,1,3082
30475,157599918,157605329,True,3,5411
30476,157608739,157611397,False,1,2658
30477,157665551,157666991,True,1,1440
30478,157665627,157666991,True,2,1364
30479,157667772,157669315,True,1,1543
30480,157667849,157669818,True,1,1969
30481,157716028,157731012,True,1,14984
30482,157740294,157981534,True,1,241240
30483,157770927,157771648,False,1,721
30484,157770927,157774274,False,1,3347
30485,157770927,157778987,True,1,8060
30486,157776720,157781239,True,1,4519
30487,157816800,157817074,True,2,274
30488,157816834,157817074,True,1,240
30489,157817140,157823675,True,2,6535
30490,157834268,157837942,True,1,3674
30491,157834268,157840051,True,1,5783
30492,157838602,157838920,False,1,318
30493,157843595,157844576,True,1,981
30494,157846582,157854657,True,1,8075
30495,157882783,157884624,True,1,1841
30496,157913648,157915082,True,2,1434
30497,157931421,157934019,True,1,2598
30498,157957962,157965860,True,2,7898
30499,157971537,158010394,True,1,38857
30500,158002877,158003900,True,1,1023
30501,158010130,158011295,True,1,1165
30502,158018054,158019607,True,2,1553
30503,158018054,158036412,True,6,18358
30504,158018054,158067576,True,1,49522
30505,158069554,158150581,True,1,81027
30506,158088957,158089831,False,1,874
30507,158103464,158106287,True,1,2823
30508,158113812,158172411,True,1,58599
30509,158117379,158118459,True,1,1080
30510,158118419,158119135,True,1,716
30511,158127138,158128390,True,1,1252
30512,158143912,158145643,True,1,1731
30513,158148288,158149041,True,1,753
30514,158148288,158189897,True,1,41609
30515,158162649,158192735,True,1,30086
30516,158164779,158165173,False,1,394
30517,158164779,158170433,False,1,5654
30518,158166835,158167475,False,2,640
30519,158172343,158179676,True,1,7333
30520,158172343,158180721,True,1,8378
30521,158172343,158187107,True,1,14764
30522,158183337,158184273,False,1,936
30523,158183337,158184273,True,2,936
30524,158186702,158209086,True,1,22384
30525,158231066,158231345,True,2,279
30526,158231066,158235402,True,1,4336
30527,158231525,158232701,True,1,1176
30528,158278853,158279781,False,1,928
30529,158278853,158279781,True,1,928
30530,158327035,158327105,True,5,70
30531,158327171,158327833,True,1,662
30532,158330521,158335675,True,4,5154
30533,158330521,158343603,True,1,13082
30534,158330790,158335883,True,1,5093
30535,158330890,158335883,True,1,4993
30536,158332865,158339930,True,1,7065
30537,158349915,158350566,True,1,651
30538,158352924,158362572,True,1,9648
30539,158379677,158383160,True,1,3483
30540,158379677,158397663,True,1,17986
30541,158405352,158406418,True,5,1066
30542,158405683,158406042,False,1,359
30543,158415238,158436763,True,1,21525
30544,158422595,158430996,False,1,8401
30545,158426307,158426497,False,1,190
30546,158426357,158426476,True,1,119
30547,158428638,158429424,False,1,786
30548,158428638,158429424,True,1,786
30549,158438843,158439486,True,1,643
30550,158439271,158439481,True,2,210
30551,158450082,158450663,True,1,581
30552,158454612,158455208,True,1,596
30553,158455807,158460545,True,4,4738
30554,158455807,158470397,False,1,14590
30555,158455807,158470397,True,1,14590
30556,158505710,158505918,True,2,208
30557,158505710,158506018,True,1,308
30558,158506866,158516494,True,3,9628
30559,158515887,158516548,True,1,661
30560,158517337,158630025,True,2,112688
30561,158519473,158527042,True,1,7569
30562,158540640,158548019,True,2,7379
30563,158542265,158543681,True,1,1416
30564,158552155,158553930,True,2,1775
30565,158552155,158555309,True,1,3154
30566,158554648,158559631,True,1,4983
30567,158555684,158556298,True,1,614
30568,158555785,158556087,True,1,302
30569,158564996,158566412,True,1,1416
30570,158572856,158573277,True,1,421
30571,158624557,158624764,True,1,207
30572,158626295,158626601,True,1,306
30573,158627056,158627673,True,1,617
30574,158637267,158637927,True,1,660
30575,158662617,158667067,True,1,4450
30576,158680319,158685642,True,1,5323
30577,158695223,158695523,True,2,300
30578,158695971,158696606,True,1,635
30579,158699671,158703218,True,1,3547
30580,158712349,158712655,True,1,306
30581,158723067,158725103,False,1,2036
30582,158725875,158726506,False,1,631
30583,158726681,158726976,False,2,295
30584,158747243,158747250,True,1,7
30585,158758824,158776935,False,1,18111
30586,158758824,158777972,False,1,19148
30587,158758824,158778107,False,1,19283
30588,158768550,158768827,True,3,277
30589,158792233,158792981,True,1,748
30590,158792287,158792981,True,1,694
30591,158792724,158792981,True,1,257
30592,158814574,158816442,False,1,1868
30593,158814574,158816442,True,3,1868
30594,158821777,158822239,True,1,462
30595,158824913,158837439,True,1,12526
30596,158836073,158838831,True,1,2758
30597,158857038,158913379,True,1,56341
30598,158857038,158938926,True,1,81888
30599,158874182,158876460,True,1,2278
30600,158876821,158879673,True,1,2852
30601,158879038,158880507,True,1,1469
30602,158894082,158914858,False,1,20776
30603,158945754,158948329,True,1,2575
30604,158954351,158954499,False,1,148
30605,158954855,158954947,True,2,92
30606,158968492,159060037,False,1,91545
30607,158974078,159028392,False,1,54314
30608,158991799,158997492,True,2,5693
30609,159006983,159014056,True,1,7073
30610,159014886,159015243,False,1,357
30611,159014886,159015243,True,3,357
30612,159050354,159051498,False,1,1144
30613,159050354,159054857,True,1,4503
30614,159050354,159056441,False,1,6087
30615,159050354,159056441,True,1,6087
30616,159063742,159065550,True,2,1808
30617,159102849,159104312,True,3,1463
30618,159111764,159112025,False,1,261
30619,159134564,159137900,False,4,3336
30620,159134564,159151217,False,2,16653
30621,159150715,159160726,True,1,10011
30622,159151723,159152097,True,1,374
30623,159154868,159172353,False,1,17485
30624,159154868,159172353,True,1,17485
30625,159156680,159166301,True,1,9621
30626,159162859,159176100,True,1,13241
30627,159182065,159182149,True,1,84
30628,159207249,159209587,False,1,2338
30629,159207249,159209587,True,2,2338
30630,159208628,159208738,False,1,110
30631,159208628,159213527,True,1,4899
30632,159218806,159221348,False,1,2542
30633,159218806,159221348,True,2,2542
30634,159232205,159232348,False,1,143
30635,159235668,159236161,False,1,493
30636,159235668,159236161,True,1,493
30637,159253498,159254311,True,1,813
30638,159256194,159260424,True,1,4230
30639,159264679,159265611,True,1,932
30640,159267690,159268517,True,1,827
30641,159291073,159293713,False,1,2640
30642,159291073,159293713,True,2,2640
30643,159291073,159295743,True,1,4670
30644,159291073,159297241,True,1,6168
30645,159291350,159293994,False,1,2644
30646,159295182,159299150,True,4,3968
30647,159297132,159297285,True,1,153
30648,159299543,159299951,False,1,408
30649,159302094,159303594,True,2,1500
30650,159341004,159341671,True,2,667
30651,159352007,159370052,True,1,18045
30652,159358814,159361246,True,3,2432
30653,159361007,159362452,True,1,1445
30654,159395406,159444720,False,1,49314
30655,159395406,159444720,True,2,49314
30656,159407809,159411300,True,1,3491
30657,159407809,159427146,True,1,19337
30658,159407809,159433763,True,3,25954
30659,159449739,159473295,True,1,23556
30660,159472290,159474803,True,1,2513
30661,159477970,159479947,True,1,1977
30662,159480392,159618735,True,2,138343
30663,159492562,159679243,False,1,186681
30664,159492562,159679243,True,3,186681
30665,159499226,159503846,True,1,4620
30666,159502191,159502569,True,1,378
30667,159524134,159528725,True,3,4591
30668,159528733,159582404,True,1,53671
30669,159530458,159583335,True,1,52877
30670,159561075,159561375,True,2,300
30671,159561479,159561578,True,1,99
30672,159567766,159574669,False,1,6903
30673,159567766,159581408,True,1,13642
30674,159583095,159583744,True,1,649
30675,159583493,159584212,False,1,719
30676,159583902,159584011,True,1,109
30677,159585080,159607219,True,4,22139
30678,159587179,159588625,True,4,1446
30679,159587433,159593367,True,1,5934
30680,159603001,159604051,True,3,1050
30681,159616746,159617496,False,1,750
30682,159616746,159635543,False,1,18797
30683,159652415,159652643,True,1,228
30684,159652547,159652643,False,1,96
30685,159652547,159652643,True,2,96
30686,159680928,159684102,True,2,3174
30687,159691731,159691825,True,1,94
30688,159699307,159701024,True,1,1717
30689,159699307,159701939,True,1,2632
30690,159699315,159701024,True,1,1709
30691,159699315,159701939,True,1,2624
30692,159699337,159701024,True,1,1687
30693,159699337,159701939,True,2,2602
30694,159699799,159701243,True,1,1444
30695,159704769,159710101,True,1,5332
30696,159708434,159712125,True,3,3691
30697,159720473,159720565,True,1,92
30698,159723596,159723716,True,7,120
30699,159740304,159741462,True,1,1158
30700,159757077,159757168,True,2,91
30701,159757461,159850188,True,1,92727
30702,159772025,159773054,False,2,1029
30703,159781105,159781447,True,1,342
30704,159781520,159782468,True,4,948
30705,159783846,159784281,True,1,435
30706,159785931,159787053,False,1,1122
30707,159788944,159790581,True,4,1637
30708,159790698,159802578,True,1,11880
30709,159797239,159797690,True,1,451
30710,159816680,159818712,True,1,2032
30711,159821525,159822512,True,1,987
30712,159822404,159822739,True,1,335
30713,159822404,159822952,True,1,548
30714,159822404,159822993,True,1,589
30715,159823067,159824256,True,1,1189
30716,159847028,159851738,False,2,4710
30717,159847028,159851738,True,1,4710
30718,159847028,159855744,True,1,8716
30719,159857848,159861824,False,1,3976
30720,159857848,159861824,True,15,3976
30721,159866657,159867636,True,1,979
30722,159871049,159872483,True,2,1434
30723,159871049,159876853,True,2,5804
30724,159872276,159873119,True,1,843
30725,159880675,159881081,False,1,406
30726,159887034,159887167,False,1,133
30727,159901249,159902694,True,1,1445
30728,159902190,159903462,True,1,1272
30729,159953673,159953745,True,2,72
30730,159953673,159953760,True,1,87
30731,159961055,159967258,False,2,6203
30732,159963018,159963431,True,1,413
30733,159972217,159973851,True,1,1634
30734,159979203,159979792,True,1,589
30735,159987695,159987821,True,2,126
30736,159997987,160114671,True,1,116684
30737,160012460,160012682,True,2,222
30738,160017208,160018413,False,1,1205
30739,160017208,160293466,False,1,276258
30740,160019602,160020011,True,1,409
30741,160019602,160020870,True,1,1268
30742,160019602,160020910,True,2,1308
30743,160020097,160020910,True,2,813
30744,160031877,160031962,True,3,85
30745,160038313,160038576,True,1,263
30746,160038346,160039468,True,1,1122
30747,160054327,160066238,False,1,11911
30748,160054327,160167232,False,1,112905
30749,160072768,160072932,False,1,164
30750,160073369,160073444,True,1,75
30751,160077079,160078470,True,1,1391
30752,160085942,160086022,True,1,80
30753,160103252,160105467,False,1,2215
30754,160110917,160150201,True,2,39284
30755,160119087,160144911,True,1,25824
30756,160141506,160155431,True,1,13925
30757,160159118,160159809,False,1,691
30758,160176163,160179459,True,1,3296
30759,160227309,160232559,True,2,5250
30760,160234075,160337142,False,1,103067
30761,160273672,160317321,True,4,43649
30762,160337137,160339670,False,1,2533
30763,160337137,160339670,True,5,2533
30764,160372686,160380138,True,1,7452
30765,160372702,160380138,True,1,7436
30766,160373868,160380743,True,1,6875
30767,160380342,160383964,True,1,3622
30768,160382149,160383246,True,1,1097
30769,160382648,160391150,False,2,8502
30770,160382648,160391150,True,3,8502
30771,160385650,160386631,True,1,981
30772,160386038,160386534,True,1,496
30773,160387367,160387506,True,1,139
30774,160392290,160393506,True,2,1216
30775,160403243,160404386,False,1,1143
30776,160403243,160404386,True,2,1143
30777,160403243,160407285,True,1,4042
30778,160407766,160410600,True,1,2834
30779,160415508,160416706,True,1,1198
30780,160445946,160450908,True,1,4962
30781,160463198,160506905,True,1,43707
30782,160463198,160517357,True,1,54159
30783,160477216,160484599,True,1,7383
30784,160497360,160498318,False,1,958
30785,160506747,160513208,True,1,6461
30786,160506747,160516271,True,1,9524
30787,160513352,160595201,False,1,81849
30788,160513352,160595201,True,1,81849
30789,160535893,160543233,True,2,7340
30790,160546052,160546814,True,1,762
30791,160548041,160548297,True,1,256
30792,160548864,160549295,True,1,431
30793,160551319,160551610,True,1,291
30794,160551937,160561615,True,1,9678
30795,160552143,160561821,True,2,9678
30796,160559145,160559651,True,1,506
30797,160634283,160636876,True,1,2593
30798,160671619,160678618,True,2,6999
30799,160678204,160679424,False,1,1220
30800,160682222,160724328,True,1,42106
30801,160697495,160699290,False,1,1795
30802,160697495,160699290,True,1,1795
30803,160697495,160703155,True,1,5660
30804,160704060,160719413,True,1,15353
30805,160704060,160742665,True,1,38605
30806,160704060,160759276,True,1,55216
30807,160704060,160764577,True,2,60517
30808,160704576,160719775,True,1,15199
30809,160705090,160743257,True,1,38167
30810,160729891,160755658,True,1,25767
30811,160729891,160777570,True,1,47679
30812,160732242,160734858,True,1,2616
30813,160739928,160740900,True,1,972
30814,160746476,160750065,True,2,3589
30815,160752867,160753874,True,1,1007
30816,160755383,160759892,True,1,4509
30817,160783231,160785096,False,1,1865
30818,160790241,160792507,True,1,2266
30819,160802462,160802783,True,14,321
30820,160806962,160807623,True,1,661
30821,160815720,160816164,False,1,444
30822,160827674,160828050,False,1,376
30823,160832443,160833925,True,1,1482
30824,160833245,160834405,True,5,1160
30825,160845481,160850078,True,1,4597
30826,160890313,160890496,True,1,183
30827,160890456,160890575,False,1,119
30828,160890709,160895632,True,1,4923
30829,160893551,160929665,False,1,36114
30830,160898804,160900388,True,1,1584
30831,160915046,160915236,False,2,190
30832,160915046,160949917,True,1,34871
30833,160915046,160989783,True,1,74737
30834,160915989,160950529,True,1,34540
30835,160939803,160942342,False,1,2539
30836,160939803,160943260,False,1,3457
30837,160955776,160998821,True,3,43045
30838,161002968,161248159,False,1,245191
30839,161026918,161028914,True,1,1996
30840,161031800,161044548,False,1,12748
30841,161046497,161072083,False,1,25586
30842,161046497,161072083,True,2,25586
30843,161058334,161068997,True,1,10663
30844,161058334,161076068,True,1,17734
30845,161058338,161076068,True,1,17730
30846,161060005,161060277,True,1,272
30847,161064689,161152575,True,1,87886
30848,161068557,161073944,False,1,5387
30849,161068557,161130487,False,1,61930
30850,161068562,161076090,False,1,7528
30851,161103127,161104953,False,1,1826
30852,161107724,161112834,False,1,5110
30853,161113444,161135564,False,1,22120
30854,161146338,161146835,False,1,497
30855,161146338,161146835,True,1,497
30856,161149829,161152024,False,2,2195
30857,161149829,161152024,True,1,2195
30858,161194890,161197959,True,1,3069
30859,161194918,161197959,True,1,3041
30860,161195275,161197959,True,1,2684
30861,161201680,161202533,False,1,853
30862,161206522,161207857,True,1,1335
30863,161230952,161231307,False,1,355
30864,161230952,161231307,True,1,355
30865,161251128,161253663,True,1,2535
30866,161251128,161255868,True,1,4740
30867,161252308,161252577,True,1,269
30868,161276118,161279662,True,1,3544
30869,161309191,161310791,False,1,1600
30870,161311528,161315276,True,1,3748
30871,161333498,161335810,True,2,2312
30872,161333498,161336439,True,1,2941
30873,161333498,161341459,True,2,7961
30874,161349353,161350899,True,1,1546
30875,161349353,161351361,True,1,2008
30876,161354250,161354844,True,1,594
30877,161354250,161355128,True,2,878
30878,161355592,161363492,False,1,7900
30879,161364854,161365414,False,1,560
30880,161387104,161389814,True,1,2710
30881,161392092,161394213,True,1,2121
30882,161393579,161439910,True,2,46331
30883,161407586,161408749,False,3,1163
30884,161420192,161423978,True,2,3786
30885,161420192,161431778,True,1,11586
30886,161428751,161429866,True,1,1115
30887,161428751,161429878,True,1,1127
30888,161429530,161437580,True,5,8050
30889,161429530,161446425,True,1,16895
30890,161467298,161476798,True,1,9500
30891,161470670,161478523,True,1,7853
30892,161497381,161531066,False,1,33685
30893,161500433,161500718,True,1,285
30894,161500495,161500780,True,1,285
30895,161522233,161523534,True,1,1301
30896,161557609,161602715,False,1,45106
30897,161576062,161576202,True,1,140
30898,161632787,161647374,True,1,14587
30899,161632949,161653605,True,2,20656
30900,161651391,161721543,True,1,70152
30901,161654050,161655281,False,1,1231
30902,161657818,161707461,True,1,49643
30903,161662477,161701584,False,1,39107
30904,161662477,161746326,True,1,83849
30905,161676304,161676644,True,1,340
30906,161702509,161705927,True,3,3418
30907,161702571,161705933,True,1,3362
30908,161707566,161712225,True,1,4659
30909,161727293,161736653,False,1,9360
30910,161758197,161759251,True,1,1054
30911,161775819,161777832,True,1,2013
30912,161797516,161797820,True,2,304
30913,161798972,161821246,True,1,22274
30914,161800568,161801726,False,1,1158
30915,161803591,161806419,True,2,2828
30916,161822002,161822977,True,1,975
30917,161822002,161824866,True,1,2864
30918,161824244,161827574,True,2,3330
30919,161888075,161907135,True,1,19060
30920,161888075,161914578,False,1,26503
30921,161897574,161901957,False,3,4383
30922,161897574,161901957,True,6,4383
30923,161926745,161934073,True,1,7328
30924,161976011,162029503,True,2,53492
30925,162006919,162040360,True,1,33441
30926,162019774,162025107,True,1,5333
30927,162074019,162086467,True,1,12448
30928,162075427,162080378,True,1,4951
30929,162080984,162085635,True,5,4651
30930,162085147,162092858,True,1,7711
30931,162131957,162133016,True,1,1059
30932,162139268,162144416,True,1,5148
30933,162141866,162145745,True,2,3879
30934,162143666,162237588,True,1,93922
30935,162143666,162237914,True,1,94248
30936,162149215,162150013,True,1,798
30937,162174800,162181910,True,1,7110
30938,162190327,162191933,True,1,1606
30939,162203424,162203708,True,1,284
30940,162210943,162220703,True,1,9760
30941,162213095,162219047,True,1,5952
30942,162214718,162216049,True,2,1331
30943,162222050,162222842,True,1,792
30944,162232119,162233617,False,1,1498
30945,162232119,162233617,True,1,1498
30946,162237573,162239887,True,1,2314
30947,162269372,162276648,False,2,7276
30948,162269372,162276648,True,1,7276
30949,162288296,162296112,False,1,7816
30950,162288296,162296112,True,2,7816
30951,162313939,162317459,False,1,3520
30952,162349667,162350827,False,1,1160
30953,162376074,162383802,True,1,7728
30954,162376074,162395218,True,1,19144
30955,162382675,162396412,False,1,13737
30956,162382675,162396412,True,1,13737
30957,162408304,162408440,True,2,136
30958,162413338,162414027,True,2,689
30959,162414751,162416738,False,1,1987
30960,162480906,162483965,False,2,3059
30961,162513906,162540779,True,2,26873
30962,162533666,162536408,True,1,2742
30963,162535968,162539853,True,1,3885
30964,162535968,162551219,True,3,15251
30965,162539912,162542383,True,1,2471
30966,162544872,162551373,True,3,6501
30967,162594146,162599055,True,1,4909
30968,162632948,162633413,True,2,465
30969,162638329,162638750,False,1,421
30970,162663516,162666147,True,2,2631
30971,162697455,162733756,True,1,36301
30972,162732654,162737436,True,1,4782
30973,162741432,162741767,True,4,335
30974,162741432,162742027,True,1,595
30975,162741432,162742030,True,1,598
30976,162741432,162742251,True,1,819
30977,162741432,162742760,True,1,1328
30978,162744239,162752478,True,1,8239
30979,162744271,162744673,True,2,402
30980,162761793,162766718,True,1,4925
30981,162771055,162772442,True,1,1387
30982,162783610,162811677,True,1,28067
30983,162795967,162809580,True,1,13613
30984,162798464,162810174,False,1,11710
30985,162798464,162810174,True,3,11710
30986,162844062,162950358,True,4,106296
30987,162853382,162854252,True,1,870
30988,162944018,162975145,True,1,31127
30989,162944042,162975172,True,1,31130
30990,162950329,162955784,False,1,5455
30991,162950329,162955784,True,1,5455
30992,162950329,162992730,False,1,42401
30993,162957920,163119944,True,1,162024
30994,162961437,162998331,True,1,36894
30995,162978696,163006856,True,1,28160
30996,162978711,163006856,True,1,28145
30997,163035691,163069750,True,1,34059
30998,163058052,163170123,True,1,112071
30999,163078463,163087108,True,1,8645
31000,163091132,163091207,True,1,75
31001,163094397,163095953,True,1,1556
31002,163141212,163141353,True,1,141
31003,163142388,163143054,True,1,666
31004,163150977,163152057,True,1,1080
31005,163159241,163168006,True,2,8765
31006,163168821,163170405,True,1,1584
31007,163169642,163173531,True,1,3889
31008,163178672,163180972,True,1,2300
31009,163178687,163180911,True,1,2224
31010,163182104,163184089,False,1,1985
31011,163184536,163185403,True,1,867
31012,163202052,163206726,True,1,4674
31013,163210750,163215754,True,2,5004
31014,163250362,163251818,False,1,1456
31015,163250362,163251818,True,2,1456
31016,163260247,163260976,True,1,729
31017,163277070,163288616,False,1,11546
31018,163288056,163298390,True,1,10334
31019,163288469,163293668,True,3,5199
31020,163305483,163307770,False,1,2287
31021,163305483,163307770,True,6,2287
31022,163305483,163309052,True,6,3569
31023,163306054,163421405,True,1,115351
31024,163311546,163312735,True,6,1189
31025,163329458,163330979,False,1,1521
31026,163358165,163364768,True,1,6603
31027,163359045,163360105,False,1,1060
31028,163360757,163361601,False,1,844
31029,163375430,163375542,False,1,112
31030,163395479,163397954,True,1,2475
31031,163455268,163464005,True,1,8737
31032,163464209,163470236,True,2,6027
31033,163544038,163682548,True,1,138510
31034,163545719,163546541,False,1,822
31035,163614922,163619138,False,5,4216
31036,163625927,163632444,True,1,6517
31037,163639137,163707397,True,1,68260
31038,163676943,163679795,True,1,2852
31039,163676943,163679996,True,4,3053
31040,163677718,163680373,True,3,2655
31041,163678063,163680394,False,2,2331
31042,163678063,163680595,False,2,2532
31043,163678448,163680394,True,1,1946
31044,163723815,163725930,True,1,2115
31045,163769186,163772713,True,1,3527
31046,163784839,163794093,True,1,9254
31047,163830547,163832274,True,7,1727
31048,163881415,163883844,True,1,2429
31049,163904872,163919008,True,1,14136
31050,163931015,163931104,True,1,89
31051,163935452,163945238,False,1,9786
31052,164020793,164023374,True,4,2581
31053,164065079,164065644,True,1,565
31054,164065214,164065849,True,1,635
31055,164070820,164269789,False,1,198969
31056,164138151,164170630,True,1,32479
31057,164143588,164145164,False,1,1576
31058,164191801,164194081,True,2,2280
31059,164194190,164194714,True,2,524
31060,164209071,164216691,True,1,7620
31061,164209071,164220551,True,1,11480
31062,164209071,164226689,True,1,17618
31063,164233104,164234170,True,1,1066
31064,164233104,164238712,True,1,5608
31065,164330947,164392948,True,1,62001
31066,164335296,164347804,True,1,12508
31067,164336640,164347995,True,1,11355
31068,164336640,164348461,True,1,11821
31069,164336640,164348478,True,1,11838
31070,164347206,164353794,True,1,6588
31071,164347206,164353811,True,1,6605
31072,164364234,164364678,True,1,444
31073,164374627,164375479,True,6,852
31074,164379638,164380833,True,1,1195
31075,164385626,164388316,True,1,2690
31076,164428164,164463008,True,3,34844
31077,164532278,164568649,True,3,36371
31078,164595928,164627565,True,1,31637
31079,164601263,164630482,True,1,29219
31080,164671072,164671907,True,1,835
31081,164697164,164701669,True,3,4505
31082,164701637,164706358,True,1,4721
31083,164708246,164709296,False,1,1050
31084,164708246,164709296,True,1,1050
31085,164726885,164732512,True,1,5627
31086,164741285,164741452,True,1,167
31087,164746750,164774043,True,3,27293
31088,164746797,164774043,True,2,27246
31089,164749988,164750697,True,1,709
31090,164762003,164765000,False,1,2997
31091,164771351,164773273,True,1,1922
31092,164781881,164782378,True,1,497
31093,164805562,164806498,False,1,936
31094,164832038,164832572,True,1,534
31095,164845462,164853557,True,2,8095
31096,164872215,164873531,True,1,1316
31097,164874635,164876533,False,1,1898
31098,164874635,164876533,True,1,1898
31099,164901800,164903345,True,3,1545
31100,164915634,164916751,True,2,1117
31101,164923201,164923590,True,1,389
31102,165004348,165056466,False,1,52118
31103,165046395,165046746,False,1,351
31104,165071572,165084835,True,2,13263
31105,165089865,165122466,True,1,32601
31106,165110424,165113059,True,1,2635
31107,165110424,165119093,True,1,8669
31108,165110714,165119127,False,1,8413
31109,165140851,165141899,True,3,1048
31110,165171292,165176504,False,1,5212
31111,165225600,165237059,True,1,11459
31112,165225600,165237063,True,3,11463
31113,165228665,165228767,False,1,102
31114,165228665,165228767,True,4,102
31115,165230507,165241299,True,2,10792
31116,165242199,165242278,False,1,79
31117,165268384,165268593,True,1,209
31118,165289738,165309984,True,1,20246
31119,165294827,165340154,False,1,45327
31120,165294877,165340154,False,1,45277
31121,165321140,165333361,True,1,12221
31122,165321140,165552363,True,5,231223
31123,165385934,165391104,True,3,5170
31124,165385934,165391108,True,1,5174
31125,165396877,165406329,True,1,9452
31126,165424174,165435923,False,1,11749
31127,165425645,165426430,True,3,785
31128,165444552,165446213,True,1,1661
31129,165446086,165447016,False,1,930
31130,165493173,165494354,False,1,1181
31131,165493173,165494354,True,1,1181
31132,165504878,165532855,True,1,27977
31133,165510396,165510822,False,1,426
31134,165529234,165531229,False,5,1995
31135,165529566,165531229,False,2,1663
31136,165535334,165546822,True,5,11488
31137,165536699,165536790,False,1,91
31138,165566295,165566770,False,1,475
31139,165608152,165609816,True,1,1664
31140,165609648,165610582,True,1,934
31141,165616814,166001080,False,1,384266
31142,165617764,165618028,False,1,264
31143,165642449,165643872,False,1,1423
31144,165642449,165643872,True,1,1423
31145,165669519,165672786,True,1,3267
31146,165736809,165740503,True,2,3694
31147,165761228,165762050,True,5,822
31148,165765942,165771159,False,1,5217
31149,165802385,165804983,True,1,2598
31150,165807036,165807685,False,1,649
31151,165811060,165814809,True,5,3749
31152,165865030,165865238,True,1,208
31153,165871620,165874196,True,2,2576
31154,165889778,165914558,False,1,24780
31155,165889778,165914902,False,3,25124
31156,165889828,165914558,False,3,24730
31157,165889828,165914902,False,2,25074
31158,165942503,165943134,False,1,631
31159,165945509,165949406,True,4,3897
31160,165990575,166007829,True,2,17254
31161,165994760,166009990,False,1,15230
31162,166020953,166021161,True,1,208
31163,166028111,166028492,False,1,381
31164,166047801,166093166,False,1,45365
31165,166047851,166093166,False,1,45315
31166,166146178,166146283,True,1,105
31167,166148006,166148298,True,1,292
31168,166162381,166331720,True,3,169339
31169,166162381,166370528,True,1,208147
31170,166177156,166188905,False,1,11749
31171,166197602,166199263,True,1,1661
31172,166232337,166241004,True,2,8667
31173,166232340,166241004,True,1,8664
31174,166263568,166263994,False,1,426
31175,166282404,166284399,False,5,1995
31176,166282736,166284399,False,3,1663
31177,166289867,166289958,False,1,91
31178,166337022,166339098,True,9,2076
31179,166345720,166350333,True,1,4613
31180,166411135,166412558,True,1,1423
31181,166425402,166427139,True,10,1737
31182,166477512,166497147,True,2,19635
31183,166549773,166550512,False,1,739
31184,166549773,166550921,True,4,1148
31185,166552461,166553595,True,2,1134
31186,166632763,166633330,True,3,567
31187,166634079,166635040,False,1,961
31188,166656494,166656627,True,5,133
31189,166686598,166839961,True,1,153363
31190,166687515,166699541,True,1,12026
31191,166689752,166690430,False,1,678
31192,166689752,166690904,True,2,1152
31193,166703791,166720796,True,1,17005
31194,166703851,166720885,False,1,17034
31195,166714762,166715087,True,1,325
31196,166744853,166747282,False,1,2429
31197,166758549,166759159,False,1,610
31198,166758549,166759533,False,1,984
31199,166790832,166801913,True,1,11081
31200,166812475,166816815,True,2,4340
31201,166856375,166858875,True,3,2500
31202,166880366,166884307,False,1,3941
31203,166957059,166959825,True,1,2766
31204,166995318,167042138,True,1,46820
31205,167036383,167037629,True,2,1246
31206,167068802,167069288,False,2,486
31207,167103359,167108431,True,1,5072
31208,167149903,167154065,True,3,4162
31209,167163269,167182897,True,1,19628
31210,167178800,167180177,True,1,1377
31211,167204946,167269214,False,1,64268
31212,167204946,167269214,True,1,64268
31213,167231873,167235009,True,1,3136
31214,167254941,167281418,False,1,26477
31215,167270988,167753562,False,1,482574
31216,167270988,167753562,True,3,482574
31217,167275218,167286386,True,1,11168
31218,167275218,167563923,True,2,288705
31219,167275567,167564197,True,3,288630
31220,167275567,167756209,True,2,480642
31221,167310075,167311040,True,1,965
31222,167315623,167335012,True,1,19389
31223,167318777,167320052,True,1,1275
31224,167346868,167350442,False,1,3574
31225,167346868,167350442,True,1,3574
31226,167347588,167350442,True,1,2854
31227,167354128,167355688,True,1,1560
31228,167372157,167372637,True,2,480
31229,167455755,167459070,True,1,3315
31230,167480219,167482001,True,12,1782
31231,167493962,167499903,True,1,5941
31232,167530499,167534792,True,1,4293
31233,167552847,167557870,False,1,5023
31234,167552847,167557870,True,3,5023
31235,167554882,167583832,True,2,28950
31236,167568908,167569876,True,1,968
31237,167581418,167582170,True,1,752
31238,167612991,167613091,True,1,100
31239,167614830,167626768,True,1,11938
31240,167630604,167631447,False,3,843
31241,167643871,167647723,False,1,3852
31242,167643871,167647723,True,2,3852
31243,167651972,167653363,True,1,1391
31244,167683233,167683790,True,1,557
31245,167695211,167697849,True,6,2638
31246,167695772,167696608,False,1,836
31247,167752033,167754807,True,1,2774
31248,167753634,167754610,True,1,976
31249,167753634,167754614,True,2,980
31250,167806193,167807060,True,1,867
31251,167806193,167807279,True,1,1086
31252,167824093,167832075,False,1,7982
31253,167841922,167846324,True,3,4402
31254,167851532,167856355,True,2,4823
31255,167866006,167873319,True,1,7313
31256,167912689,167923015,True,2,10326
31257,167965782,167967402,True,1,1620
31258,167965782,167973914,True,1,8132
31259,167973801,167978069,True,1,4268
31260,168004690,168007990,True,1,3300
31261,168011295,168017562,True,1,6267
31262,168023334,168027039,False,2,3705
31263,168023334,168027039,True,2,3705
31264,168031250,168041353,True,1,10103
31265,168085825,168257349,False,1,171524
31266,168086870,168089992,True,1,3122
31267,168175618,168176976,True,2,1358
31268,168232420,168272901,True,1,40481
31269,168232420,168344093,False,1,111673
31270,168232420,168344093,True,4,111673
31271,168237118,168616825,True,1,379707
31272,168314076,168318894,True,2,4818
31273,168323714,168340252,False,1,16538
31274,168358033,168361474,False,1,3441
31275,168358033,168361474,True,1,3441
31276,168365765,168366428,False,1,663
31277,168370492,168373217,False,1,2725
31278,168370492,168373713,True,1,3221
31279,168385460,168385922,True,1,462
31280,168397817,168397958,True,3,141
31281,168408804,168410775,True,1,1971
31282,168424909,168425002,True,7,93
31283,168430202,168430283,True,1,81
31284,168430269,168435724,False,2,5455
31285,168430269,168435724,True,5,5455
31286,168444606,168453445,True,1,8839
31287,168444606,168455332,True,1,10726
31288,168449976,168452332,True,1,2356
31289,168449976,168452768,True,1,2792
31290,168453557,168454973,True,1,1416
31291,168454075,168454156,True,1,81
31292,168480974,168483722,True,1,2748
31293,168511366,168525074,True,1,13708
31294,168517830,168560347,True,1,42517
31295,168517830,168601491,False,1,83661
31296,168519214,168638631,False,1,119417
31297,168526608,168528464,True,6,1856
31298,168531825,168535682,True,1,3857
31299,168536376,168583030,False,1,46654
31300,168540144,168542287,True,1,2143
31301,168609501,168667508,False,1,58007
31302,168632296,168635917,False,1,3621
31303,168645865,168647316,True,3,1451
31304,168657121,168674965,True,2,17844
31305,168657211,168666380,False,2,9169
31306,168657211,168666380,True,2,9169
31307,168670821,168683406,False,2,12585
31308,168670821,168683700,False,2,12879
31309,168670821,168683700,True,1,12879
31310,168671040,168680954,False,1,9914
31311,168694858,168696423,True,1,1565
31312,168740049,168744317,True,1,4268
31313,168749402,168750724,True,1,1322
31314,168749402,168750852,True,1,1450
31315,168749402,168750963,True,1,1561
31316,168754447,168755177,True,1,730
31317,168766148,168766738,True,2,590
31318,168804452,168834235,True,2,29783
31319,168876882,168880041,True,1,3159
31320,168880448,168882202,True,1,1754
31321,168914236,168914721,True,1,485
31322,168914618,168914914,True,1,296
31323,168915385,168923156,True,1,7771
31324,168987618,168988529,True,1,911
31325,168998193,168999903,True,2,1710
31326,168999663,169000677,True,1,1014
31327,169023597,169024098,True,2,501
31328,169040384,169043421,True,1,3037
31329,169056923,169057665,True,1,742
31330,169066826,169069601,True,1,2775
31331,169074446,169095533,True,1,21087
31332,169086956,169087711,True,1,755
31333,169087798,169188602,True,2,100804
31334,169091449,169106443,False,1,14994
31335,169117100,169117855,True,1,755
31336,169119104,169178385,True,1,59281
31337,169119104,169184662,True,1,65558
31338,169126214,169126396,True,1,182
31339,169138945,169143261,True,1,4316
31340,169199764,169222912,True,1,23148
31341,169207605,169208377,True,1,772
31342,169220182,169254809,True,1,34627
31343,169254052,169260987,True,3,6935
31344,169260169,169269074,True,2,8905
31345,169260169,169274922,True,1,14753
31346,169261344,169269658,True,3,8314
31347,169261344,169275506,False,1,14162
31348,169294753,169295223,True,1,470
31349,169301542,169303183,True,1,1641
31350,169320490,169328100,True,1,7610
31351,169359738,169364703,True,1,4965
31352,169364385,169366586,True,2,2201
31353,169375918,169380917,False,1,4999
31354,169429514,169527409,False,1,97895
31355,169435357,169450228,False,1,14871
31356,169467271,169471898,True,1,4627
31357,169467271,169500593,True,3,33322
31358,169487021,169508448,True,2,21427
31359,169487285,169488519,True,2,1234
31360,169490117,169520352,True,1,30235
31361,169498016,169498834,True,1,818
31362,169528298,169532932,True,1,4634
31363,169534772,169536172,True,1,1400
31364,169536706,169537217,True,1,511
31365,169621316,169625672,True,1,4356
31366,169661818,169661910,False,1,92
31367,169668954,169670054,True,3,1100
31368,169682578,169683999,True,1,1421
31369,169707325,169725612,True,6,18287
31370,169721529,169723111,False,1,1582
31371,169728586,169731796,True,1,3210
31372,169737559,169739219,False,1,1660
31373,169737691,169739683,False,1,1992
31374,169746011,169746104,False,1,93
31375,169747265,169747519,False,1,254
31376,169748234,169750552,True,1,2318
31377,169748320,169750638,True,1,2318
31378,169769118,169769372,True,1,254
31379,169771013,169771563,True,1,550
31380,169780497,169822440,False,1,41943
31381,169809194,169810860,True,1,1666
31382,169890111,169891556,True,1,1445
31383,169890792,169895031,True,1,4239
31384,169928236,169931512,True,1,3276
31385,169944113,169953916,False,1,9803
31386,169944113,169953916,True,2,9803
31387,170016666,170017199,False,1,533
31388,170016951,170783802,True,1,766851
31389,170016951,170859327,True,1,842376
31390,170018191,170018765,True,2,574
31391,170039685,170047741,True,3,8056
31392,170098014,170099865,True,2,1851
31393,170101024,170101233,False,1,209
31394,170122838,170161878,True,1,39040
31395,170122866,170161913,True,2,39047
31396,170128407,170129313,False,1,906
31397,170128407,170129313,True,1,906
31398,170141324,170152187,False,1,10863
31399,170190482,170190956,True,1,474
31400,170190482,170191203,True,1,721
31401,170191265,170353804,True,1,162539
31402,170191265,170536984,True,1,345719
31403,170192244,170537117,True,2,344873
31404,170194348,170538631,True,1,344283
31405,170222679,170224741,False,1,2062
31406,170222679,170225432,True,6,2753
31407,170227844,170229323,False,1,1479
31408,170228823,170229808,False,1,985
31409,170230992,170231673,False,1,681
31410,170231522,170232876,True,1,1354
31411,170236010,170244239,True,2,8229
31412,170242418,170242660,True,1,242
31413,170264916,170265707,True,2,791
31414,170265604,170265887,True,1,283
31415,170288614,170291297,True,4,2683
31416,170288614,170308079,True,1,19465
31417,170294614,170310881,True,3,16267
31418,170341570,170348177,False,1,6607
31419,170350219,170351743,False,1,1524
31420,170350219,170355266,False,1,5047
31421,170350219,170355266,True,1,5047
31422,170372965,170374711,False,2,1746
31423,170372965,170374711,True,1,1746
31424,170378280,170379820,True,1,1540
31425,170396820,170453240,True,1,56420
31426,170396994,170398764,True,1,1770
31427,170396999,170398764,True,1,1765
31428,170426067,170426721,False,1,654
31429,170426067,170426721,True,5,654
31430,170426067,170436709,True,1,10642
31431,170450688,170457867,False,1,7179
31432,170450688,170457867,True,1,7179
31433,170509051,170510482,True,2,1431
31434,170552447,170553840,True,1,1393
31435,170558939,170610151,True,2,51212
31436,170583712,170599753,True,1,16041
31437,170633726,170635165,False,1,1439
31438,170642956,170647299,False,1,4343
31439,170679348,170679790,True,2,442
31440,170679348,170681803,True,2,2455
31441,170679348,170682345,True,2,2997
31442,170679348,170684744,True,1,5396
31443,170718095,170720253,True,1,2158
31444,170718095,170724067,True,1,5972
31445,170720736,170726469,True,1,5733
31446,170721638,170721719,True,1,81
31447,170740248,170741286,False,1,1038
31448,170740248,170742038,False,1,1790
31449,170783669,170786504,False,1,2835
31450,170783669,170786504,True,1,2835
31451,170794474,170795375,True,1,901
31452,170807566,170842689,True,1,35123
31453,170807566,171035279,True,1,227713
31454,170807566,171172734,True,1,365168
31455,170811647,170812488,False,1,841
31456,170811647,170812488,True,14,841
31457,170815480,170818130,True,1,2650
31458,170816427,170817758,True,1,1331
31459,170829137,170831258,True,1,2121
31460,170855894,170857813,True,5,1919
31461,170855894,170858886,True,2,2992
31462,170860283,170862024,True,1,1741
31463,170860283,170862027,True,1,1744
31464,170868646,170872761,True,1,4115
31465,170879712,170880820,True,1,1108
31466,170889342,170890428,True,1,1086
31467,170890436,170892193,True,1,1757
31468,170968704,170970515,True,3,1811
31469,170982011,170982093,True,2,82
31470,170982198,170985018,True,1,2820
31471,171008727,171029450,True,1,20723
31472,171035984,171149795,True,1,113811
31473,171035984,171287250,True,1,251266
31474,171047659,171131342,True,1,83683
31475,171050783,171132803,True,5,82020
31476,171056161,171065601,True,2,9440
31477,171095004,171097176,False,1,2172
31478,171095004,171097176,True,2,2172
31479,171095005,171095007,True,1,2
31480,171095021,171097176,True,1,2155
31481,171103577,171105085,True,1,1508
31482,171106001,171107979,True,1,1978
31483,171108608,171115213,True,4,6605
31484,171132770,171142280,True,2,9510
31485,171139581,171139837,False,1,256
31486,171139581,171139837,True,2,256
31487,171157022,171158906,True,1,1884
31488,171163794,171164039,True,3,245
31489,171163794,171164518,False,1,724
31490,171163794,171165930,True,1,2136
31491,171168464,171173396,False,2,4932
31492,171168591,171177807,False,1,9216
31493,171168591,171177807,True,1,9216
31494,171184836,171189042,True,2,4206
31495,171192196,171199803,True,1,7607
31496,171213384,171215970,True,1,2586
31497,171225721,171226819,True,1,1098
31498,171236456,171304973,True,1,68517
31499,171243951,171244529,True,3,578
31500,171245183,171247575,True,1,2392
31501,171248287,171253562,True,1,5275
31502,171290165,171327184,True,1,37019
31503,171292420,171295377,False,1,2957
31504,171293845,171314359,True,1,20514
31505,171293845,171328997,True,1,35152
31506,171295728,171302583,True,1,6855
31507,171315043,171315145,False,1,102
31508,171324163,171324451,True,1,288
31509,171327666,171329711,True,1,2045
31510,171338316,171353962,False,1,15646
31511,171338316,171353962,True,5,15646
31512,171340172,171346924,True,1,6752
31513,171348300,171351383,True,1,3083
31514,171371605,171373414,True,1,1809
31515,171393116,171395476,True,1,2360
31516,171394169,171395568,True,1,1399
31517,171423222,171423423,True,1,201
31518,171430017,171435794,True,1,5777
31519,171434021,171439841,False,1,5820
31520,171434021,171439841,True,1,5820
31521,171446279,171447330,False,1,1051
31522,171446279,171447330,True,1,1051
31523,171461515,171468561,True,1,7046
31524,171465124,171467758,True,1,2634
31525,171482795,171484891,True,1,2096
31526,171484520,171485362,False,2,842
31527,171496624,171498284,False,1,1660
31528,171505421,171505675,False,1,254
31529,171532601,171534304,True,2,1703
31530,171533887,171534968,True,1,1081
31531,171536488,171536581,True,1,93
31532,171549226,171549653,True,3,427
31533,171551329,171626826,True,1,75497
31534,171567459,171569122,True,1,1663
31535,171571418,171574588,True,4,3170
31536,171577063,171577328,False,1,265
31537,171609385,171610743,True,1,1358
31538,171623146,171630376,True,1,7230
31539,171625703,171626213,True,1,510
31540,171625703,171627045,True,1,1342
31541,171644447,171644524,False,1,77
31542,171645808,171646476,True,1,668
31543,171652109,171652315,True,3,206
31544,171660168,171676305,True,1,16137
31545,171666530,171667981,True,2,1451
31546,171668565,171668931,True,1,366
31547,171676064,171676154,True,1,90
31548,171678707,171685566,True,2,6859
31549,171686800,171689555,True,4,2755
31550,171698709,171699087,False,1,378
31551,171716034,171720872,True,3,4838
31552,171720465,171734467,False,1,14002
31553,171720561,171746284,False,1,25723
31554,171722969,171765054,True,2,42085
31555,171770417,171773014,True,2,2597
31556,171771244,171773014,True,1,1770
31557,171773294,171775020,False,1,1726
31558,171776250,171778846,False,2,2596
31559,171798533,171800400,True,2,1867
31560,171804911,171806150,True,1,1239
31561,171827730,171828951,True,1,1221
31562,171843006,171843287,True,1,281
31563,171843006,171843450,True,1,444
31564,171843006,171843854,True,1,848
31565,171847875,171952785,True,4,104910
31566,171855468,171858459,False,1,2991
31567,171865602,171869392,True,1,3790
31568,171867230,171869787,True,1,2557
31569,171873112,171878911,True,1,5799
31570,171875967,172044946,False,1,168979
31571,171908982,171909659,True,2,677
31572,171912190,171917141,True,4,4951
31573,171923238,171924296,True,1,1058
31574,171937194,171943768,False,1,6574
31575,171939273,171964298,True,2,25025
31576,171945736,171946468,True,1,732
31577,171962684,171962830,True,1,146
31578,171962684,171964335,True,1,1651
31579,171962988,171972020,True,2,9032
31580,171983327,171986435,False,1,3108
31581,171983934,171985102,True,1,1168
31582,171993365,172083968,True,1,90603
31583,171993471,172084052,True,1,90581
31584,172009733,172012153,True,3,2420
31585,172009733,172012203,True,1,2470
31586,172026772,172030537,True,1,3765
31587,172026772,172061671,False,1,34899
31588,172026772,172061671,True,1,34899
31589,172028899,172031682,False,1,2783
31590,172038956,172041150,True,1,2194
31591,172038956,172041670,False,1,2714
31592,172038956,172041670,True,2,2714
31593,172042931,172043244,True,1,313
31594,172079556,172087713,False,1,8157
31595,172084730,172087681,False,1,2951
31596,172085518,172086378,False,1,860
31597,172093173,172093489,True,1,316
31598,172133785,172137787,True,2,4002
31599,172133785,172139768,True,1,5983
31600,172157212,172158367,True,2,1155
31601,172172061,172182868,True,2,10807
31602,172176973,172219177,True,3,42204
31603,172179507,172203998,True,2,24491
31604,172196211,172196665,False,1,454
31605,172199940,172214289,True,1,14349
31606,172212671,172214877,True,2,2206
31607,172233328,172234699,False,1,1371
31608,172234886,172238633,True,2,3747
31609,172252539,172255075,True,1,2536
31610,172253147,172253435,True,4,288
31611,172253654,172256407,False,1,2753
31612,172255359,172256010,False,1,651
31613,172266198,172275156,False,1,8958
31614,172304631,172306010,True,3,1379
31615,172307306,172331133,False,1,23827
31616,172315809,172320682,True,1,4873
31617,172319497,172336077,True,3,16580
31618,172321974,172322271,False,1,297
31619,172326583,172345783,True,1,19200
31620,172369498,172370179,True,1,681
31621,172391290,172395345,False,3,4055
31622,172391290,172395345,True,3,4055
31623,172397665,172406439,True,1,8774
31624,172398070,172428261,True,1,30191
31625,172430937,172432163,True,6,1226
31626,172440596,172445654,True,1,5058
31627,172476082,172479318,False,1,3236
31628,172476099,172480883,True,1,4784
31629,172476099,172481057,True,1,4958
31630,172476099,172481749,True,1,5650
31631,172481362,172482373,True,5,1011
31632,172508096,172508456,True,2,360
31633,172521693,172526604,True,1,4911
31634,172536326,172538488,True,1,2162
31635,172547417,172667549,True,2,120132
31636,172547417,172688804,True,1,141387
31637,172547417,172741382,True,1,193965
31638,172551731,172553665,True,2,1934
31639,172606800,172613804,True,1,7004
31640,172640139,172642198,True,1,2059
31641,172640142,172642198,True,4,2056
31642,172640191,172644305,False,1,4114
31643,172646603,172650646,True,1,4043
31644,172648757,172652226,True,2,3469
31645,172666778,172668775,False,1,1997
31646,172666778,172668775,True,1,1997
31647,172702227,172702994,False,1,767
31648,172702227,172702994,True,1,767
31649,172704322,172705033,True,1,711
31650,172708994,172711200,True,2,2206
31651,172731739,172732018,False,3,279
31652,172733214,172733856,False,1,642
31653,172737588,172739968,True,1,2380
31654,172743058,172744243,True,6,1185
31655,172746510,172748013,True,1,1503
31656,172747244,172750335,True,6,3091
31657,172752474,172753629,True,1,1155
31658,172767617,172779027,False,1,11410
31659,172773096,172775399,True,1,2303
31660,172773452,172775755,True,2,2303
31661,172773633,172773864,False,2,231
31662,172792995,172887956,True,3,94961
31663,172831975,172849233,False,1,17258
31664,172853211,172859782,True,2,6571
31665,172885352,172900865,True,5,15513
31666,172904014,172908764,True,3,4750
31667,173016068,173027260,True,4,11192
31668,173018935,173019620,False,1,685
31669,173022403,173023316,True,1,913
31670,173023183,173030161,True,2,6978
31671,173023183,173045907,False,1,22724
31672,173025697,173046181,True,1,20484
31673,173026589,173047052,True,1,20463
31674,173044608,173045138,False,1,530
31675,173069053,173178153,False,1,109100
31676,173089286,173090661,True,1,1375
31677,173107884,173112933,True,2,5049
31678,173128876,173191232,False,1,62356
31679,173128876,173191232,True,1,62356
31680,173129612,173129716,True,1,104
31681,173129612,173191493,True,1,61881
31682,173129612,173191903,True,2,62291
31683,173129868,173139082,True,7,9214
31684,173149129,173149626,True,1,497
31685,173167292,173168072,True,4,780
31686,173167352,173168072,True,4,720
31687,173191507,173210323,True,1,18816
31688,173191555,173198878,True,1,7323
31689,173191555,173210258,True,1,18703
31690,173229328,173230480,True,1,1152
31691,173320228,173322557,True,1,2329
31692,173333416,173335684,False,1,2268
31693,173336837,173337409,True,1,572
31694,173337194,173337722,True,1,528
31695,173338496,173347364,True,1,8868
31696,173356801,173360565,False,1,3764
31697,173370539,173372169,True,1,1630
31698,173376031,173377530,False,1,1499
31699,173380154,173384442,True,1,4288
31700,173380379,173380937,True,2,558
31701,173399968,173544649,True,1,144681
31702,173455222,173475597,True,1,20375
31703,173463624,173465152,True,5,1528
31704,173498113,173527619,True,4,29506
31705,173498173,173593844,True,1,95671
31706,173508898,173509658,False,1,760
31707,173518318,173524490,True,1,6172
31708,173546032,173641592,True,2,95560
31709,173551177,173561085,False,1,9908
31710,173561712,173561802,False,1,90
31711,173563547,173574485,False,1,10938
31712,173563547,173574485,True,4,10938
31713,173563980,173565411,True,1,1431
31714,173585130,173585765,True,1,635
31715,173585130,173586445,True,1,1315
31716,173611753,173611862,True,1,109
31717,173611980,173613342,True,1,1362
31718,173627067,173631046,True,2,3979
31719,173633667,173634316,True,2,649
31720,173644461,173644831,True,1,370
31721,173649043,173650576,True,2,1533
31722,173651551,173652732,True,1,1181
31723,173652327,173662807,True,1,10480
31724,173662615,173675426,False,1,12811
31725,173663056,173669795,True,3,6739
31726,173680369,173688205,False,1,7836
31727,173688675,173690990,True,1,2315
31728,173703620,173714642,True,1,11022
31729,173779884,173780788,True,1,904
31730,173784023,173784942,True,3,919
31731,173815134,173816579,True,1,1445
31732,173869210,173873492,True,2,4282
31733,173874798,173886623,True,7,11825
31734,173874803,173886623,True,3,11820
31735,173893332,173893349,False,1,17
31736,173895345,173915461,True,2,20116
31737,173907106,173908784,False,1,1678
31738,173909423,173925500,False,3,16077
31739,173950033,173950604,True,3,571
31740,173983339,174004860,True,1,21521
31741,174024821,174027378,True,4,2557
31742,174025719,174038371,True,3,12652
31743,174046231,174051420,False,1,5189
31744,174062978,174063809,True,3,831
31745,174081997,174082096,False,1,99
31746,174085300,174091901,True,1,6601
31747,174085300,174114502,True,2,29202
31748,174085300,174122577,True,1,37277
31749,174121686,174136882,True,1,15196
31750,174138130,174140731,True,1,2601
31751,174143786,174145510,True,1,1724
31752,174164162,174165560,True,1,1398
31753,174177992,174187375,False,1,9383
31754,174200093,174201239,False,1,1146
31755,174222475,174237074,True,1,14599
31756,174234679,174289195,False,1,54516
31757,174266943,174268389,True,2,1446
31758,174277186,174282308,False,1,5122
31759,174281978,174319351,True,1,37373
31760,174289538,174323154,True,1,33616
31761,174340906,174351657,True,3,10751
31762,174340906,174355440,True,1,14534
31763,174406688,174406960,True,1,272
31764,174453162,174454075,True,1,913
31765,174453162,174455984,True,1,2822
31766,174458938,174459501,False,1,563
31767,174458938,174459719,False,1,781
31768,174477829,174481010,True,1,3181
31769,174491545,174492217,False,1,672
31770,174515827,174516734,True,2,907
31771,174515989,174537864,True,4,21875
31772,174516820,174516989,True,1,169
31773,174553118,174566259,True,1,13141
31774,174553118,174571274,True,1,18156
31775,174567165,174567680,True,4,515
31776,174569397,174569884,True,3,487
31777,174574087,174604073,True,1,29986
31778,174576953,174618145,True,1,41192
31779,174618036,174619203,True,2,1167
31780,174657415,174661861,True,1,4446
31781,174657415,174674470,True,1,17055
31782,174673084,174675726,True,3,2642
31783,174675142,174676733,False,1,1591
31784,174691930,174693432,False,1,1502
31785,174710152,174736159,True,1,26007
31786,174721769,174732473,False,1,10704
31787,174721769,174732473,True,2,10704
31788,174728057,174730431,True,3,2374
31789,174733893,174849049,True,1,115156
31790,174744514,174751939,False,1,7425
31791,174761177,174918949,True,2,157772
31792,174786047,174786686,True,1,639
31793,174807774,174809148,False,1,1374
31794,174814439,174815397,True,1,958
31795,174851873,174858219,False,1,6346
31796,174851873,174858219,True,2,6346
31797,174880482,174881144,False,1,662
31798,174883792,174884971,True,1,1179
31799,174891603,174891680,True,1,77
31800,174917499,174997304,True,1,79805
31801,174929489,174929856,True,1,367
31802,174971164,174971624,True,3,460
31803,174983327,174984506,False,1,1179
31804,174983327,174984506,True,3,1179
31805,174997670,175000407,True,1,2737
31806,175011636,175012909,True,4,1273
31807,175031409,175071870,True,4,40461
31808,175053424,175054343,True,1,919
31809,175055642,175065217,False,1,9575
31810,175119531,175120060,True,1,529
31811,175127430,175127904,True,6,474
31812,175127430,175127907,True,1,477
31813,175128571,175171719,True,1,43148
31814,175129542,175131039,False,2,1497
31815,175129776,175131181,False,2,1405
31816,175174520,175177077,True,2,2557
31817,175191124,175194742,False,2,3618
31818,175195543,175196903,False,1,1360
31819,175195550,175195901,False,1,351
31820,175195550,175195953,False,1,403
31821,175195550,175196903,False,1,1353
31822,175270976,175313302,False,1,42326
31823,175273626,175274185,True,1,559
31824,175273626,175274336,True,1,710
31825,175273626,175314354,True,1,40728
31826,175294564,175371889,True,1,77325
31827,175380802,175380918,True,1,116
31828,175463821,175464557,False,1,736
31829,175473766,175478682,False,1,4916
31830,175483095,175483371,True,2,276
31831,175483098,175483371,True,2,273
31832,175486143,175487709,True,1,1566
31833,175489675,175491191,True,1,1516
31834,175510137,175527230,False,1,17093
31835,175510137,175532612,False,1,22475
31836,175510137,175575697,False,1,65560
31837,175589077,175591844,True,1,2767
31838,175590766,175591181,True,2,415
31839,175594847,175595044,True,1,197
31840,175594953,175606266,True,1,11313
31841,175638759,175639734,False,1,975
31842,175670250,175672251,True,3,2001
31843,175673537,175674447,False,1,910
31844,175675397,175676169,True,2,772
31845,175676941,175677470,True,1,529
31846,175693523,175700590,False,1,7067
31847,175693722,175729255,True,1,35533
31848,175712545,175725801,True,4,13256
31849,175715194,175727209,False,1,12015
31850,175725137,175727457,False,1,2320
31851,175730259,175731646,True,1,1387
31852,175730745,175790887,True,1,60142
31853,175730757,175790899,True,1,60142
31854,175757486,175778443,True,1,20957
31855,175814686,175815971,True,3,1285
31856,175843502,175847027,True,1,3525
31857,175856728,175895468,True,2,38740
31858,175856728,175933422,True,1,76694
31859,175923671,175927114,False,3,3443
31860,175968770,175998877,True,1,30107
31861,175970158,175993689,True,5,23531
31862,175987075,176002128,True,1,15053
31863,175987353,176025278,True,1,37925
31864,176004557,176006542,True,1,1985
31865,176004595,176006542,True,1,1947
31866,176007399,176012275,True,1,4876
31867,176032703,176038365,True,1,5662
31868,176032799,176038365,True,6,5566
31869,176054435,176056058,True,2,1623
31870,176063566,176071581,True,1,8015
31871,176064655,176072713,True,1,8058
31872,176064655,176079030,False,1,14375
31873,176064655,176079030,True,1,14375
31874,176095326,176099369,True,1,4043
31875,176109535,176113098,True,1,3563
31876,176112423,176127164,True,3,14741
31877,176113547,176115258,True,1,1711
31878,176113591,176115258,True,1,1667
31879,176167007,176167241,True,5,234
31880,176183450,176194160,True,1,10710
31881,176193626,176195590,False,1,1964
31882,176206248,176207438,True,1,1190
31883,176206248,176208266,True,2,2018
31884,176235496,176237240,False,1,1744
31885,176235496,176237240,True,2,1744
31886,176235496,176237244,True,1,1748
31887,176240437,176241098,False,1,661
31888,176246494,176255944,True,1,9450
31889,176292971,176317181,False,1,24210
31890,176315330,176318621,False,1,3291
31891,176323654,176351681,True,4,28027
31892,176323654,176395349,True,1,71695
31893,176360771,176367418,True,1,6647
31894,176365379,176369720,False,3,4341
31895,176365379,176369720,True,3,4341
31896,176370448,176386175,False,1,15727
31897,176378459,176379054,True,1,595
31898,176392377,176392687,True,4,310
31899,176398227,176401270,True,1,3043
31900,176448312,176448768,False,1,456
31901,176448312,176448768,True,2,456
31902,176451400,176456333,True,2,4933
31903,176479850,176482660,False,1,2810
31904,176480415,176496218,True,1,15803
31905,176480415,176537962,True,1,57547
31906,176516208,176519330,True,1,3122
31907,176555175,176555665,True,2,490
31908,176555175,176558447,True,1,3272
31909,176599694,176603853,False,1,4159
31910,176599694,176603853,True,6,4159
31911,176608740,176663861,False,1,55121
31912,176649949,176652503,True,1,2554
31913,176651328,176653959,True,1,2631
31914,176654827,176660374,True,2,5547
31915,176687575,176699879,True,1,12304
31916,176687891,176699858,True,2,11967
31917,176734818,176751131,True,2,16313
31918,176747948,176750693,True,1,2745
31919,176751022,176752198,False,1,1176
31920,176757003,176757260,True,1,257
31921,176769902,176770153,True,1,251
31922,176778150,177236219,True,1,458069
31923,176781191,176786642,True,1,5451
31924,176789442,176795067,True,4,5625
31925,176800409,176806313,True,1,5904
31926,176800579,176805604,True,3,5025
31927,176828997,176830223,True,3,1226
31928,176840338,176843486,True,4,3148
31929,176840607,176841268,True,1,661
31930,176841964,176851708,False,1,9744
31931,176845130,176846518,True,1,1388
31932,176847779,176848371,True,1,592
31933,176853155,176854974,True,1,1819
31934,176856532,176856629,True,1,97
31935,176856861,176867442,True,1,10581
31936,176856966,176867547,False,1,10581
31937,176856966,176867547,True,5,10581
31938,176858782,176863190,True,1,4408
31939,176858782,176865867,False,2,7085
31940,176859514,176861506,True,1,1992
31941,176885980,176886918,True,2,938
31942,176898023,176899656,False,1,1633
31943,176919294,176931923,True,1,12629
31944,176920061,176923358,False,1,3297
31945,176939788,176942469,True,1,2681
31946,176939788,176943969,True,1,4181
31947,176939788,176944579,True,1,4791
31948,176943033,176948198,True,1,5165
31949,176943870,176945134,True,1,1264
31950,176944897,176948473,True,1,3576
31951,176945549,176946813,True,2,1264
31952,176957087,176964375,True,1,7288
31953,176975126,176978037,True,1,2911
31954,176981906,176982642,False,1,736
31955,176989262,176989404,False,1,142
31956,176990935,176991018,True,1,83
31957,177010106,177010447,False,1,341
31958,177033071,177115015,True,1,81944
31959,177040099,177072358,True,1,32259
31960,177043289,177045050,True,1,1761
31961,177043289,177096681,False,1,53392
31962,177059452,177061711,True,1,2259
31963,177072336,177078135,False,1,5799
31964,177072336,177078135,True,1,5799
31965,177112244,177113124,True,1,880
31966,177112319,177113203,True,1,884
31967,177113232,177113511,True,1,279
31968,177142989,177149075,True,2,6086
31969,177240654,177253149,True,1,12495
31970,177273762,177280304,True,4,6542
31971,177283865,177289252,True,2,5387
31972,177287651,177296523,True,1,8872
31973,177298950,177300760,True,3,1810
31974,177311436,177317036,False,1,5600
31975,177355619,177366278,False,1,10659
31976,177387659,177387795,True,1,136
31977,177392179,177397369,True,2,5190
31978,177405958,177406090,True,1,132
31979,177410055,177410387,True,1,332
31980,177419675,177422218,True,1,2543
31981,177424099,177424655,True,1,556
31982,177425957,177426218,True,1,261
31983,177435912,177460071,True,1,24159
31984,177436862,177437675,True,1,813
31985,177437360,177438053,True,2,693
31986,177441486,177444199,True,1,2713
31987,177456549,177458142,True,1,1593
31988,177457277,177457401,True,1,124
31989,177459588,177467463,False,3,7875
31990,177461169,177473392,True,1,12223
31991,177485185,177498415,True,1,13230
31992,177489126,177491589,True,1,2463
31993,177496073,177499138,True,1,3065
31994,177504229,177505120,True,1,891
31995,177506427,177507697,False,1,1270
31996,177508286,177509973,True,4,1687
31997,177511774,177515636,True,1,3862
31998,177515337,177521168,True,1,5831
31999,177526943,177527810,True,3,867
32000,177545896,177546432,True,4,536
32001,177560199,177562114,True,1,1915
32002,177564007,177564084,True,4,77
32003,177564007,177564122,True,1,115
32004,177592669,177605970,False,1,13301
32005,177595443,177601814,False,1,6371
32006,177619980,177620723,False,1,743
32007,177621585,177623055,True,3,1470
32008,177648468,177649319,True,1,851
32009,177671827,177677947,True,3,6120
32010,177684558,177685015,True,1,457
32011,177703922,177709464,True,2,5542
32012,177704416,177704514,True,1,98
32013,177704640,177706965,True,2,2325
32014,177704640,177722258,True,1,17618
32015,177704640,177725048,True,1,20408
32016,177704640,177725104,True,1,20464
32017,177709957,177711641,True,1,1684
32018,177713712,177714691,True,1,979
32019,177740652,177741136,True,1,484
32020,177751990,177752352,True,1,362
32021,177752124,177752352,True,1,228
32022,177754168,177755699,True,1,1531
32023,177760568,177766382,True,1,5814
32024,177761074,177764554,True,3,3480
32025,177765457,177774843,True,1,9386
32026,177777527,177785503,True,3,7976
32027,177791498,177793205,True,1,1707
32028,177793753,177794833,True,5,1080
32029,177801718,177827020,False,1,25302
32030,177806306,177816327,False,1,10021
32031,177806306,177818836,False,2,12530
32032,177806306,177818836,True,4,12530
32033,177822979,177835407,True,1,12428
32034,177835716,177848037,True,1,12321
32035,177843465,177844148,True,1,683
32036,177845281,177847652,False,1,2371
32037,177847096,177848530,True,3,1434
32038,177855596,177858262,False,1,2666
32039,177856141,177858678,True,1,2537
32040,177858278,177869406,True,1,11128
32041,177859950,177860390,True,3,440
32042,177866730,177867379,True,2,649
32043,177884945,177886938,True,3,1993
32044,177895075,177895216,True,1,141
32045,177903130,177903820,True,1,690
32046,177904694,177905977,True,1,1283
32047,177909754,177910649,True,1,895
32048,177918745,177921998,True,1,3253
32049,177928993,177937525,True,1,8532
32050,177931572,177941055,False,1,9483
32051,177931990,178013787,False,1,81797
32052,177933505,177934544,True,1,1039
32053,177946452,177950378,True,2,3926
32054,177971173,177973222,True,1,2049
32055,177982676,177989175,True,1,6499
32056,177997052,178004293,False,1,7241
32057,178005802,178010640,True,1,4838
32058,178009500,178009758,False,1,258
32059,178010814,178011523,True,1,709
32060,178011077,178027320,False,1,16243
32061,178021696,178021820,False,1,124
32062,178021696,178021820,True,2,124
32063,178021696,178021823,True,1,127
32064,178024948,178027142,True,3,2194
32065,178058765,178059245,True,5,480
32066,178059489,178059683,True,1,194
32067,178078272,178079956,True,1,1684
32068,178084467,178086510,True,1,2043
32069,178094906,178114366,False,1,19460
32070,178103482,178108354,True,1,4872
32071,178106023,178106680,True,3,657
32072,178109602,178110365,False,1,763
32073,178111952,178115592,False,1,3640
32074,178111952,178115592,True,2,3640
32075,178117565,178126532,False,1,8967
32076,178117565,178126532,True,10,8967
32077,178122184,178123805,True,1,1621
32078,178122184,178134314,True,1,12130
32079,178131131,178137906,True,1,6775
32080,178163371,178163657,True,5,286
32081,178169360,178170880,False,1,1520
32082,178176348,178177046,True,1,698
32083,178205572,178206870,False,1,1298
32084,178226807,178231446,True,1,4639
32085,178230128,178230639,False,1,511
32086,178235664,178237712,True,2,2048
32087,178259094,178275427,False,1,16333
32088,178271203,178290561,False,1,19358
32089,178300232,178356590,True,3,56358
32090,178300232,178375824,True,1,75592
32091,178313476,178314105,False,1,629
32092,178313659,178333030,True,3,19371
32093,178313904,178318104,False,1,4200
32094,178314069,178314073,False,1,4
32095,178320616,178325213,False,1,4597
32096,178320616,178325213,True,1,4597
32097,178320616,178329226,True,1,8610
32098,178320620,178325213,True,1,4593
32099,178320620,178327284,True,1,6664
32100,178329139,178333901,True,2,4762
32101,178339356,178341831,True,1,2475
32102,178353906,178354001,True,1,95
32103,178357834,178372367,False,1,14533
32104,178362638,178364911,True,1,2273
32105,178364345,178364610,True,1,265
32106,178364685,178364848,False,1,163
32107,178370203,178370421,False,1,218
32108,178379950,178382042,True,1,2092
32109,178386781,178387238,False,1,457
32110,178394691,178395590,True,1,899
32111,178406192,178410428,False,1,4236
32112,178412306,178439039,False,1,26733
32113,178444181,178445644,False,1,1463
32114,178451425,178451741,False,1,316
32115,178465697,178466333,True,1,636
32116,178476443,178483984,True,2,7541
32117,178493565,178497041,True,1,3476
32118,178524881,178525872,True,1,991
32119,178529531,178532313,False,1,2782
32120,178529531,178532313,True,2,2782
32121,178535584,178535680,True,1,96
32122,178568428,178571513,True,3,3085
32123,178574964,178576967,True,1,2003
32124,178581054,178581412,False,1,358
32125,178582082,178590952,True,1,8870
32126,178582082,178596711,True,5,14629
32127,178582082,178627318,True,1,45236
32128,178600162,178604261,False,2,4099
32129,178600162,178604261,True,3,4099
32130,178637349,178641207,True,1,3858
32131,178642589,178643977,True,3,1388
32132,178651791,178678764,False,1,26973
32133,178669099,178671251,True,3,2152
32134,178669576,178670856,False,1,1280
32135,178693713,178726102,False,1,32389
32136,178693713,178726102,True,3,32389
32137,178697536,178697924,True,1,388
32138,178706586,178707999,True,1,1413
32139,178708147,178710100,True,1,1953
32140,178732652,178736894,True,2,4242
32141,178744768,178750050,False,1,5282
32142,178756952,178758763,True,1,1811
32143,178771478,178777498,False,1,6020
32144,178775175,178777045,True,1,1870
32145,178775850,178867203,True,1,91353
32146,178778093,178778501,True,1,408
32147,178785356,178787780,True,1,2424
32148,178803383,178810141,True,3,6758
32149,178811996,178813369,False,1,1373
32150,178839240,178888426,True,2,49186
32151,178841521,178889662,False,1,48141
32152,178842005,178842714,False,1,709
32153,178842005,178842714,True,2,709
32154,178884676,178884798,True,4,122
32155,178884676,178886693,True,1,2017
32156,178885308,178886775,True,1,1467
32157,178887343,178888042,True,2,699
32158,178894887,178899071,True,1,4184
32159,178894887,178903404,True,1,8517
32160,178899302,178899717,True,1,415
32161,178945894,178946987,False,1,1093
32162,178945894,178946987,True,3,1093
32163,178949349,178949599,True,1,250
32164,178995127,179008020,False,1,12893
32165,179027298,179030279,True,3,2981
32166,179027438,179029418,False,1,1980
32167,179027438,179029418,True,3,1980
32168,179037137,179038349,True,1,1212
32169,179062619,179063704,True,1,1085
32170,179107152,179107589,False,1,437
32171,179127520,179129392,False,1,1872
32172,179144577,179145546,False,1,969
32173,179147283,179148667,True,1,1384
32174,179149812,179151700,True,2,1888
32175,179150519,179153094,True,1,2575
32176,179156162,179156726,True,1,564
32177,179159060,179167944,True,1,8884
32178,179195519,179196372,True,1,853
32179,179207887,179208986,True,1,1099
32180,179215495,179218757,True,1,3262
32181,179233270,179235638,True,1,2368
32182,179247499,179276974,False,1,29475
32183,179247499,179276974,True,1,29475
32184,179248490,179280149,True,1,31659
32185,179251828,179269558,True,3,17730
32186,179254184,179254410,True,3,226
32187,179254589,179254751,True,1,162
32188,179254818,179254980,True,1,162
32189,179262355,179263943,False,1,1588
32190,179263174,179264892,True,1,1718
32191,179263174,179288334,True,1,25160
32192,179263174,179288341,False,1,25167
32193,179284654,179286120,True,2,1466
32194,179287331,179291849,False,1,4518
32195,179289832,179290948,True,1,1116
32196,179296914,179299580,True,8,2666
32197,179297982,179298844,True,1,862
32198,179305056,179305628,True,1,572
32199,179314572,179317155,True,1,2583
32200,179340286,179341022,True,1,736
32201,179359527,179376426,True,1,16899
32202,179374183,179383710,True,1,9527
32203,179378343,179391447,True,1,13104
32204,179379452,179384701,True,1,5249
32205,179393618,179399010,True,1,5392
32206,179403750,179404287,True,1,537
32207,179423333,179423771,False,1,438
32208,179423333,179423771,True,3,438
32209,179448394,179448805,True,1,411
32210,179448485,179448865,True,1,380
32211,179448567,179448865,True,3,298
32212,179448828,179459903,False,1,11075
32213,179448828,179459905,False,1,11077
32214,179449283,179460146,True,1,10863
32215,179451133,179452534,True,2,1401
32216,179454092,179455178,True,1,1086
32217,179456833,179457782,True,1,949
32218,179485174,179486199,True,1,1025
32219,179485174,179487251,True,1,2077
32220,179497892,179500092,False,1,2200
32221,179498219,179500676,False,1,2457
32222,179502461,179503567,False,1,1106
32223,179506242,179508733,True,4,2491
32224,179506280,179508733,True,3,2453
32225,179506280,179510034,True,3,3754
32226,179506771,179507025,True,1,254
32227,179511388,179523673,True,1,12285
32228,179522733,179522954,False,1,221
32229,179526036,179527365,True,1,1329
32230,179527371,179535044,True,1,7673
32231,179527477,179530100,True,1,2623
32232,179528685,179529836,True,1,1151
32233,179541517,179552020,True,1,10503
32234,179541517,179552030,True,1,10513
32235,179547902,179548373,True,2,471
32236,179556893,179557358,False,1,465
32237,179565980,179566685,True,1,705
32238,179567545,179572758,True,2,5213
32239,179573797,179575744,True,1,1947
32240,179574457,179578051,False,1,3594
32241,179574457,179578051,True,2,3594
32242,179574545,179575671,True,1,1126
32243,179575076,179576329,False,1,1253
32244,179575076,179576329,True,3,1253
32245,179576204,179576888,False,1,684
32246,179576204,179576888,True,1,684
32247,179578867,179578942,True,1,75
32248,179579661,179583229,True,1,3568
32249,179581529,179584083,True,1,2554
32250,179581581,179583898,True,1,2317
32251,179584008,179585024,True,1,1016
32252,179588633,179589330,True,1,697
32253,179594130,179651265,True,1,57135
32254,179609074,179609246,True,2,172
32255,179612655,179613358,True,1,703
32256,179613340,179613781,True,1,441
32257,179614343,179620513,True,1,6170
32258,179626270,179632294,True,1,6024
32259,179626745,179632294,True,1,5549
32260,179628531,179632433,False,3,3902
32261,179628531,179632433,True,3,3902
32262,179629362,179634970,True,1,5608
32263,179643915,179646309,True,1,2394
32264,179659121,179663521,True,1,4400
32265,179659121,179673095,True,1,13974
32266,179670949,179673806,True,1,2857
32267,179682358,179686802,True,1,4444
32268,179682358,179695361,True,2,13003
32269,179682421,179682761,True,2,340
32270,179686307,179688936,True,1,2629
32271,179709350,179765266,False,1,55916
32272,179709350,179765266,True,1,55916
32273,179712096,179714750,True,1,2654
32274,179719593,179720140,True,2,547
32275,179730253,179730338,True,2,85
32276,179730253,179730344,True,1,91
32277,179735825,179736542,True,5,717
32278,179746554,179749094,False,1,2540
32279,179749345,179759222,False,1,9877
32280,179749345,179759222,True,4,9877
32281,179757111,179831188,True,1,74077
32282,179767837,179769199,False,1,1362
32283,179776004,179777231,True,4,1227
32284,179781177,179781547,False,1,370
32285,179784343,179926744,True,1,142401
32286,179790108,179797527,True,1,7419
32287,179790108,179806634,True,2,16526
32288,179818197,179821194,True,1,2997
32289,179822795,179832600,False,1,9805
32290,179830639,179832084,True,1,1445
32291,179831406,179832084,True,1,678
32292,179833341,179836965,True,1,3624
32293,179833779,179837403,True,1,3624
32294,179842668,179843549,False,1,881
32295,179869315,179869575,True,2,260
32296,179880260,179889750,True,2,9490
32297,179902053,179903243,True,1,1190
32298,179934539,179940968,True,2,6429
32299,179936901,179936980,False,1,79
32300,179939527,179941246,True,1,1719
32301,179939527,179951817,False,2,12290
32302,179939527,179951817,True,1,12290
32303,179952066,179958106,True,3,6040
32304,179957964,179958549,False,1,585
32305,179966897,179974190,True,1,7293
32306,179966897,179974192,False,1,7295
32307,179966897,179974717,True,2,7820
32308,179971874,179972254,True,1,380
32309,179977069,179987393,True,1,10324
32310,179979552,179987893,True,1,8341
32311,179979552,179988663,True,1,9111
32312,179980224,179982458,True,1,2234
32313,179980977,179982915,True,1,1938
32314,179980977,180005868,True,1,24891
32315,179995929,179996716,True,1,787
32316,180001302,180001454,True,1,152
32317,180026135,180027238,True,2,1103
32318,180029723,180030577,True,1,854
32319,180029723,180030588,False,1,865
32320,180030360,180030961,True,6,601
32321,180030360,180030964,True,1,604
32322,180030360,180035787,True,1,5427
32323,180031748,180036476,True,1,4728
32324,180042163,180043509,True,1,1346
32325,180048864,180058073,True,1,9209
32326,180060965,180061119,True,1,154
32327,180065510,180067478,True,3,1968
32328,180068409,180107841,True,1,39432
32329,180076019,180079146,True,1,3127
32330,180078160,180082998,False,1,4838
32331,180078160,180083032,False,4,4872
32332,180078160,180083071,False,1,4911
32333,180088295,180089301,True,1,1006
32334,180088295,180090733,True,1,2438
32335,180089121,180113000,True,1,23879
32336,180089121,180118079,True,1,28958
32337,180093393,180094828,False,1,1435
32338,180096998,180101462,False,1,4464
32339,180097169,180101462,False,1,4293
32340,180097249,180101462,False,2,4213
32341,180098167,180101462,False,1,3295
32342,180110548,180112461,False,1,1913
32343,180114150,180115866,False,1,1716
32344,180131445,180131522,False,1,77
32345,180144178,180146468,False,1,2290
32346,180144178,180146468,True,2,2290
32347,180152260,180156488,True,2,4228
32348,180154292,180155836,True,1,1544
32349,180172244,180180110,True,2,7866
32350,180178139,180183049,True,6,4910
32351,180178139,180186712,True,1,8573
32352,180181171,180187980,False,1,6809
32353,180191564,180204277,True,1,12713
32354,180197524,180250670,True,1,53146
32355,180212993,180216222,True,1,3229
32356,180219706,180220217,True,1,511
32357,180225344,180226540,True,1,1196
32358,180225777,180226638,True,2,861
32359,180227938,180333751,True,2,105813
32360,180238288,180244732,True,2,6444
32361,180247915,180249720,True,1,1805
32362,180247915,180250831,True,2,2916
32363,180253779,180254606,True,1,827
32364,180255786,180256186,False,1,400
32365,180285990,180419447,True,3,133457
32366,180319822,180320309,True,1,487
32367,180320917,180321178,True,1,261
32368,180336812,180394192,True,1,57380
32369,180337551,180341266,False,1,3715
32370,180343217,180343405,True,2,188
32371,180383490,180383688,True,1,198
32372,180386225,180426578,False,1,40353
32373,180386225,180426578,True,2,40353
32374,180390218,180456308,True,1,66090
32375,180402512,180404500,False,1,1988
32376,180416772,180417764,True,2,992
32377,180449843,180504806,False,1,54963
32378,180449858,180450701,True,1,843
32379,180451751,180459249,True,1,7498
32380,180451847,180454421,True,1,2574
32381,180451940,180454421,True,1,2481
32382,180451940,180458567,True,1,6627
32383,180468115,180478963,True,3,10848
32384,180488417,180504651,False,1,16234
32385,180525533,180526573,True,1,1040
32386,180527136,180661351,True,2,134215
32387,180528981,180529624,True,1,643
32388,180544653,180548587,True,1,3934
32389,180547500,180732111,False,1,184611
32390,180553367,180582185,True,1,28818
32391,180555893,180569105,False,1,13212
32392,180573422,180595767,True,1,22345
32393,180575223,180596674,True,1,21451
32394,180586555,180586835,True,1,280
32395,180593735,180595594,False,1,1859
32396,180606853,180701247,False,1,94394
32397,180607690,180611850,True,1,4160
32398,180624149,180642759,False,1,18610
32399,180640100,180640882,True,1,782
32400,180643321,180643796,True,1,475
32401,180656857,180661814,True,1,4957
32402,180659238,180660753,False,1,1515
32403,180662677,180664059,True,1,1382
32404,180677635,180694590,True,1,16955
32405,180678446,180695054,True,2,16608
32406,180682137,180683480,True,1,1343
32407,180682141,180683480,True,2,1339
32408,180682196,180683480,True,1,1284
32409,180682286,180683480,True,1,1194
32410,180689014,180689384,False,1,370
32411,180689014,180689401,False,2,387
32412,180689014,180689401,True,1,387
32413,180693120,180693539,True,1,419
32414,180707142,180707962,True,1,820
32415,180752705,180754675,False,2,1970
32416,180752705,180754675,True,2,1970
32417,180775742,180775841,True,1,99
32418,180780690,180787552,True,2,6862
32419,180843303,180844202,False,1,899
32420,180844559,180845165,True,3,606
32421,180844559,180851695,True,1,7136
32422,180846052,180852358,False,1,6306
32423,180848393,180849379,True,2,986
32424,180848393,180851187,True,3,2794
32425,180888866,180890277,False,1,1411
32426,180888866,180890277,True,1,1411
32427,180903029,180906722,True,1,3693
32428,180918289,180918599,False,1,310
32429,180919520,180920434,False,1,914
32430,180921509,180924344,True,4,2835
32431,180921969,180923897,True,1,1928
32432,180968705,180970850,True,1,2145
32433,180981860,180985278,True,1,3418
32434,180995641,180997800,True,1,2159
32435,180995886,180996676,True,1,790
32436,181042432,181043105,True,1,673
32437,181056990,181178560,True,1,121570
32438,181059032,181061862,True,1,2830
32439,181065970,181067044,True,1,1074
32440,181079271,181095897,True,1,16626
32441,181079404,181095897,True,2,16493
32442,181079443,181095897,True,1,16454
32443,181089597,181155091,True,1,65494
32444,181125286,181128061,True,1,2775
32445,181125286,181130539,True,1,5253
32446,181162433,181162693,True,1,260
32447,181163904,181165465,True,1,1561
32448,181163932,181165465,True,5,1533
32449,181215883,181216290,False,1,407
32450,181254796,181255257,True,3,461
32451,181278855,181284107,True,2,5252
32452,181280338,181301354,True,2,21016
32453,181293060,181295592,True,7,2532
32454,181293060,181388644,False,6,95584
32455,181293060,181388644,True,2,95584
32456,181299394,181306700,False,1,7306
32457,181321455,181378193,True,1,56738
32458,181322326,181326029,True,1,3703
32459,181331813,181334039,True,1,2226
32460,181345327,181346401,True,1,1074
32461,181352904,181390687,False,1,37783
32462,181379489,181380028,True,1,539
32463,181385156,181385836,False,1,680
32464,181389953,181392646,True,3,2693
32465,181406034,181409383,True,1,3349
32466,181425366,181431480,False,1,6114
32467,181445837,181448395,True,2,2558
32468,181451051,181451951,True,1,900
32469,181456464,181472839,True,1,16375
32470,181462656,181478776,False,1,16120
32471,181486935,181492688,True,1,5753
32472,181489202,181489801,True,3,599
32473,181489528,181502728,True,1,13200
32474,181489528,181505230,True,1,15702
32475,181491844,181492098,True,1,254
32476,181500950,181513071,False,4,12121
32477,181500950,181513071,True,5,12121
32478,181502427,181513828,False,1,11401
32479,181515436,181516961,False,1,1525
32480,181525562,181526651,True,1,1089
32481,181540435,181545029,True,1,4594
32482,181540435,181547541,True,1,7106
32483,181547213,181547640,True,4,427
32484,181555010,181555238,True,1,228
32485,181585803,181586613,False,1,810
32486,181585803,181586613,True,1,810
32487,181618002,181618412,True,1,410
32488,181618524,181623312,True,1,4788
32489,181632334,181632435,True,1,101
32490,181632796,181646476,True,1,13680
32491,181646462,181653621,True,1,7159
32492,181726903,181728659,True,1,1756
32493,181726903,181729733,True,1,2830
32494,181729440,181731015,True,1,1575
32495,181779549,181780580,False,1,1031
32496,181791119,181793348,True,1,2229
32497,181828448,181835888,True,1,7440
32498,181829826,181836554,True,1,6728
32499,181843295,181844357,False,1,1062
32500,181863100,181865476,True,1,2376
32501,181893403,181894815,True,3,1412
32502,181948143,181949018,True,5,875
32503,181951460,181959133,False,1,7673
32504,182006020,182044134,True,1,38114
32505,182006749,182033816,True,1,27067
32506,182006749,182044591,True,1,37842
32507,182008319,182037685,True,1,29366
32508,182014864,182051379,False,1,36515
32509,182014864,182051379,True,2,36515
32510,182027368,182031253,True,1,3885
32511,182027368,182042929,True,1,15561
32512,182027368,182044714,False,1,17346
32513,182061514,182065263,True,1,3749
32514,182068942,182099729,True,1,30787
32515,182075680,182090747,False,1,15067
32516,182097665,182278076,False,1,180411
32517,182097665,182278076,True,2,180411
32518,182123590,182127422,True,1,3832
32519,182143351,182143692,True,2,341
32520,182146552,182156386,True,3,9834
32521,182175436,182186017,True,1,10581
32522,182180701,182221436,True,3,40735
32523,182181275,182184852,False,1,3577
32524,182181502,182222237,True,4,40735
32525,182184622,182190654,True,1,6032
32526,182218057,182220069,False,1,2012
32527,182275709,182280886,True,1,5177
32528,182291212,182296003,False,1,4791
32529,182300666,182309307,True,1,8641
32530,182300666,182336015,True,1,35349
32531,182304776,182305164,True,2,388
32532,182304776,182311947,True,1,7171
32533,182304776,182311952,True,1,7176
32534,182304776,182314338,True,1,9562
32535,182312675,182385574,True,1,72899
32536,182327684,182327771,False,1,87
32537,182348884,182351284,True,2,2400
32538,182355759,182357664,True,1,1905
32539,182383133,182385865,True,2,2732
32540,182407519,182408086,False,1,567
32541,182449691,182451455,True,3,1764
32542,182449691,182452266,True,2,2575
32543,182467689,182492121,False,1,24432
32544,182521249,182527841,True,1,6592
32545,182521249,182551195,True,3,29946
32546,182524410,182528709,True,1,4299
32547,182592856,182596484,False,1,3628
32548,182592856,182612141,True,1,19285
32549,182623626,182644245,True,1,20619
32550,182675832,182677140,True,2,1308
32551,182683475,182687660,True,4,4185
32552,182709121,182709720,False,1,599
32553,182715558,182721274,True,1,5716
32554,182721245,182725989,True,1,4744
32555,182734034,182736104,False,1,2070
32556,182763403,182764463,True,3,1060
32557,182810694,182851693,True,1,40999
32558,182823825,182830694,True,1,6869
32559,182855438,182855929,True,3,491
32560,182856754,182856906,True,1,152
32561,182856754,182858455,True,2,1701
32562,182863372,182888186,False,1,24814
32563,182889565,182893441,True,1,3876
32564,182893227,182893983,True,1,756
32565,182894644,182895554,True,1,910
32566,182894988,182895898,True,1,910
32567,182900112,182900506,True,1,394
32568,182901263,182903093,True,1,1830
32569,182905615,182908581,False,1,2966
32570,182910781,182911377,False,1,596
32571,182922803,182926415,True,2,3612
32572,182946894,182950614,True,1,3720
32573,182948940,182949086,True,1,146
32574,182956733,182956945,True,1,212
32575,182956819,182956986,False,1,167
32576,182956819,182956986,True,2,167
32577,182967180,182968095,True,1,915
32578,182986541,182986772,True,1,231
32579,182990798,182995773,False,1,4975
32580,182995327,182999124,True,1,3797
32581,182995517,182995856,False,1,339
32582,182996283,182997133,True,1,850
32583,182996283,182997945,True,1,1662
32584,182999971,183000673,False,1,702
32585,183006098,183008210,True,1,2112
32586,183006098,183011387,True,1,5289
32587,183006098,183011989,True,1,5891
32588,183019506,183034781,False,1,15275
32589,183019699,183021574,True,1,1875
32590,183019699,183021942,True,1,2243
32591,183019699,183022019,True,1,2320
32592,183049071,183049148,True,1,77
32593,183079063,183084463,True,4,5400
32594,183079063,183097414,True,1,18351
32595,183079063,183111151,True,1,32088
32596,183084057,183084678,True,3,621
32597,183087902,183088846,False,1,944
32598,183131821,183132392,False,1,571
32599,183140649,183169973,True,1,29324
32600,183140649,183173211,True,3,32562
32601,183141445,183215733,False,1,74288
32602,183160983,183191919,False,1,30936
32603,183160983,183191919,True,2,30936
32604,183160983,183204337,True,1,43354
32605,183160983,183206964,True,1,45981
32606,183161228,183191919,True,3,30691
32607,183161228,183204337,True,2,43109
32608,183162316,183192541,True,1,30225
32609,183162316,183204959,True,1,42643
32610,183178751,183178974,False,1,223
32611,183178751,183184205,False,1,5454
32612,183211876,183212160,True,1,284
32613,183211933,183212160,True,1,227
32614,183212933,183222290,True,1,9357
32615,183249175,183273591,True,1,24416
32616,183262710,183271902,True,1,9192
32617,183272312,183278000,True,2,5688
32618,183272312,183291559,True,1,19247
32619,183286774,183315132,False,1,28358
32620,183286774,183315132,True,1,28358
32621,183286774,183412282,True,1,125508
32622,183286774,183438228,True,1,151454
32623,183317529,183319372,False,1,1843
32624,183351773,183390875,False,1,39102
32625,183398839,183399560,True,1,721
32626,183400398,183409514,True,1,9116
32627,183400398,183418932,True,1,18534
32628,183425452,183426435,True,1,983
32629,183443932,183445637,True,1,1705
32630,183453238,183454118,False,1,880
32631,183453238,183454118,True,2,880
32632,183455692,183455779,True,1,87
32633,183466713,183472568,True,1,5855
32634,183477663,183481930,True,3,4267
32635,183484619,183487818,True,3,3199
32636,183528301,183531984,False,1,3683
32637,183543099,183550802,False,1,7703
32638,183543099,183550802,True,1,7703
32639,183548585,183549592,True,1,1007
32640,183559978,183563341,False,1,3363
32641,183608133,183617837,True,1,9704
32642,183611259,183611679,True,1,420
32643,183611367,183648579,False,1,37212
32644,183649767,183667652,False,1,17885
32645,183658400,183658901,True,7,501
32646,183686739,183686957,True,1,218
32647,183691213,183719985,True,2,28772
32648,183751380,183799748,True,1,48368
32649,183849168,183851678,True,4,2510
32650,183852378,183856195,True,1,3817
32651,183856975,183857469,False,1,494
32652,183866938,183867976,True,6,1038
32653,183867747,183868330,True,1,583
32654,183883294,183883734,True,1,440
32655,183906092,183914999,True,1,8907
32656,183927500,183931801,False,1,4301
32657,183932908,183933612,True,2,704
32658,183932908,183933646,True,1,738
32659,183933524,183933873,True,1,349
32660,183941963,183943673,True,1,1710
32661,183953048,183954048,False,4,1000
32662,183953048,183954048,True,1,1000
32663,183960929,183961724,True,1,795
32664,183986695,183988119,True,2,1424
32665,184000286,184002023,False,2,1737
32666,184001711,184016611,True,1,14900
32667,184013429,184023017,False,1,9588
32668,184014549,184015381,True,1,832
32669,184094568,184100661,True,2,6093
32670,184102397,184151947,True,1,49550
32671,184154053,184154825,False,1,772
32672,184154053,184154825,True,1,772
32673,184162192,184162299,False,1,107
32674,184165117,184165787,True,2,670
32675,184173831,184343059,True,1,169228
32676,184229918,184251565,True,1,21647
32677,184229918,184316594,True,1,86676
32678,184233191,184234941,True,4,1750
32679,184252117,184255042,False,1,2925
32680,184261383,184269917,True,1,8534
32681,184295313,184307126,True,5,11813
32682,184316324,184316874,True,3,550
32683,184381753,184385397,True,2,3644
32684,184381753,184389206,True,1,7453
32685,184427997,184459699,False,1,31702
32686,184440015,184440271,True,1,256
32687,184443491,184452837,False,1,9346
32688,184443491,184452837,True,1,9346
32689,184478834,184481618,True,2,2784
32690,184495820,184497770,True,4,1950
32691,184509591,184534538,False,1,24947
32692,184523156,184523280,True,2,124
32693,184672483,184675593,False,1,3110
32694,184672483,184679583,True,3,7100
32695,184678700,184682150,False,1,3450
32696,184759224,184760058,True,1,834
32697,184759224,184760081,False,2,857
32698,184759224,184760081,True,2,857
32699,184794255,184856158,True,2,61903
32700,184795204,184829893,True,1,34689
32701,184795204,184856785,False,1,61581
32702,184829972,184843200,True,1,13228
32703,184830166,184830372,True,2,206
32704,184830166,184843200,True,3,13034
32705,184835523,184845981,True,1,10458
32706,184870479,184873301,True,2,2822
32707,184991399,184993592,True,1,2193
32708,184993848,184996262,False,1,2414
32709,185002860,185003923,True,1,1063
32710,185002860,185009164,True,1,6304
32711,185002860,185009169,True,1,6309
32712,185022420,185025356,False,1,2936
32713,185022420,185027063,False,1,4643
32714,185055653,185062172,False,16,6519
32715,185055653,185062172,True,15,6519
32716,185072276,185073215,True,1,939
32717,185074502,185084412,True,1,9910
32718,185074675,185083035,False,2,8360
32719,185074675,185084573,False,1,9898
32720,185074675,185084573,True,3,9898
32721,185074675,185084585,False,14,9910
32722,185074675,185084585,True,8,9910
32723,185074675,185084640,True,1,9965
32724,185074675,185086746,False,1,12071
32725,185074675,185096872,False,1,22197
32726,185074675,185099713,False,1,25038
32727,185079879,185080296,False,1,417
32728,185092138,185100114,False,1,7976
32729,185092138,185100114,True,2,7976
32730,185094701,185095938,False,1,1237
32731,185147652,185150825,True,1,3173
32732,185165040,185166307,True,1,1267
32733,185170532,185173206,False,1,2674
32734,185176769,185180761,True,1,3992
32735,185262571,185262746,True,1,175
32736,185263298,185266097,True,3,2799
32737,185265305,185266011,True,1,706
32738,185268966,185271368,True,1,2402
32739,185344589,185347154,True,1,2565
32740,185367177,185367917,True,1,740
32741,185367177,185380509,True,1,13332
32742,185405902,185417399,True,1,11497
32743,185424157,185424571,False,1,414
32744,185424157,185424571,True,2,414
32745,185464243,185472931,True,1,8688
32746,185464243,185475999,True,1,11756
32747,185492279,185513133,False,1,20854
32748,185492279,185519471,False,3,27192
32749,185492279,185625563,False,1,133284
32750,185492279,185634529,False,2,142250
32751,185492279,185644132,False,1,151853
32752,185524671,185533410,True,6,8739
32753,185524671,185536872,True,1,12201
32754,185529224,185530270,False,1,1046
32755,185529224,185530270,True,1,1046
32756,185566762,185569778,False,1,3016
32757,185577903,185581134,True,1,3231
32758,185579145,185579686,True,1,541
32759,185580455,185582361,True,1,1906
32760,185611251,185612331,False,1,1080
32761,185628105,185628642,True,1,537
32762,185630917,185634458,False,1,3541
32763,185630917,185638114,False,1,7197
32764,185630917,185691098,False,1,60181
32765,185636481,185639463,True,4,2982
32766,185637444,185640542,True,1,3098
32767,185721232,185736246,False,1,15014
32768,185723465,185730829,False,1,7364
32769,185723465,185730829,True,4,7364
32770,185757307,185758076,False,3,769
32771,185762859,185768121,True,2,5262
32772,185811431,185814109,True,1,2678
32773,185819526,185821367,True,1,1841
32774,185839522,185841855,True,1,2333
32775,185840234,185842663,True,1,2429
32776,185841542,185841616,True,1,74
32777,185841542,185841694,True,1,152
32778,185845606,185905212,False,1,59606
32779,185845606,185905212,True,1,59606
32780,185858284,185858689,True,3,405
32781,185858284,185858709,True,1,425
32782,185874531,185910416,True,1,35885
32783,185874531,185914614,True,1,40083
32784,185882081,185884460,True,3,2379
32785,185910265,186026946,False,1,116681
32786,185910265,186065293,True,4,155028
32787,185910265,186073517,True,1,163252
32788,185939939,185950078,True,16,10139
32789,185953779,186003449,True,2,49670
32790,185959991,185962351,True,1,2360
32791,185960444,186002218,True,2,41774
32792,185960951,185962802,False,1,1851
32793,185960951,185962802,True,1,1851
32794,186030658,186031087,False,1,429
32795,186030658,186031087,True,1,429
32796,186034174,186039877,True,1,5703
32797,186046321,186049807,True,1,3486
32798,186058492,186100060,False,1,41568
32799,186059232,186104345,False,1,45113
32800,186085304,186086281,True,1,977
32801,186109699,186117361,False,2,7662
32802,186109699,186117361,True,3,7662
32803,186126413,186128535,True,1,2122
32804,186126573,186128546,True,1,1973
32805,186127820,186129262,True,1,1442
32806,186133910,186177230,False,1,43320
32807,186193526,186196863,True,2,3337
32808,186222568,186224478,False,1,1910
32809,186237346,186243430,True,2,6084
32810,186260617,186261416,True,1,799
32811,186323367,186334120,False,1,10753
32812,186323367,186334120,True,1,10753
32813,186336193,186336902,True,1,709
32814,186340428,186355131,False,1,14703
32815,186340428,186355131,True,3,14703
32816,186340857,186341134,True,3,277
32817,186340857,186346166,True,1,5309
32818,186368154,186374040,False,1,5886
32819,186424073,186444078,True,1,20005
32820,186434410,186511496,True,1,77086
32821,186441967,186736700,False,1,294733
32822,186443792,186459807,True,1,16015
32823,186450797,186488632,True,1,37835
32824,186451444,186736829,True,3,285385
32825,186488258,186488781,True,1,523
32826,186521450,186524400,True,1,2950
32827,186595267,186596537,False,1,1270
32828,186595267,186596537,True,1,1270
32829,186596876,186611023,True,1,14147
32830,186597133,186598250,True,1,1117
32831,186599158,186601368,True,1,2210
32832,186603732,186604794,True,1,1062
32833,186617468,186620454,True,4,2986
32834,186617468,186624119,True,1,6651
32835,186707410,186711853,False,2,4443
32836,186707541,186711853,False,1,4312
32837,186715814,186715906,False,1,92
32838,186748258,186777145,True,1,28887
32839,186778819,186780907,True,1,2088
32840,186779194,186779986,True,2,792
32841,186789755,186794661,True,1,4906
32842,186795132,186795821,True,1,689
32843,186808129,186815932,True,1,7803
32844,186814316,186818741,True,3,4425
32845,186852488,186852885,False,1,397
32846,186852488,186854815,False,1,2327
32847,186853298,186855268,False,1,1970
32848,186857534,186858179,True,1,645
32849,186858882,186864630,True,1,5748
32850,186887604,186887945,True,3,341
32851,186895940,186915251,True,1,19311
32852,186912122,186913085,True,1,963
32853,186917813,186918956,True,1,1143
32854,186927059,186927287,False,2,228
32855,186938565,186938953,True,1,388
32856,186949686,186949919,True,1,233
32857,186949686,186955253,True,2,5567
32858,186949686,186955258,True,1,5572
32859,186949686,186958302,True,1,8616
32860,186965786,186969022,True,1,3236
32861,186972370,186973715,False,1,1345
32862,186973755,186973934,True,1,179
32863,186976384,187206626,True,2,230242
32864,187030151,187030487,True,1,336
32865,187030151,187033101,True,1,2950
32866,187030916,187031279,True,3,363
32867,187035333,187038569,True,2,3236
32868,187071775,187071865,True,1,90
32869,187089879,187120576,True,4,30697
32870,187089879,187125034,True,1,35155
32871,187102560,187106416,True,1,3856
32872,187107512,187107641,True,1,129
32873,187116796,187130888,True,1,14092
32874,187128186,187170149,True,2,41963
32875,187128493,187170344,True,1,41851
32876,187151771,187151886,True,1,115
32877,187175570,187181856,True,8,6286
32878,187179565,187195842,True,1,16277
32879,187185129,187187688,True,3,2559
32880,187187080,187193966,False,1,6886
32881,187189356,187193609,True,1,4253
32882,187212736,187213853,False,3,1117
32883,187235743,187236889,True,1,1146
32884,187235743,187237153,False,1,1410
32885,187235743,187237153,True,1,1410
32886,187244696,187246574,True,1,1878
32887,187292719,187295195,True,1,2476
32888,187299247,187299442,True,1,195
32889,187302672,187303898,True,1,1226
32890,187303204,187303977,True,1,773
32891,187335148,187335497,True,1,349
32892,187339363,187342409,True,1,3046
32893,187342254,187343728,True,1,1474
32894,187347186,187349568,True,1,2382
32895,187347186,187350392,True,1,3206
32896,187352464,187353153,True,1,689
32897,187367582,187379147,False,1,11565
32898,187367582,187379147,True,1,11565
32899,187398308,187413698,True,4,15390
32900,187398308,187421483,True,1,23175
32901,187398308,187453155,True,1,54847
32902,187413329,187416064,True,4,2735
32903,187432698,187433264,True,1,566
32904,187440198,187441917,True,1,1719
32905,187445566,187449811,True,1,4245
32906,187452907,187466602,True,1,13695
32907,187453539,187455814,True,1,2275
32908,187467340,187480423,True,1,13083
32909,187488272,187750243,False,1,261971
32910,187509026,187514175,True,1,5149
32911,187509081,187533214,True,1,24133
32912,187543897,187546267,True,1,2370
32913,187543897,187560083,True,2,16186
32914,187544919,187560736,True,2,15817
32915,187552830,187559388,False,1,6558
32916,187552830,187565855,False,1,13025
32917,187557215,187558353,True,1,1138
32918,187557215,187558476,True,1,1261
32919,187563836,187564508,False,1,672
32920,187563836,187565133,True,1,1297
32921,187599433,187733579,True,1,134146
32922,187600600,187600734,False,1,134
32923,187605942,187606595,True,1,653
32924,187620592,187649471,True,4,28879
32925,187623899,187630940,True,1,7041
32926,187627276,187627908,True,1,632
32927,187654473,187654584,False,1,111
32928,187711539,187714550,True,1,3011
32929,187711991,187721235,False,1,9244
32930,187722595,187724228,True,2,1633
32931,187722595,187724231,False,1,1636
32932,187722595,187724231,True,2,1636
32933,187724752,187748748,True,2,23996
32934,187758946,188076591,True,2,317645
32935,187794720,187799972,True,8,5252
32936,187827549,187878710,True,3,51161
32937,187844139,187847201,False,1,3062
32938,187873320,187875084,False,1,1764
32939,187875372,187896756,False,1,21384
32940,187887977,187897910,True,2,9933
32941,187902997,187904753,True,3,1756
32942,187908860,187918904,False,1,10044
32943,187908860,187918904,True,1,10044
32944,187918923,187919921,False,1,998
32945,187922401,187925843,False,1,3442
32946,187927571,187930056,True,1,2485
32947,187928615,187930633,True,1,2018
32948,187929748,187931215,True,1,1467
32949,187931146,187931915,True,2,769
32950,187931418,187931915,True,1,497
32951,187933113,187934797,True,1,1684
32952,187933425,187939360,False,1,5935
32953,187952803,187954435,True,2,1632
32954,188019436,188022060,True,1,2624
32955,188028763,188036379,True,1,7616
32956,188048285,188050930,True,2,2645
32957,188055318,188060176,True,5,4858
32958,188068062,188068513,False,1,451
32959,188070022,188072141,False,1,2119
32960,188074286,188078457,True,1,4171
32961,188077742,188078479,True,1,737
32962,188085560,188086503,True,4,943
32963,188094178,188094844,False,1,666
32964,188102205,188121809,True,1,19604
32965,188102287,188121813,True,1,19526
32966,188113743,188114965,True,1,1222
32967,188115589,188117452,False,1,1863
32968,188142398,188143693,False,1,1295
32969,188142398,188143693,True,2,1295
32970,188204425,188230905,False,1,26480
32971,188224415,188237125,True,1,12710
32972,188240259,188243790,True,1,3531
32973,188250336,188253652,True,1,3316
32974,188269554,188338753,True,1,69199
32975,188278698,188286039,True,3,7341
32976,188293046,188293294,True,1,248
32977,188303815,188313543,True,3,9728
32978,188344514,188357246,True,1,12732
32979,188358379,188358546,True,1,167
32980,188372535,188376823,False,1,4288
32981,188372535,188388228,True,1,15693
32982,188395189,188679920,True,1,284731
32983,188425736,188426771,True,3,1035
32984,188429362,188431623,True,1,2261
32985,188429362,188432534,True,3,3172
32986,188435666,188445707,True,1,10041
32987,188439013,188459862,False,1,20849
32988,188454353,188456920,True,2,2567
32989,188461618,188461723,False,1,105
32990,188491533,188496441,True,1,4908
32991,188554160,188578899,False,1,24739
32992,188557742,188580652,False,1,22910
32993,188571528,188578280,True,1,6752
32994,188571584,188578325,True,1,6741
32995,188601244,188602367,True,1,1123
32996,188608199,188668061,True,1,59862
32997,188650983,188781972,True,1,130989
32998,188670513,188671250,False,1,737
32999,188670513,188671250,True,1,737
33000,188685049,188686635,True,1,1586
33001,188706033,188718844,True,1,12811
33002,188707304,188712757,True,2,5453
33003,188717828,188733440,False,1,15612
33004,188742809,188745389,False,1,2580
33005,188770579,188776631,True,1,6052
33006,188770579,188779782,True,1,9203
33007,188787432,188788230,True,1,798
33008,188787488,188788231,True,1,743
33009,188787702,188788273,True,1,571
33010,188801636,188804540,True,3,2904
33011,188808240,188809495,True,1,1255
33012,188835245,188839000,False,1,3755
33013,188835245,188846679,False,3,11434
33014,188856502,188857899,False,1,1397
33015,188858031,188861759,False,2,3728
33016,188887936,188893328,False,1,5392
33017,188899784,188901803,True,1,2019
33018,188917191,188920056,True,1,2865
33019,188927254,188927958,False,1,704
33020,188927558,188927984,False,1,426
33021,188927558,188927984,True,1,426
33022,188934661,188938108,True,1,3447
33023,188941520,188941607,False,1,87
33024,188952200,188952286,True,1,86
33025,188972266,188973698,True,1,1432
33026,188977753,188981952,True,1,4199
33027,188985609,188996447,True,2,10838
33028,189003233,189029682,True,1,26449
33029,189003233,189034061,True,1,30828
33030,189022713,189023665,True,1,952
33031,189035075,189036609,True,3,1534
33032,189073962,189076156,True,2,2194
33033,189080029,189279778,True,3,199749
33034,189086307,189105425,True,1,19118
33035,189095433,189110823,True,1,15390
33036,189095433,189110869,True,1,15436
33037,189154221,189155047,True,1,826
33038,189154221,189155081,False,1,860
33039,189154221,189158273,False,1,4052
33040,189182048,189185402,True,1,3354
33041,189188446,189188966,True,1,520
33042,189189050,189247573,True,1,58523
33043,189216615,189261328,True,4,44713
33044,189230841,189231308,False,1,467
33045,189274767,189277628,True,1,2861
33046,189281567,189283037,True,2,1470
33047,189285452,189285582,True,1,130
33048,189296967,189297270,True,1,303
33049,189312835,189315149,True,1,2314
33050,189314276,189338847,False,2,24571
33051,189314276,189338880,False,2,24604
33052,189314276,189514134,False,1,199858
33053,189335739,189335923,True,1,184
33054,189376274,189381994,False,1,5720
33055,189392465,189395244,True,1,2779
33056,189404748,189405747,True,2,999
33057,189407576,189410381,False,1,2805
33058,189408778,189409344,True,1,566
33059,189414076,189415660,True,1,1584
33060,189415422,189419314,True,1,3892
33061,189425673,189426222,False,1,549
33062,189425673,189426222,True,2,549
33063,189444093,189452891,False,2,8798
33064,189444093,189460610,True,1,16517
33065,189454264,189455543,True,1,1279
33066,189457098,189460310,True,1,3212
33067,189492396,189493263,True,1,867
33068,189500142,189502092,True,2,1950
33069,189525986,189531834,True,1,5848
33070,189534208,189534317,True,2,109
33071,189534436,189535075,True,4,639
33072,189541524,189542990,False,1,1466
33073,189541524,189542990,True,1,1466
33074,189549693,189596181,True,1,46488
33075,189549693,189616228,True,3,66535
33076,189550188,189616382,True,1,66194
33077,189588227,189590509,True,1,2282
33078,189588266,189590516,True,1,2250
33079,189599983,189603166,True,1,3183
33080,189600955,189600956,True,1,1
33081,189614500,189614686,True,1,186
33082,189632754,189636437,True,1,3683
33083,189642244,189642785,False,1,541
33084,189642244,189642785,True,1,541
33085,189646364,189684512,True,1,38148
33086,189666822,189667294,True,1,472
33087,189667526,189667709,True,1,183
33088,189683193,189683641,True,1,448
33089,189683388,189698938,True,2,15550
33090,189688060,189688882,False,1,822
33091,189688060,189688882,True,11,822
33092,189691397,189692655,True,1,1258
33093,189715768,189716661,True,1,893
33094,189768076,189805219,True,1,37143
33095,189768076,189808093,True,3,40017
33096,189768076,189814261,True,1,46185
33097,189768614,189774492,False,1,5878
33098,189781932,189782734,False,1,802
33099,189781932,189792524,False,1,10592
33100,189781932,189792524,True,2,10592
33101,189790305,189791323,False,1,1018
33102,189795880,189796378,True,1,498
33103,189798693,189800937,True,1,2244
33104,189798895,189801139,True,1,2244
33105,189805181,189807336,True,2,2155
33106,189807680,189818765,False,1,11085
33107,189817946,189818213,True,1,267
33108,189835056,189835716,True,1,660
33109,189840123,189840349,False,1,226
33110,189856082,189859183,True,2,3101
33111,189858389,189859219,True,1,830
33112,189858389,189863324,True,1,4935
33113,189858620,189859311,True,1,691
33114,189858620,189863416,True,1,4796
33115,189858690,189860099,True,4,1409
33116,189860213,189864282,True,1,4069
33117,189862153,189864406,True,2,2253
33118,189895843,189900144,True,1,4301
33119,189907450,189909574,True,1,2124
33120,189926412,189933067,True,2,6655
33121,189945660,189957289,True,4,11629
33122,189965001,189970319,True,1,5318
33123,189966360,189970421,True,2,4061
33124,189969755,189970427,True,1,672
33125,189976797,189978917,False,3,2120
33126,189978626,189980855,True,1,2229
33127,189986168,189989465,True,1,3297
33128,189988636,189993674,True,1,5038
33129,189990883,189992606,False,1,1723
33130,189990883,189992606,True,1,1723
33131,189990883,189993375,False,1,2492
33132,189990883,189993375,True,1,2492
33133,190005919,190007110,True,1,1191
33134,190011736,190011938,False,1,202
33135,190055613,190057583,True,1,1970
33136,190055832,190057642,True,1,1810
33137,190055924,190057579,True,1,1655
33138,190068973,190069602,False,1,629
33139,190068973,190069602,True,3,629
33140,190095532,190095655,True,1,123
33141,190095532,190101386,True,1,5854
33142,190095796,190101502,True,1,5706
33143,190106805,190120897,True,1,14092
33144,190116867,190120984,True,1,4117
33145,190119807,190120176,False,1,369
33146,190119807,190120176,True,2,369
33147,190132943,190135960,False,1,3017
33148,190132943,190135960,True,2,3017
33149,190134237,190134410,True,2,173
33150,190157417,190158315,False,1,898
33151,190157417,190159402,False,1,1985
33152,190157417,190159402,True,2,1985
33153,190157507,190158409,True,1,902
33154,190157507,190159496,True,1,1989
33155,190161867,190162400,False,1,533
33156,190161867,190162400,True,1,533
33157,190176127,190182190,True,1,6063
33158,190176127,190187561,True,1,11434
33159,190184170,190187528,True,2,3358
33160,190214364,190214697,True,1,333
33161,190230682,190240280,True,2,9598
33162,190246699,190268067,False,1,21368
33163,190257644,190258253,True,1,609
33164,190258216,190258490,True,2,274
33165,190258627,190258729,True,1,102
33166,190279961,190282245,True,2,2284
33167,190279961,190282495,True,1,2534
33168,190294320,190294729,True,3,409
33169,190299645,190301750,True,1,2105
33170,190299645,190301761,True,1,2116
33171,190300063,190301761,True,1,1698
33172,190300213,190301761,True,1,1548
33173,190313988,190314084,True,1,96
33174,190314050,190314146,True,1,96
33175,190349266,190360300,True,1,11034
33176,190354285,190355425,True,1,1140
33177,190376353,190376429,False,1,76
33178,190376353,190380515,False,1,4162
33179,190427901,190429128,True,2,1227
33180,190438255,190440400,True,1,2145
33181,190438255,190445687,True,1,7432
33182,190440501,190443001,True,1,2500
33183,190445492,190445589,True,1,97
33184,190453413,190454873,True,1,1460
33185,190469545,190469852,True,1,307
33186,190508429,190511746,True,2,3317
33187,190508429,190511771,True,1,3342
33188,190512259,190518835,True,1,6576
33189,190512906,190516163,True,1,3257
33190,190513068,190516183,True,1,3115
33191,190516358,190520600,True,3,4242
33192,190524299,190525729,True,2,1430
33193,190559150,190563848,True,1,4698
33194,190560125,190564823,True,1,4698
33195,190571931,190572400,True,3,469
33196,190571931,190575944,True,2,4013
33197,190572378,190576146,True,2,3768
33198,190580239,190581435,True,1,1196
33199,190586097,190587041,False,1,944
33200,190653465,190662267,True,2,8802
33201,190703461,190705170,True,1,1709
33202,190725328,190736132,True,1,10804
33203,190726145,190727431,True,3,1286
33204,190730499,190753047,True,1,22548
33205,190730499,190761616,True,1,31117
33206,190730616,190730859,False,1,243
33207,190745306,190752731,True,1,7425
33208,190746153,190749403,False,1,3250
33209,190746153,190749403,True,9,3250
33210,190747957,190755352,False,1,7395
33211,190753804,190757231,True,2,3427
33212,190768802,190774593,True,2,5791
33213,190787541,190791009,False,1,3468
33214,190803902,190835848,True,4,31946
33215,190807963,190809805,False,1,1842
33216,190826500,190829854,False,1,3354
33217,190830183,190832928,True,1,2745
33218,190842444,190842770,False,1,326
33219,190844447,190856412,True,1,11965
33220,190848589,190849307,True,1,718
33221,190848833,190849307,True,1,474
33222,190853449,190853545,False,1,96
33223,190857264,190858164,False,1,900
33224,190857264,190858164,True,1,900
33225,190867281,190867626,True,1,345
33226,190884823,190888660,True,1,3837
33227,190884823,190910433,True,1,25610
33228,190897140,190940961,True,1,43821
33229,190900686,190901237,True,1,551
33230,190904014,190906144,True,1,2130
33231,190945856,190948796,True,2,2940
33232,190949387,190951177,True,1,1790
33233,190951389,190953721,True,1,2332
33234,190958554,190959720,True,1,1166
33235,190959002,190962661,True,1,3659
33236,191001092,191002169,False,1,1077
33237,191001092,191002169,True,1,1077
33238,191006919,191011189,False,1,4270
33239,191006919,191011189,True,1,4270
33240,191011705,191012265,True,1,560
33241,191035681,191036080,True,3,399
33242,191035816,191036206,False,1,390
33243,191047162,191047427,True,1,265
33244,191047531,191052302,True,1,4771
33245,191047531,191056018,True,5,8487
33246,191070871,191073561,False,1,2690
33247,191073471,191073553,False,1,82
33248,191075053,191075791,False,1,738
33249,191075053,191076494,True,1,1441
33250,191109564,191109933,True,5,369
33251,191116509,191167517,True,1,51008
33252,191124734,191127799,True,1,3065
33253,191132388,191135797,True,1,3409
33254,191134658,191135353,True,4,695
33255,191144044,191147768,False,2,3724
33256,191144044,191147768,True,1,3724
33257,191156439,191158992,True,1,2553
33258,191166066,191192338,True,1,26272
33259,191167125,191192923,True,1,25798
33260,191197865,191198501,False,3,636
33261,191199491,191206645,False,1,7154
33262,191218145,191225403,True,6,7258
33263,191223183,191257235,True,7,34052
33264,191223893,191247778,True,1,23885
33265,191248219,191248552,False,1,333
33266,191250508,191270901,True,1,20393
33267,191259528,191299424,False,1,39896
33268,191289534,191289653,False,1,119
33269,191306344,191308459,True,1,2115
33270,191307041,191307545,True,5,504
33271,191307664,191312073,True,1,4409
33272,191307664,191319754,False,1,12090
33273,191307697,191312055,True,1,4358
33274,191307697,191312058,True,1,4361
33275,191307697,191319736,False,1,12039
33276,191316905,191332893,True,2,15988
33277,191337182,191344604,False,2,7422
33278,191337182,191344604,True,1,7422
33279,191346018,191358939,True,3,12921
33280,191358346,191476107,True,1,117761
33281,191383029,191405101,True,2,22072
33282,191383029,191406723,True,1,23694
33283,191383029,191410523,True,1,27494
33284,191399581,191405041,False,1,5460
33285,191399581,191405041,True,3,5460
33286,191399581,191409475,False,1,9894
33287,191399581,191409475,True,4,9894
33288,191419611,191447118,True,1,27507
33289,191424566,191430132,True,1,5566
33290,191452877,191463760,True,1,10883
33291,191455121,191456605,True,3,1484
33292,191464344,191470659,True,1,6315
33293,191473745,191474235,True,1,490
33294,191493839,191497452,True,1,3613
33295,191496457,191516198,True,2,19741
33296,191500220,191500496,True,3,276
33297,191506277,191509080,False,1,2803
33298,191506277,191509080,True,1,2803
33299,191507760,191544183,True,1,36423
33300,191530502,191531487,True,1,985
33301,191539972,191541663,True,1,1691
33302,191554847,191555358,True,1,511
33303,191582448,191682368,True,1,99920
33304,191629411,191631816,True,2,2405
33305,191637032,191641195,True,3,4163
33306,191642100,191652303,True,1,10203
33307,191642100,191659052,True,1,16952
33308,191645843,191654047,False,1,8204
33309,191662787,191673113,True,2,10326
33310,191662787,191674408,True,2,11621
33311,191671306,191672636,False,2,1330
33312,191671306,191672636,True,2,1330
33313,191682456,191685420,True,1,2964
33314,191683669,191689597,False,1,5928
33315,191697962,191740758,True,1,42796
33316,191717083,191728403,False,1,11320
33317,191717083,191728403,True,1,11320
33318,191719855,191723498,False,1,3643
33319,191735927,191737666,False,1,1739
33320,191735927,191737666,True,2,1739
33321,191735927,191737669,True,1,1742
33322,191768193,191782244,True,2,14051
33323,191768282,191770949,True,1,2667
33324,191786425,191786810,True,1,385
33325,191787968,191788329,True,1,361
33326,191821453,191822732,True,1,1279
33327,191823016,191825658,True,3,2642
33328,191834917,191942939,True,1,108022
33329,191879850,191930416,True,3,50566
33330,191880777,191881407,True,4,630
33331,191881023,191881160,False,1,137
33332,191881155,191882495,True,1,1340
33333,191881155,191890285,True,1,9130
33334,191891337,191892580,False,1,1243
33335,191895103,191939187,True,4,44084
33336,191926272,191939172,True,2,12900
33337,191940642,191963316,True,1,22674
33338,191945752,191998386,True,1,52634
33339,191951813,191953969,False,1,2156
33340,191952729,191971343,False,2,18614
33341,191986559,191990225,True,1,3666
33342,191994336,191997602,True,1,3266
33343,191995609,192008981,True,1,13372
33344,191996107,192009147,True,2,13040
33345,191997626,192009997,True,1,12371
33346,191998646,191999276,False,1,630
33347,192003043,192011604,True,1,8561
33348,192025419,192038198,True,1,12779
33349,192025637,192052809,True,1,27172
33350,192050886,192059648,True,2,8762
33351,192051223,192061374,True,1,10151
33352,192063099,192089829,True,1,26730
33353,192074646,192081434,False,2,6788
33354,192074646,192081434,True,1,6788
33355,192077111,192096833,True,8,19722
33356,192077111,192112043,True,1,34932
33357,192079134,192079395,False,1,261
33358,192079960,192083705,False,1,3745
33359,192086212,192102487,False,1,16275
33360,192089326,192097867,True,1,8541
33361,192102971,192103327,True,1,356
33362,192104580,192111166,True,3,6586
33363,192137067,192139746,True,1,2679
33364,192154031,192154165,True,2,134
33365,192155437,192155934,True,1,497
33366,192158693,192161287,False,2,2594
33367,192160499,192163979,False,1,3480
33368,192161311,192161861,True,1,550
33369,192172096,192298236,True,1,126140
33370,192172153,192298236,True,1,126083
33371,192172806,192178083,True,3,5277
33372,192174205,192174958,True,1,753
33373,192186644,192191262,False,1,4618
33374,192187050,192187377,True,1,327
33375,192195445,192208619,True,1,13174
33376,192208153,192216124,True,1,7971
33377,192212494,192215186,True,1,2692
33378,192212544,192230077,True,1,17533
33379,192222442,192226312,True,2,3870
33380,192224237,192225072,True,1,835
33381,192224237,192226450,True,1,2213
33382,192231602,192232089,True,1,487
33383,192234200,192235214,False,1,1014
33384,192236077,192236226,False,2,149
33385,192246394,192246802,True,1,408
33386,192261005,192264053,False,5,3048
33387,192261005,192265478,False,3,4473
33388,192263913,192281008,False,1,17095
33389,192274555,192277311,True,1,2756
33390,192286107,192287220,True,1,1113
33391,192292206,192312205,True,1,19999
33392,192299743,192308368,False,1,8625
33393,192305719,192309824,True,2,4105
33394,192325526,192363836,True,1,38310
33395,192352984,192356662,False,1,3678
33396,192353521,192354387,False,1,866
33397,192353521,192354387,True,1,866
33398,192353521,192354392,True,1,871
33399,192363863,192365625,False,1,1762
33400,192385365,192387362,False,1,1997
33401,192398451,192399785,False,1,1334
33402,192410173,192417330,True,1,7157
33403,192418760,192419430,False,2,670
33404,192418760,192421540,False,3,2780
33405,192418760,192421540,True,1,2780
33406,192423437,192426909,True,1,3472
33407,192423874,192426909,False,1,3035
33408,192423874,192426909,True,2,3035
33409,192428843,192447593,True,2,18750
33410,192431231,192434761,False,1,3530
33411,192438770,192439879,False,1,1109
33412,192465022,192467443,True,3,2421
33413,192467091,192471958,True,2,4867
33414,192502923,192526002,False,1,23079
33415,192505562,192507652,True,1,2090
33416,192515662,192517531,True,1,1869
33417,192517138,192521554,True,1,4416
33418,192521792,192524081,True,1,2289
33419,192543223,192586185,True,1,42962
33420,192556000,192556214,True,1,214
33421,192556815,192563824,False,1,7009
33422,192562181,192594329,False,1,32148
33423,192562181,192594411,False,2,32230
33424,192562181,192594411,True,1,32230
33425,192562181,192637572,False,1,75391
33426,192562181,192725915,False,2,163734
33427,192562181,192903953,False,3,341772
33428,192588635,192608995,True,1,20360
33429,192589047,192599938,True,1,10891
33430,192605407,192626344,True,1,20937
33431,192611206,192611674,True,1,468
33432,192611282,192611705,False,2,423
33433,192611282,192611705,True,7,423
33434,192636356,192642186,True,1,5830
33435,192652013,192653195,False,1,1182
33436,192658983,192690871,True,2,31888
33437,192663982,192665494,False,1,1512
33438,192674383,192683563,True,2,9180
33439,192678007,192731242,True,1,53235
33440,192678061,192731158,True,1,53097
33441,192686622,192732224,False,1,45602
33442,192734589,192736644,False,1,2055
33443,192734589,192736644,True,2,2055
33444,192734589,192736813,True,1,2224
33445,192789414,192791266,True,3,1852
33446,192793579,192794351,False,1,772
33447,192810715,192812036,False,1,1321
33448,192850496,192850985,True,1,489
33449,192858312,192860085,True,1,1773
33450,192886994,192890775,True,2,3781
33451,192895912,192902553,True,1,6641
33452,192895912,192988135,True,1,92223
33453,192907901,192939014,True,2,31113
33454,192910877,192913307,False,1,2430
33455,192927932,193025757,True,1,97825
33456,192945862,192952608,False,2,6746
33457,192995499,192997323,True,1,1824
33458,193006144,193006911,True,1,767
33459,193011524,193058506,True,1,46982
33460,193043683,193044810,True,1,1127
33461,193045092,193057275,True,1,12183
33462,193046296,193048663,False,1,2367
33463,193051430,193058794,True,1,7364
33464,193059265,193065898,True,1,6633
33465,193067276,193119091,True,3,51815
33466,193145111,193146956,False,1,1845
33467,193176689,193205547,True,1,28858
33468,193185995,193186088,False,1,93
33469,193196256,193205483,False,1,9227
33470,193196256,193230645,False,1,34389
33471,193216561,193248793,False,1,32232
33472,193271014,193272237,True,1,1223
33473,193271625,193271832,False,1,207
33474,193274753,193275747,True,1,994
33475,193300078,193301196,True,1,1118
33476,193302915,193304813,True,1,1898
33477,193342430,193374538,True,2,32108
33478,193342430,193374543,True,2,32113
33479,193346095,193346622,True,1,527
33480,193346701,193348323,True,2,1622
33481,193352778,193363169,False,1,10391
33482,193375716,193376107,True,6,391
33483,193386221,193387561,False,1,1340
33484,193397021,193400027,True,3,3006
33485,193428518,193428917,True,2,399
33486,193445183,193451533,True,1,6350
33487,193486915,194227834,True,1,740919
33488,193493113,193556226,True,1,63113
33489,193499916,193503585,True,1,3669
33490,193567428,193571672,False,1,4244
33491,193579598,193585149,True,1,5551
33492,193586484,193620089,True,2,33605
33493,193593594,193595180,False,1,1586
33494,193593594,193595180,True,5,1586
33495,193597448,193599330,True,1,1882
33496,193618683,193618798,True,1,115
33497,193619433,193622690,False,1,3257
33498,193625225,193626930,False,1,1705
33499,193659693,193675811,True,2,16118
33500,193659693,193678370,True,1,18677
33501,193662675,193677095,True,1,14420
33502,193667684,193704098,False,1,36414
33503,193693760,193694241,True,2,481
33504,193693766,193694241,True,1,475
33505,193703254,193703555,True,2,301
33506,193717043,193722857,True,2,5814
33507,193738737,193746459,True,1,7722
33508,193748870,193777794,False,1,28924
33509,193749886,193751413,True,1,1527
33510,193751643,193753096,True,1,1453
33511,193753654,193753871,True,1,217
33512,193767056,193777962,True,2,10906
33513,193835798,193836514,True,2,716
33514,193864110,193864940,True,1,830
33515,193867937,193868527,True,1,590
33516,193876482,193876872,False,1,390
33517,193878864,193900329,False,2,21465
33518,193880966,193881066,False,1,100
33519,193880966,193881066,True,2,100
33520,193896012,193896193,True,1,181
33521,193908016,193908176,True,1,160
33522,193908655,193915417,True,1,6762
33523,193937649,193955102,True,6,17453
33524,193939527,193940721,False,1,1194
33525,193939527,193940721,True,1,1194
33526,193974651,193976889,False,1,2238
33527,193982364,193982544,True,1,180
33528,193982364,193983439,True,1,1075
33529,193983990,193984322,True,1,332
33530,193995192,193995647,True,1,455
33531,194003069,194008861,True,1,5792
33532,194003069,194008894,True,1,5825
33533,194003069,194008933,True,2,5864
33534,194003069,194009269,True,1,6200
33535,194021019,194021422,True,1,403
33536,194021019,194061899,True,1,40880
33537,194035203,194037038,True,1,1835
33538,194043204,194062615,True,1,19411
33539,194082166,194095660,True,3,13494
33540,194083547,194085419,True,1,1872
33541,194146412,194149604,False,1,3192
33542,194146412,194149604,True,13,3192
33543,194162009,194162370,True,1,361
33544,194190027,194195873,False,1,5846
33545,194202755,194207481,True,1,4726
33546,194274041,194314270,True,1,40229
33547,194312309,194327070,True,1,14761
33548,194316937,194318694,False,2,1757
33549,194316937,194318694,True,4,1757
33550,194327565,194328307,False,1,742
33551,194327565,194328495,False,1,930
33552,194332380,194336713,True,1,4333
33553,194332836,194337169,True,1,4333
33554,194348436,194355533,True,1,7097
33555,194354974,194368908,True,1,13934
33556,194374602,194376292,False,1,1690
33557,194374602,194376292,True,7,1690
33558,194376625,194377390,False,1,765
33559,194405030,194415600,True,4,10570
33560,194407673,194416752,True,1,9079
33561,194482263,194482355,False,1,92
33562,194482263,194482508,True,1,245
33563,194482263,194482903,True,2,640
33564,194489754,194521652,True,1,31898
33565,194489754,194527139,True,1,37385
33566,194501424,194520953,True,2,19529
33567,194503557,194503664,True,1,107
33568,194503557,194507789,True,2,4232
33569,194520259,194526269,False,2,6010
33570,194520259,194526269,True,7,6010
33571,194527467,194563485,True,1,36018
33572,194532902,194533240,True,1,338
33573,194542304,194545299,True,1,2995
33574,194548613,194559691,True,2,11078
33575,194550534,194551696,True,2,1162
33576,194602078,194602380,True,2,302
33577,194602078,194604528,True,1,2450
33578,194602645,194604771,True,1,2126
33579,194612948,194617750,True,1,4802
33580,194617231,194620709,True,2,3478
33581,194630600,194631208,False,1,608
33582,194630727,194631208,False,1,481
33583,194634942,194638599,False,1,3657
33584,194635049,194638586,False,1,3537
33585,194642416,194646624,True,1,4208
33586,194653652,194654059,True,1,407
33587,194671839,194674667,True,1,2828
33588,194676453,194681804,False,1,5351
33589,194676453,194681804,True,1,5351
33590,194714016,194714106,False,1,90
33591,194722588,194722670,True,1,82
33592,194722777,194723184,True,4,407
33593,194731274,194733157,True,2,1883
33594,194732385,194735637,True,4,3252
33595,194744801,194745115,True,7,314
33596,194745397,194787365,True,5,41968
33597,194847209,194863379,True,2,16170
33598,194854776,194889385,True,1,34609
33599,194886404,194887272,True,1,868
33600,194886664,194887532,False,1,868
33601,194886664,194887532,True,1,868
33602,194908952,194917068,True,1,8116
33603,194916216,194947441,False,1,31225
33604,194943285,195054527,True,2,111242
33605,194963208,194963798,True,6,590
33606,194965229,194972783,True,1,7554
33607,194965229,194974558,True,1,9329
33608,194967415,194968427,False,1,1012
33609,194967415,194968427,True,1,1012
33610,194967415,194969068,True,1,1653
33611,194967415,194970517,True,1,3102
33612,194977983,195010879,False,1,32896
33613,194977983,195010879,True,2,32896
33614,195007475,195007884,False,1,409
33615,195007672,195061058,False,1,53386
33616,195009031,195009112,True,2,81
33617,195012440,195111587,True,1,99147
33618,195027904,195032859,True,1,4955
33619,195029433,195057743,False,1,28310
33620,195030931,195085796,True,1,54865
33621,195030931,195098400,True,1,67469
33622,195030931,195114854,True,1,83923
33623,195031684,195098664,True,4,66980
33624,195044792,195057212,True,2,12420
33625,195052664,195052786,True,3,122
33626,195052858,195052944,True,1,86
33627,195075708,195400075,False,1,324367
33628,195082082,195102920,True,1,20838
33629,195083663,195085243,True,4,1580
33630,195088001,195091183,True,1,3182
33631,195123020,195292446,False,1,169426
33632,195184799,195187763,True,2,2964
33633,195185372,195198282,True,1,12910
33634,195187587,195201648,False,1,14061
33635,195192196,195194222,False,1,2026
33636,195192196,195194987,False,1,2791
33637,195228307,195230369,True,1,2062
33638,195278059,195279982,True,1,1923
33639,195278922,195280903,True,1,1981
33640,195315128,195454588,True,1,139460
33641,195324846,195325300,True,4,454
33642,195332497,195334890,False,1,2393
33643,195335535,195338777,True,1,3242
33644,195342201,195344231,False,1,2030
33645,195357689,195359896,True,1,2207
33646,195360048,195527715,False,1,167667
33647,195367112,195369751,True,1,2639
33648,195403960,195412560,True,1,8600
33649,195411352,195417220,False,1,5868
33650,195436898,195447473,False,1,10575
33651,195467698,195475515,False,1,7817
33652,195472788,195502821,True,1,30033
33653,195498876,195499005,True,1,129
33654,195507484,195813554,False,1,306070
33655,195519817,195520397,True,1,580
33656,195519817,195523754,True,1,3937
33657,195532982,195533852,True,1,870
33658,195532982,195534236,True,1,1254
33659,195558905,195563031,False,2,4126
33660,195558905,195563031,True,5,4126
33661,195563687,195565130,False,1,1443
33662,195588250,195667778,True,1,79528
33663,195594649,195644290,True,1,49641
33664,195606634,195607266,True,3,632
33665,195658564,195658991,False,1,427
33666,195681587,195682343,True,1,756
33667,195691569,195691756,True,1,187
33668,195711984,195713227,True,1,1243
33669,195717647,195718242,False,1,595
33670,195725467,195730681,True,2,5214
33671,195746134,195746250,True,1,116
33672,195749334,195802433,False,1,53099
33673,195749334,195802433,True,3,53099
33674,195758083,195758176,True,1,93
33675,195772622,195773191,False,1,569
33676,195775448,195776139,False,1,691
33677,195779220,195781812,True,3,2592
33678,195779687,195782153,True,1,2466
33679,195822227,195822639,True,2,412
33680,195822701,195824104,False,1,1403
33681,195824573,195845563,False,2,20990
33682,195843869,195844345,True,1,476
33683,195850470,195853345,False,1,2875
33684,195856548,195914413,True,1,57865
33685,195896514,195896527,False,1,13
33686,195903302,195908116,False,3,4814
33687,195903302,195908116,True,6,4814
33688,195903302,195911283,False,2,7981
33689,195903302,195911283,True,4,7981
33690,195998615,196009028,True,1,10413
33691,196128541,196142191,True,2,13650
33692,196163689,196169705,False,1,6016
33693,196173512,196202931,True,1,29419
33694,196199011,196211480,False,1,12469
33695,196208848,196211018,False,1,2170
33696,196208848,196211018,True,4,2170
33697,196210327,196211053,True,1,726
33698,196210327,196211298,True,1,971
33699,196212209,196213645,False,2,1436
33700,196214798,196220149,False,1,5351
33701,196218448,196232626,True,1,14178
33702,196230045,196233647,False,1,3602
33703,196244158,196244757,False,1,599
33704,196244158,196244757,True,1,599
33705,196250279,196250766,False,1,487
33706,196251696,196253099,True,1,1403
33707,196252341,196254182,True,1,1841
33708,196310082,196310573,True,1,491
33709,196314626,196322177,False,1,7551
33710,196328069,196328162,True,1,93
33711,196335575,196335664,True,1,89
33712,196371795,196372377,True,1,582
33713,196383336,196384789,True,2,1453
33714,196413936,196414454,True,8,518
33715,196450911,196461214,True,1,10303
33716,196451969,196455099,False,1,3130
33717,196462467,196463125,True,1,658
33718,196470039,196470210,True,7,171
33719,196485541,196486900,False,1,1359
33720,196485541,196511358,False,1,25817
33721,196488432,196488524,True,1,92
33722,196488552,196488644,False,1,92
33723,196493795,196495549,True,1,1754
33724,196496122,196526715,False,1,30593
33725,196525172,196526048,True,1,876
33726,196545824,196546014,True,1,190
33727,196559953,196564834,True,1,4881
33728,196572502,196573997,True,1,1495
33729,196572558,196587563,False,1,15005
33730,196572558,196703026,True,1,130468
33731,196576215,196648579,False,1,72364
33732,196597903,196598538,True,1,635
33733,196618948,196619216,True,1,268
33734,196660167,196660407,True,1,240
33735,196682070,196682239,True,1,169
33736,196702043,196702579,True,1,536
33737,196708459,196715103,True,3,6644
33738,196746646,196748154,True,2,1508
33739,196784927,196827554,False,1,42627
33740,196800616,196835006,False,1,34390
33741,196850423,196850864,False,1,441
33742,196850423,196859874,False,1,9451
33743,196861548,196862357,False,1,809
33744,196866518,196867394,False,1,876
33745,196889941,196890314,True,3,373
33746,196889977,196890314,True,1,337
33747,196902455,196938351,True,3,35896
33748,196902455,196942734,True,1,40279
33749,196903402,196926758,True,1,23356
33750,196903402,196938819,True,1,35417
33751,196908680,196914025,False,1,5345
33752,196925612,196971611,True,1,45999
33753,196952372,196954823,True,2,2451
33754,196960292,197113872,True,1,153580
33755,196996589,196999246,True,1,2657
33756,197008330,197012760,True,1,4430
33757,197020484,197021413,False,1,929
33758,197033498,197034234,True,2,736
33759,197084516,197152503,True,1,67987
33760,197136673,197168613,False,1,31940
33761,197144573,197180876,False,1,36303
33762,197184172,197185177,True,3,1005
33763,197185582,197185872,True,1,290
33764,197204857,197207651,False,1,2794
33765,197207913,197215388,False,1,7475
33766,197211898,197212299,True,1,401
33767,197223365,197239003,False,1,15638
33768,197253363,197255715,True,3,2352
33769,197257925,197263640,True,2,5715
33770,197258527,197263971,True,1,5444
33771,197265288,197269354,False,1,4066
33772,197276265,197281048,False,1,4783
33773,197276265,197281048,True,3,4783
33774,197277811,197281573,True,1,3762
33775,197308744,197308835,True,1,91
33776,197313521,197329704,True,1,16183
33777,197352632,197391266,False,1,38634
33778,197369286,197370126,True,1,840
33779,197406595,197422031,False,1,15436
33780,197407420,197413116,False,4,5696
33781,197407420,197413116,True,3,5696
33782,197433301,197576574,False,1,143273
33783,197469584,197474555,True,2,4971
33784,197518901,197519707,True,1,806
33785,197532061,197545269,True,1,13208
33786,197542613,197546737,True,1,4124
33787,197565576,197565878,False,1,302
33788,197576144,197605387,True,1,29243
33789,197576144,197651431,True,1,75287
33790,197582796,197588815,True,1,6019
33791,197589846,197660287,True,1,70441
33792,197591179,197660905,True,2,69726
33793,197618859,197620182,True,1,1323
33794,197656270,197683426,False,1,27156
33795,197656468,197656572,True,1,104
33796,197656883,197662699,True,2,5816
33797,197706229,197711754,False,1,5525
33798,197714873,197716911,False,1,2038
33799,197717480,197725498,False,1,8018
33800,197725379,197725587,False,1,208
33801,197733679,197739365,False,1,5686
33802,197740260,197745857,True,1,5597
33803,197741969,197746083,True,1,4114
33804,197760287,197766528,True,1,6241
33805,197762825,197781611,True,4,18786
33806,197783705,198087780,True,3,304075
33807,197783705,198318579,True,1,534874
33808,197800674,197843383,True,1,42709
33809,197816425,197816517,False,1,92
33810,197819274,197831012,False,1,11738
33811,197819274,197831012,True,4,11738
33812,197825776,197830371,False,1,4595
33813,197847122,197854441,False,1,7319
33814,197847122,197854441,True,2,7319
33815,197886930,197897183,True,1,10253
33816,197925614,197949017,True,2,23403
33817,197944701,197955620,True,1,10919
33818,197963369,197964688,True,1,1319
33819,197967818,197970831,False,1,3013
33820,197967818,197970831,True,4,3013
33821,197974920,197975153,True,3,233
33822,197974920,197975157,True,3,237
33823,197975315,197976905,True,1,1590
33824,197986660,197987780,True,1,1120
33825,197987589,197987898,True,1,309
33826,197995440,198000626,True,1,5186
33827,197995440,198004197,True,1,8757
33828,198013218,198014246,True,2,1028
33829,198013468,198014255,True,2,787
33830,198015299,198035253,True,1,19954
33831,198015299,198045480,True,1,30181
33832,198032133,198035757,True,2,3624
33833,198038573,198046101,True,1,7528
33834,198073370,198078972,True,3,5602
33835,198074262,198079453,True,1,5191
33836,198075044,198094247,True,1,19203
33837,198078690,198081172,True,5,2482
33838,198108015,198108808,True,1,793
33839,198111761,198112551,True,2,790
33840,198111761,198113490,True,2,1729
33841,198122868,198196745,True,5,73877
33842,198130809,198136513,True,1,5704
33843,198141193,198144538,True,3,3345
33844,198152906,198159003,False,1,6097
33845,198153704,198178051,True,1,24347
33846,198153704,198182196,True,1,28492
33847,198163011,198165342,True,1,2331
33848,198166610,198167265,True,2,655
33849,198183107,198187190,True,1,4083
33850,198183107,198188112,True,1,5005
33851,198191925,198192719,True,1,794
33852,198204628,198205836,True,1,1208
33853,198204628,198205898,True,1,1270
33854,198205355,198206198,True,2,843
33855,198206957,198212950,True,1,5993
33856,198207917,198211874,True,3,3957
33857,198229698,198231281,True,1,1583
33858,198233410,198234749,True,6,1339
33859,198254702,198255486,True,1,784
33860,198254702,198277674,True,2,22972
33861,198257980,198273699,True,4,15719
33862,198259078,198265082,True,1,6004
33863,198259138,198265082,True,1,5944
33864,198260160,198265629,True,1,5469
33865,198277375,198282882,True,4,5507
33866,198277378,198282882,True,6,5504
33867,198277394,198282882,True,1,5488
33868,198290051,198293397,True,1,3346
33869,198290051,198299843,True,1,9792
33870,198298965,198302902,True,1,3937
33871,198308876,198311161,True,1,2285
33872,198312454,198314198,False,1,1744
33873,198312454,198314198,True,4,1744
33874,198313087,198314601,True,4,1514
33875,198337236,198337687,True,1,451
33876,198337972,198338279,True,1,307
33877,198356072,198356610,True,1,538
33878,198357792,198363096,False,1,5304
33879,198365246,198397080,True,4,31834
33880,198365246,198397083,True,2,31837
33881,198372229,198376160,True,1,3931
33882,198375118,198377567,True,1,2449
33883,198385664,198443549,True,3,57885
33884,198391896,198393727,True,1,1831
33885,198391905,198393727,True,1,1822
33886,198391905,198393730,True,1,1825
33887,198391973,198392611,True,1,638
33888,198392051,198392697,False,1,646
33889,198409704,198409997,True,1,293
33890,198409704,198411340,True,2,1636
33891,198412039,198416041,True,2,4002
33892,198412039,198417355,True,4,5316
33893,198425323,198433072,True,2,7749
33894,198429182,198430716,True,1,1534
33895,198429209,198430716,False,1,1507
33896,198429209,198430716,True,2,1507
33897,198433041,198436354,True,1,3313
33898,198434799,198436177,True,1,1378
33899,198436556,198436635,True,7,79
33900,198438401,198438532,False,1,131
33901,198438946,198440361,True,1,1415
33902,198450230,198451258,True,1,1028
33903,198450780,198451410,True,1,630
33904,198451543,198452277,True,1,734
33905,198473536,198477752,True,1,4216
33906,198477623,198477752,True,2,129
33907,198491835,198493506,True,5,1671
33908,198517797,198586436,True,1,68639
33909,198528465,198534347,False,1,5882
33910,198528465,198534347,True,2,5882
33911,198528465,198547180,True,1,18715
33912,198538345,198539045,True,1,700
33913,198545252,198547003,True,1,1751
33914,198546323,198990175,False,1,443852
33915,198565159,198575668,True,1,10509
33916,198605877,198608092,True,1,2215
33917,198643917,198644889,True,3,972
33918,198646070,198669609,True,1,23539
33919,198664887,198669810,True,2,4923
33920,198673223,198674496,True,1,1273
33921,198688772,198702631,True,2,13859
33922,198688772,198705713,True,2,16941
33923,198710433,198713022,True,3,2589
33924,198714460,198736140,True,1,21680
33925,198714460,198736155,True,1,21695
33926,198714947,198751941,False,1,36994
33927,198714947,198751941,True,1,36994
33928,198714947,198821178,True,1,106231
33929,198746626,198746843,True,1,217
33930,198750477,198750742,True,3,265
33931,198750477,198751272,True,1,795
33932,198757411,198759208,False,1,1797
33933,198758606,198772268,True,1,13662
33934,198785255,198788855,True,2,3600
33935,198801376,198811138,True,1,9762
33936,198807700,198811705,True,1,4005
33937,198821442,198822889,True,1,1447
33938,198821595,198826737,False,1,5142
33939,198851444,198859709,False,1,8265
33940,198851444,198859709,True,4,8265
33941,198851444,198862376,True,1,10932
33942,198853875,199142457,True,1,288582
33943,198874962,198876554,True,2,1592
33944,198878806,198879413,True,1,607
33945,198892742,198894198,True,3,1456
33946,198892742,198895107,True,6,2365
33947,198909213,198910814,True,1,1601
33948,198923267,198923969,False,1,702
33949,198923267,198923969,True,1,702
33950,198923324,198924026,True,2,702
33951,198927605,198973262,True,1,45657
33952,198935086,199005826,True,3,70740
33953,198935666,198940538,False,1,4872
33954,198940032,199079421,False,1,139389
33955,198949206,198950413,True,1,1207
33956,198978398,198988868,True,3,10470
33957,198993955,198995109,False,1,1154
33958,198993955,198995109,True,3,1154
33959,198993955,199001361,True,1,7406
33960,198993959,198995109,False,1,1150
33961,198993959,198995109,True,2,1150
33962,198996664,199001082,True,1,4418
33963,198998583,198999625,True,1,1042
33964,199020927,199023422,True,3,2495
33965,199023384,199024110,True,2,726
33966,199023384,199024114,True,1,730
33967,199040905,199043544,True,2,2639
33968,199042117,199047352,True,1,5235
33969,199054124,199055930,True,1,1806
33970,199073564,199267222,False,1,193658
33971,199073564,199402492,True,1,328928
33972,199098514,199143540,True,3,45026
33973,199104092,199119124,True,3,15032
33974,199129258,199130125,True,1,867
33975,199136685,199161685,True,1,25000
33976,199136685,199209843,True,1,73158
33977,199137052,199160268,True,1,23216
33978,199156855,199159149,True,2,2294
33979,199161332,199168632,True,2,7300
33980,199220066,199229207,True,1,9141
33981,199226567,199230070,True,1,3503
33982,199226567,199234258,True,2,7691
33983,199226567,199240700,True,1,14133
33984,199228407,199248384,True,3,19977
33985,199229310,199249287,True,1,19977
33986,199250227,199264760,True,2,14533
33987,199262525,199263715,False,1,1190
33988,199278156,199333304,True,2,55148
33989,199278156,199359430,True,2,81274
33990,199278940,199279386,True,1,446
33991,199280694,199433459,True,1,152765
33992,199291392,199291393,True,2,1
33993,199291499,199299079,False,1,7580
33994,199294880,199296515,True,2,1635
33995,199294880,199301948,True,1,7068
33996,199324004,199334225,True,1,10221
33997,199337428,199340349,True,8,2921
33998,199354859,199356047,False,1,1188
33999,199354859,199356047,True,9,1188
34000,199373271,199373493,True,2,222
34001,199376505,199383288,True,1,6783
34002,199381159,199381316,True,3,157
34003,199382607,199385287,True,2,2680
34004,199392070,199397511,True,1,5441
34005,199398524,199398630,True,4,106
34006,199399071,199399776,True,2,705
34007,199399699,199399979,True,1,280
34008,199409938,199410239,True,6,301
34009,199416829,199420161,True,1,3332
34010,199430754,199430997,False,1,243
34011,199434749,199437144,True,1,2395
34012,199449006,199449308,True,1,302
34013,199450121,199460370,True,2,10249
34014,199460074,199483366,True,2,23292
34015,199484868,199498758,True,1,13890
34016,199493127,199493649,True,1,522
34017,199504829,199504925,True,5,96
34018,199515446,199520987,True,2,5541
34019,199515446,199521456,True,1,6010
34020,199516584,199516930,False,1,346
34021,199516584,199516930,True,1,346
34022,199535334,199536110,False,1,776
34023,199535334,199536110,True,1,776
34024,199542931,199543360,True,1,429
34025,199542931,199544179,True,4,1248
34026,199542931,199549835,True,1,6904
34027,199543367,199543479,True,1,112
34028,199543367,199544298,True,1,931
34029,199543468,199544273,True,1,805
34030,199551137,199553656,True,1,2519
34031,199551165,199553651,True,2,2486
34032,199571658,199571736,True,1,78
34033,199583397,199587752,False,1,4355
34034,199583397,199587752,True,5,4355
34035,199583706,199587846,True,1,4140
34036,199587288,199588964,True,3,1676
34037,199593760,199594443,True,1,683
34038,199595253,199600179,True,2,4926
34039,199596983,199597102,True,1,119
34040,199597631,199598134,True,1,503
34041,199598503,199607292,False,1,8789
34042,199598503,199608945,False,1,10442
34043,199598503,199618495,False,1,19992
34044,199598503,199619468,True,1,20965
34045,199601899,199605677,True,3,3778
34046,199615844,199616539,True,1,695
34047,199618633,199619660,False,1,1027
34048,199618633,199629234,False,1,10601
34049,199632506,199633112,True,1,606
34050,199633894,199634205,True,1,311
34051,199635043,199636649,True,1,1606
34052,199667615,199699588,True,1,31973
34053,199677925,199679519,False,1,1594
34054,199679852,199680015,True,2,163
34055,199694723,199694954,False,1,231
34056,199697346,199698254,True,3,908
34057,199698683,199701245,False,1,2562
34058,199698683,199701517,False,1,2834
34059,199705871,199736364,False,1,30493
34060,199705871,199743357,True,3,37486
34061,199706983,199743841,False,1,36858
34062,199706983,199743841,True,2,36858
34063,199712103,199713003,True,1,900
34064,199717655,199718583,True,1,928
34065,199717655,199719170,True,1,1515
34066,199718644,199718875,True,2,231
34067,199720848,199721971,True,1,1123
34068,199729544,199730516,True,2,972
34069,199736559,199926796,False,1,190237
34070,199742791,199768879,True,1,26088
34071,199752692,199755426,True,1,2734
34072,199753019,199755718,True,1,2699
34073,199757017,199757826,True,1,809
34074,199763905,199765303,False,1,1398
34075,199763905,199765303,True,2,1398
34076,199768612,199776110,False,1,7498
34077,199768777,199769548,True,1,771
34078,199771618,199773235,True,1,1617
34079,199788843,199810228,True,1,21385
34080,199788843,199817018,True,3,28175
34081,199788843,199817428,True,1,28585
34082,199788843,199885647,False,1,96804
34083,199798674,199800350,True,1,1676
34084,199801674,199801849,True,2,175
34085,199809389,199813450,True,1,4061
34086,199810938,199811919,True,1,981
34087,199815126,199815546,True,1,420
34088,199815126,199817372,True,1,2246
34089,199825102,199825433,True,1,331
34090,199833805,199866803,True,1,32998
34091,199836969,199841574,False,1,4605
34092,199836969,199844719,False,1,7750
34093,199836969,199846065,False,1,9096
34094,199846335,199861503,True,1,15168
34095,199855590,199857481,False,1,1891
34096,199856257,199861544,False,1,5287
34097,199860661,199862874,True,6,2213
34098,199860896,199866211,True,1,5315
34099,199867609,199869566,False,1,1957
34100,199871748,199873902,True,1,2154
34101,199876677,199882001,True,1,5324
34102,199883149,199884560,True,1,1411
34103,199888056,199888522,False,1,466
34104,199895205,199906380,True,1,11175
34105,199895554,199906699,True,1,11145
34106,199899886,199899970,True,1,84
34107,199899985,199900069,False,1,84
34108,199907885,199930530,True,1,22645
34109,199911614,199911936,True,1,322
34110,199913681,199917029,True,1,3348
34111,199913681,199917695,True,3,4014
34112,199915504,199916441,False,1,937
34113,199917249,199921112,False,1,3863
34114,199920443,199921144,True,1,701
34115,199932790,199945231,False,1,12441
34116,199937892,199942807,True,1,4915
34117,199942410,199942732,True,5,322
34118,199947924,199953176,False,1,5252
34119,199959274,199960125,True,1,851
34120,199959575,199978151,True,2,18576
34121,199981747,199983248,False,1,1501
34122,199981747,199983248,True,4,1501
34123,199985721,199985851,True,1,130
34124,199994078,199994228,True,1,150
34125,199997453,199998004,False,1,551
34126,199997453,199998004,True,2,551
34127,199997453,199998631,True,1,1178
34128,199997453,199999809,True,2,2356
34129,200001556,200009083,False,1,7527
34130,200001556,200009083,True,3,7527
34131,200002724,200003115,True,1,391
34132,200011539,200014356,True,1,2817
34133,200016190,200018262,True,1,2072
34134,200020442,200033519,False,1,13077
34135,200020442,200064711,False,1,44269
34136,200021583,200021692,True,1,109
34137,200033167,200033606,True,1,439
34138,200033436,200033875,True,1,439
34139,200034752,200035642,True,2,890
34140,200051068,200051479,True,6,411
34141,200052940,200055063,True,1,2123
34142,200053075,200054648,True,1,1573
34143,200053075,200055063,True,1,1988
34144,200056565,200057793,True,1,1228
34145,200066067,200066163,True,1,96
34146,200069737,200072617,True,1,2880
34147,200083398,200085439,True,1,2041
34148,200084094,200084591,True,1,497
34149,200090449,200092575,True,2,2126
34150,200105812,200105999,False,1,187
34151,200107203,200111490,True,2,4287
34152,200108845,200115221,True,1,6376
34153,200109703,200111264,True,1,1561
34154,200110807,200113812,True,1,3005
34155,200123842,200126075,True,1,2233
34156,200128932,200129314,True,3,382
34157,200139255,200139618,True,1,363
34158,200139475,200139658,True,1,183
34159,200139997,200140172,True,1,175
34160,200143476,200146311,True,1,2835
34161,200150810,200151861,True,3,1051
34162,200163173,200164398,True,1,1225
34163,200166863,200169188,True,1,2325
34164,200173063,200173909,True,1,846
34165,200185652,200198223,False,1,12571
34166,200197379,200201929,True,3,4550
34167,200212441,200244765,True,3,32324
34168,200212441,200279313,True,2,66872
34169,200223278,200230038,True,2,6760
34170,200223348,200239303,True,1,15955
34171,200241319,200268575,True,1,27256
34172,200249194,200249874,True,2,680
34173,200252098,200254479,True,1,2381
34174,200252098,200255701,True,1,3603
34175,200274023,200283276,True,2,9253
34176,200277350,200311815,True,1,34465
34177,200286946,200288023,False,1,1077
34178,200286946,200288023,True,1,1077
34179,200288085,200289755,False,1,1670
34180,200290471,200334443,True,1,43972
34181,200297872,200304092,True,1,6220
34182,200301627,200308170,True,2,6543
34183,200302158,200308456,True,1,6298
34184,200307658,200323493,True,2,15835
34185,200307678,200308053,False,1,375
34186,200309808,200309904,True,1,96
34187,200322353,200334249,True,1,11896
34188,200331772,200334486,True,2,2714
34189,200338502,200346210,True,1,7708
34190,200338502,200351387,True,1,12885
34191,200340046,200340127,True,2,81
34192,200344560,200344959,False,2,399
34193,200344560,200344959,True,1,399
34194,200345455,200346236,True,1,781
34195,200346560,200384708,True,1,38148
34196,200348821,200365041,True,1,16220
34197,200348821,200367514,True,1,18693
34198,200348934,200349010,True,1,76
34199,200349485,200349602,False,1,117
34200,200350305,200359742,False,1,9437
34201,200353437,200353884,True,1,447
34202,200366784,200366867,False,1,83
34203,200366784,200366867,True,1,83
34204,200368242,200371553,False,1,3311
34205,200368242,200371553,True,2,3311
34206,200368242,200373243,True,1,5001
34207,200373836,200376143,True,1,2307
34208,200374461,200374793,True,1,332
34209,200374611,200374793,True,1,182
34210,200374728,200374874,False,1,146
34211,200378301,200378448,True,1,147
34212,200381144,200383936,False,1,2792
34213,200395327,200398103,True,1,2776
34214,200398720,200402873,True,3,4153
34215,200400055,200400932,True,2,877
34216,200408265,200521256,True,1,112991
34217,200411789,200413834,True,1,2045
34218,200419588,200420075,True,1,487
34219,200420160,200420403,True,1,243
34220,200420732,200420928,True,2,196
34221,200423234,200485513,True,1,62279
34222,200436329,200438338,True,1,2009
34223,200436329,200459224,True,3,22895
34224,200436787,200442422,True,3,5635
34225,200443318,200452370,True,1,9052
34226,200449494,200453359,True,3,3865
34227,200456547,200459446,True,3,2899
34228,200461574,200463514,True,1,1940
34229,200461574,200465249,True,1,3675
34230,200463981,200464597,True,1,616
34231,200475920,200476022,True,1,102
34232,200476223,200476367,True,1,144
34233,200480285,200557123,True,1,76838
34234,200481674,200484595,False,1,2921
34235,200481674,200484595,True,1,2921
34236,200508496,200511472,False,1,2976
34237,200513932,200516892,False,1,2960
34238,200513932,200529453,False,1,15521
34239,200515581,200518380,True,1,2799
34240,200517929,200683994,True,3,166065
34241,200519624,200576932,True,3,57308
34242,200527010,200549882,True,1,22872
34243,200528005,200550341,True,1,22336
34244,200530029,200532947,True,1,2918
34245,200530029,200538291,True,5,8262
34246,200537547,200538987,True,1,1440
34247,200537547,200539532,True,2,1985
34248,200542908,200545160,True,1,2252
34249,200549741,200549831,True,1,90
34250,200556523,200556614,True,1,91
34251,200575476,200577116,False,1,1640
34252,200607602,200608117,True,1,515
34253,200631610,200632168,True,1,558
34254,200632218,200632573,True,1,355
34255,200632218,200632633,True,1,415
34256,200632498,200632573,True,1,75
34257,200633210,200634645,True,1,1435
34258,200637038,200637601,True,2,563
34259,200654034,200654576,True,1,542
34260,200657247,200676872,True,1,19625
34261,200662519,200662896,False,3,377
34262,200662519,200662896,True,2,377
34263,200663461,200665965,False,1,2504
34264,200667746,200670050,True,2,2304
34265,200667946,200683395,True,1,15449
34266,200680266,200680330,True,1,64
34267,200686860,200703834,True,1,16974
34268,200696541,200701210,False,1,4669
34269,200706414,200706608,True,1,194
34270,200709111,200710585,True,1,1474
34271,200709851,200710842,True,1,991
34272,200712331,200713307,True,1,976
34273,200719818,200722810,True,1,2992
34274,200727410,200729368,True,2,1958
34275,200732443,200733059,True,1,616
34276,200736916,200750057,True,2,13141
34277,200742830,200744291,True,1,1461
34278,200747064,200747780,True,1,716
34279,200791901,200798778,True,1,6877
34280,200801398,200802972,True,2,1574
34281,200801398,200803307,True,1,1909
34282,200823183,200826422,True,1,3239
34283,200829792,200834704,True,1,4912
34284,200832407,200833400,True,1,993
34285,200856408,200860618,True,1,4210
34286,200856739,200860659,True,2,3920
34287,200856817,200860870,True,1,4053
34288,200862395,200864234,True,2,1839
34289,200864589,200866304,False,1,1715
34290,200864589,200866304,True,1,1715
34291,200865199,200871303,True,2,6104
34292,200868033,200868859,True,1,826
34293,200871062,200894435,True,2,23373
34294,200872191,200895082,True,1,22891
34295,200875059,200881670,False,1,6611
34296,200875059,200884393,True,1,9334
34297,200876544,200989172,True,1,112628
34298,200883993,200890581,False,1,6588
34299,200900797,200902116,True,3,1319
34300,200900801,200902116,True,1,1315
34301,200901810,200906620,True,1,4810
34302,200907860,200909517,True,2,1657
34303,200910979,200911085,True,1,106
34304,200915563,200915714,True,1,151
34305,200918458,200923972,True,1,5514
34306,200927632,200930133,True,1,2501
34307,200930177,200930430,True,2,253
34308,200930177,200930480,True,2,303
34309,200930177,200930677,True,1,500
34310,200937632,200938572,True,6,940
34311,200938376,200939903,True,3,1527
34312,200945649,200945892,True,4,243
34313,200950067,200954523,True,1,4456
34314,200950067,200965779,True,1,15712
34315,200970633,200981203,True,1,10570
34316,200970633,200988299,True,1,17666
34317,200971742,201036740,True,1,64998
34318,200975570,200976402,True,4,832
34319,200976323,200976402,True,2,79
34320,200982658,200984957,True,1,2299
34321,200992092,200999025,True,1,6933
34322,201007660,201019251,True,1,11591
34323,201026409,201027890,True,1,1481
34324,201026840,201026936,False,1,96
34325,201047465,201053448,True,3,5983
34326,201063598,201082772,True,1,19174
34327,201070466,201071132,True,1,666
34328,201100091,201100191,True,2,100
34329,201101010,201101115,False,2,105
34330,201101010,201101115,True,1,105
34331,201103523,201103628,False,1,105
34332,201103523,201103628,True,1,105
34333,201111326,201113254,True,1,1928
34334,201116969,201199478,True,1,82509
34335,201118745,201118934,False,2,189
34336,201120040,201128073,True,1,8033
34337,201165020,201166990,True,1,1970
34338,201188561,201192580,False,1,4019
34339,201188561,201192580,True,3,4019
34340,201189392,201193270,True,1,3878
34341,201195518,201212892,False,1,17374
34342,201197576,201201141,False,1,3565
34343,201197576,201201141,True,2,3565
34344,201202291,201204162,True,1,1871
34345,201206414,201206544,True,1,130
34346,201207782,201240377,True,1,32595
34347,201209378,201210420,False,1,1042
34348,201209378,201212614,False,4,3236
34349,201209378,201212614,True,5,3236
34350,201209378,201212647,True,1,3269
34351,201212257,201212455,False,1,198
34352,201214142,201214260,False,1,118
34353,201214190,201214646,False,1,456
34354,201217619,201218531,False,1,912
34355,201217833,201218473,False,1,640
34356,201221838,201222352,True,1,514
34357,201225873,201246813,True,1,20940
34358,201225996,201228055,True,1,2059
34359,201228656,201228923,True,1,267
34360,201228656,201231942,True,3,3286
34361,201233347,201237653,True,1,4306
34362,201263640,201267164,False,1,3524
34363,201269418,201271223,True,1,1805
34364,201291911,201292322,True,4,411
34365,201292355,201295866,True,1,3511
34366,201292485,201293436,True,3,951
34367,201292485,201295996,False,1,3511
34368,201305865,201306134,True,1,269
34369,201312914,201314914,True,1,2000
34370,201314455,201324261,True,2,9806
34371,201322128,201337673,True,1,15545
34372,201322128,201346233,True,1,24105
34373,201323118,201338267,True,1,15149
34374,201326415,201330042,True,1,3627
34375,201326427,201330042,True,1,3615
34376,201326861,201337762,False,1,10901
34377,201326861,201337762,True,1,10901
34378,201334045,201339011,True,2,4966
34379,201345139,201345439,True,1,300
34380,201348456,201348880,True,1,424
34381,201352778,201356469,True,1,3691
34382,201378832,201381387,True,2,2555
34383,201411361,201433740,True,1,22379
34384,201457637,201459070,True,2,1433
34385,201463689,201463791,True,3,102
34386,201476151,201494758,True,3,18607
34387,201480757,201481251,False,1,494
34388,201482747,201496403,True,2,13656
34389,201482747,201505361,True,1,22614
34390,201486116,201486459,True,1,343
34391,201491379,201502399,True,1,11020
34392,201502126,201525333,True,2,23207
34393,201516821,201517081,True,3,260
34394,201524324,201527171,True,1,2847
34395,201540894,201542041,True,2,1147
34396,201550167,201551791,True,1,1624
34397,201579457,201581801,True,2,2344
34398,201595483,201597558,True,1,2075
34399,201601497,201603521,True,5,2024
34400,201602718,201604711,False,1,1993
34401,201602718,201604711,True,2,1993
34402,201611156,201611465,True,1,309
34403,201611156,201611468,True,1,312
34404,201613933,201614442,True,1,509
34405,201621322,201629899,True,1,8577
34406,201621322,201653683,False,1,32361
34407,201629705,201630348,True,2,643
34408,201635076,201639360,True,1,4284
34409,201635076,201640305,True,1,5229
34410,201636581,201637338,True,6,757
34411,201638180,201642020,True,1,3840
34412,201639715,201642287,True,3,2572
34413,201641432,201647418,True,1,5986
34414,201649997,201688287,False,1,38290
34415,201661256,201662224,True,1,968
34416,201663537,201681290,True,1,17753
34417,201675716,201678110,True,3,2394
34418,201678393,201678478,True,1,85
34419,201678393,201680482,True,1,2089
34420,201681103,201683570,True,1,2467
34421,201685586,201689999,True,1,4413
34422,201685611,201690015,True,1,4404
34423,201685873,201690077,True,1,4204
34424,201689874,201690755,True,1,881
34425,201690523,201691975,False,1,1452
34426,201693384,201696358,True,1,2974
34427,201695329,201797575,False,1,102246
34428,201696824,201782692,True,1,85868
34429,201696923,201700825,True,3,3902
34430,201697255,201713071,True,1,15816
34431,201698974,201699315,True,1,341
34432,201722482,201722582,False,1,100
34433,201722482,201726867,True,1,4385
34434,201735387,201752142,True,1,16755
34435,201735387,201753829,False,1,18442
34436,201735387,201753829,True,3,18442
34437,201738923,201739209,True,1,286
34438,201740139,201740565,True,1,426
34439,201740857,201741767,False,2,910
34440,201741863,201742378,True,1,515
34441,201741863,201742598,True,1,735
34442,201741863,201742980,True,1,1117
34443,201751168,201751255,True,2,87
34444,201754796,201757099,True,1,2303
34445,201755281,201757584,True,1,2303
34446,201756385,201756893,True,1,508
34447,201756385,201756921,True,1,536
34448,201756385,201756932,True,1,547
34449,201756770,201757124,True,1,354
34450,201766076,201766313,False,2,237
34451,201766076,201766313,True,1,237
34452,201770443,201772085,True,3,1642
34453,201770493,201773598,False,1,3105
34454,201770493,201774172,False,1,3679
34455,201780715,201789938,True,1,9223
34456,201790706,201793126,False,1,2420
34457,201790706,201793126,True,1,2420
34458,201794411,201801691,True,2,7280
34459,201810356,201813028,False,3,2672
34460,201810356,201813028,True,4,2672
34461,201822968,201823324,True,5,356
34462,201838292,201873189,True,1,34897
34463,201883669,201936695,True,4,53026
34464,201887214,201888025,True,1,811
34465,201887214,201889028,True,1,1814
34466,201896657,201899846,False,1,3189
34467,201903449,201905383,True,1,1934
34468,201914016,201914413,True,1,397
34469,201915210,201916266,False,1,1056
34470,201915210,201916266,True,4,1056
34471,201918596,201920176,True,1,1580
34472,201918596,201923723,True,1,5127
34473,201923149,201923812,True,4,663
34474,201935051,201953000,True,1,17949
34475,201935051,201956139,True,1,21088
34476,201946699,201947895,True,4,1196
34477,201975146,201976046,True,1,900
34478,202000426,202001225,False,2,799
34479,202007785,202008175,True,1,390
34480,202009135,202010314,True,3,1179
34481,202012592,202069377,False,1,56785
34482,202012592,202069377,True,1,56785
34483,202018565,202020290,True,1,1725
34484,202029021,202030581,False,1,1560
34485,202041399,202071759,False,1,30360
34486,202088041,202089625,True,6,1584
34487,202102007,202102935,True,1,928
34488,202103394,202106428,True,1,3034
34489,202173969,202176198,True,1,2229
34490,202174339,202179546,True,1,5207
34491,202174447,202174592,False,5,145
34492,202179572,202206122,True,4,26550
34493,202185463,202186984,False,1,1521
34494,202190428,202193513,True,1,3085
34495,202197911,202198400,False,1,489
34496,202216350,202218074,True,1,1724
34497,202219749,202221524,True,2,1775
34498,202222628,202238853,False,1,16225
34499,202228065,202228809,True,2,744
34500,202233514,202235080,False,1,1566
34501,202234889,202238008,True,1,3119
34502,202238929,202239924,True,1,995
34503,202247651,202261500,False,1,13849
34504,202277052,202278861,True,4,1809
34505,202286005,202286172,True,2,167
34506,202291865,202291974,True,2,109
34507,202299015,202302029,True,1,3014
34508,202314069,202318961,True,1,4892
34509,202325775,202326411,True,1,636
34510,202326415,202328955,True,1,2540
34511,202332701,202346463,True,1,13762
34512,202340608,202344767,True,2,4159
34513,202341406,202345067,True,1,3661
34514,202358952,202362380,True,1,3428
34515,202367272,202368232,True,1,960
34516,202367272,202418494,True,1,51222
34517,202370675,202371225,True,3,550
34518,202377178,202483795,True,2,106617
34519,202386673,202387932,True,2,1259
34520,202418499,202420714,False,1,2215
34521,202419356,202420724,False,1,1368
34522,202475709,202478434,True,1,2725
34523,202513457,202513544,True,1,87
34524,202513485,202514699,True,3,1214
34525,202540761,202541367,True,2,606
34526,202555093,202555200,True,2,107
34527,202561526,202564291,True,1,2765
34528,202572329,202572484,False,1,155
34529,202573665,202574453,False,1,788
34530,202584998,202587487,False,15,2489
34531,202585935,202587429,True,1,1494
34532,202586164,202591673,True,2,5509
34533,202586164,202591725,False,1,5561
34534,202586164,202597320,False,1,11156
34535,202591041,202611425,True,1,20384
34536,202592462,202607817,True,1,15355
34537,202594812,202595788,False,1,976
34538,202595628,202598724,True,1,3096
34539,202600223,202615114,True,1,14891
34540,202611256,202616116,True,1,4860
34541,202636027,202647934,True,3,11907
34542,202646131,202646673,True,2,542
34543,202648836,202650127,True,1,1291
34544,202677913,202680275,True,5,2362
34545,202677913,202680957,True,1,3044
34546,202721225,202753387,False,1,32162
34547,202722482,202726398,False,1,3916
34548,202723529,202723755,True,2,226
34549,202738809,202739620,True,1,811
34550,202741397,202742572,True,3,1175
34551,202746853,202752972,True,1,6119
34552,202761437,202762002,True,1,565
34553,202780150,202780449,False,1,299
34554,202780513,202784903,True,1,4390
34555,202791259,202791616,True,1,357
34556,202799992,202801204,True,1,1212
34557,202817952,202818392,True,2,440
34558,202838607,202838879,True,2,272
34559,202840219,202845478,True,2,5259
34560,202870215,202892951,False,1,22736
34561,202873488,202957805,True,1,84317
34562,202875147,202958679,True,1,83532
34563,202883576,202883882,True,1,306
34564,202887056,202888929,True,3,1873
34565,202892611,202896908,True,1,4297
34566,202901003,202901536,True,1,533
34567,202909593,202912415,False,1,2822
34568,202911363,202913370,True,1,2007
34569,202911366,202913370,False,2,2004
34570,202911366,202913370,True,3,2004
34571,202911366,202915843,True,1,4477
34572,202918556,203018576,True,5,100020
34573,202918556,203130559,True,1,212003
34574,202919115,202924173,True,2,5058
34575,202921830,203020274,True,1,98444
34576,202929649,202978722,False,2,49073
34577,202940598,202941084,False,2,486
34578,202940598,202941084,True,3,486
34579,202941740,202944607,True,1,2867
34580,202942979,202944607,True,2,1628
34581,202957640,202957832,True,1,192
34582,202957735,202957832,True,1,97
34583,202983025,203029622,False,1,46597
34584,202984123,202987958,False,1,3835
34585,202984123,202987958,True,2,3835
34586,202988445,202991892,False,1,3447
34587,202988445,202992386,True,1,3941
34588,202988445,202992417,False,1,3972
34589,202993195,203002129,True,2,8934
34590,202996196,202998980,True,1,2784
34591,202997029,202999237,True,1,2208
34592,203004325,203005521,True,1,1196
34593,203044846,203056811,True,1,11965
34594,203067998,203073070,True,3,5072
34595,203072639,203073024,False,1,385
34596,203076601,203079045,False,1,2444
34597,203085096,203086825,True,1,1729
34598,203093861,203095288,True,1,1427
34599,203093861,203117760,True,1,23899
34600,203097139,203100415,False,1,3276
34601,203101172,203102018,True,1,846
34602,203126564,203134031,False,1,7467
34603,203137118,203139284,True,2,2166
34604,203140331,203155516,True,1,15185
34605,203142413,203144644,True,1,2231
34606,203163261,203168237,False,1,4976
34607,203171299,203174356,True,3,3057
34608,203182670,203183182,True,1,512
34609,203187052,203188576,False,1,1524
34610,203230881,203231026,True,4,145
34611,203237467,203237852,True,5,385
34612,203248424,203251078,True,2,2654
34613,203259167,203264461,False,1,5294
34614,203272426,203274899,True,4,2473
34615,203299922,203302180,True,1,2258
34616,203319571,203338906,False,1,19335
34617,203348009,203348796,True,2,787
34618,203374021,203374880,False,1,859
34619,203404959,203406680,True,1,1721
34620,203405005,203406834,True,1,1829
34621,203412348,203412436,True,1,88
34622,203413969,203416418,True,1,2449
34623,203415423,203416687,True,2,1264
34624,203415478,203416690,True,2,1212
34625,203430730,203431666,True,4,936
34626,203430905,203432078,True,1,1173
34627,203433142,203433676,False,1,534
34628,203433844,203434604,False,1,760
34629,203435112,203444123,True,1,9011
34630,203435112,203491212,True,1,56100
34631,203435712,203435809,True,1,97
34632,203523733,203527012,True,1,3279
34633,203537342,203538616,False,1,1274
34634,203537661,203538599,True,1,938
34635,203571888,203579115,True,1,7227
34636,203576350,203577077,False,1,727
34637,203576350,203577077,True,2,727
34638,203586834,203608337,True,1,21503
34639,203590665,203592202,True,1,1537
34640,203604394,203610577,True,1,6183
34641,203610005,203621270,False,1,11265
34642,203623063,203624180,True,1,1117
34643,203625450,203627012,True,1,1562
34644,203630136,203633755,True,1,3619
34645,203636212,203638435,True,1,2223
34646,203643701,203646884,False,2,3183
34647,203643701,203646884,True,1,3183
34648,203654196,203655419,True,1,1223
34649,203666426,203677004,True,2,10578
34650,203683094,203688240,False,1,5146
34651,203689692,203691548,True,3,1856
34652,203693936,203916490,True,1,222554
34653,203694128,203916682,False,1,222554
34654,203694128,203916682,True,5,222554
34655,203706932,203711744,True,2,4812
34656,203708289,203708369,True,3,80
34657,203708775,203708907,True,1,132
34658,203709200,203710271,True,1,1071
34659,203709200,203710815,True,1,1615
34660,203709212,203710815,True,1,1603
34661,203734995,203758546,True,3,23551
34662,203738478,203739802,True,1,1324
34663,203739284,203743595,True,1,4311
34664,203741290,203741939,True,1,649
34665,203742756,203744685,True,1,1929
34666,203742764,203744693,True,1,1929
34667,203774928,203792148,True,1,17220
34668,203774928,203793345,True,1,18417
34669,203775889,203777270,False,1,1381
34670,203780481,203781332,True,1,851
34671,203785805,203790381,True,1,4576
34672,203810327,203811477,True,1,1150
34673,203812816,203812906,True,1,90
34674,203812816,203813394,True,1,578
34675,203812816,203814050,True,1,1234
34676,203812816,203814440,True,1,1624
34677,203821955,203824461,True,3,2506
34678,203836479,203836712,True,2,233
34679,203836825,203847807,True,1,10982
34680,203848582,203853619,True,1,5037
34681,203856953,203872208,True,1,15255
34682,203863783,203866984,True,8,3201
34683,203889770,203891895,False,1,2125
34684,203891804,203894907,True,3,3103
34685,203891804,203898008,True,3,6204
34686,203897507,203898747,True,1,1240
34687,203932347,203936528,True,1,4181
34688,203934583,203935120,True,1,537
34689,203934583,203935159,True,2,576
34690,203934583,203935811,True,2,1228
34691,203935435,203935998,True,1,563
34692,203951390,203951524,True,4,134
34693,203951394,203951524,True,2,130
34694,203959824,203961965,True,1,2141
34695,203959824,203962533,True,1,2709
34696,203963091,203966064,True,4,2973
34697,203966646,203968043,True,1,1397
34698,203969217,203969395,True,1,178
34699,203969999,204018059,True,1,48060
34700,203973852,203974686,True,1,834
34701,203977581,203996980,True,8,19399
34702,203977581,203999686,True,1,22105
34703,203977581,204009356,True,1,31775
34704,203977581,204011918,True,1,34337
34705,203985182,203987476,True,5,2294
34706,204002008,204003649,True,1,1641
34707,204002008,204004531,True,1,2523
34708,204008848,204008996,True,1,148
34709,204009165,204010707,True,1,1542
34710,204009165,204010726,True,1,1561
34711,204028008,204032718,True,2,4710
34712,204033427,204056651,True,1,23224
34713,204037650,204040118,False,1,2468
34714,204037650,204045146,True,1,7496
34715,204047475,204047628,False,1,153
34716,204047791,204048603,True,2,812
34717,204048363,204049372,False,1,1009
34718,204048811,204049775,True,1,964
34719,204048811,204050227,True,1,1416
34720,204066488,204089933,True,2,23445
34721,204066488,204109808,True,2,43320
34722,204068284,204072913,False,3,4629
34723,204068284,204072913,True,1,4629
34724,204073787,204074868,True,2,1081
34725,204089933,204092682,True,1,2749
34726,204096137,204096629,True,2,492
34727,204113610,204133370,True,1,19760
34728,204120555,204121488,True,1,933
34729,204129345,204131005,False,1,1660
34730,204148084,204150623,True,1,2539
34731,204148084,204150646,True,2,2562
34732,204148084,204150651,True,1,2567
34733,204148084,204153365,True,1,5281
34734,204183328,204199282,False,1,15954
34735,204183328,204199282,True,2,15954
34736,204189735,204195618,False,1,5883
34737,204195094,204196715,True,2,1621
34738,204210225,204211175,True,2,950
34739,204210225,204324991,True,1,114766
34740,204210996,204211651,True,1,655
34741,204214059,204214590,True,1,531
34742,204227678,204228353,True,1,675
34743,204235505,204239286,False,2,3781
34744,204235505,204246300,False,1,10795
34745,204235505,204247513,False,1,12008
34746,204235505,204247562,False,2,12057
34747,204235554,204247582,False,2,12028
34748,204235554,204247631,False,1,12077
34749,204238074,204240503,False,1,2429
34750,204243457,204243646,False,2,189
34751,204243457,204244334,False,2,877
34752,204243457,204251607,False,1,8150
34753,204244072,204244581,False,1,509
34754,204244072,204250592,False,1,6520
34755,204245183,204245310,True,3,127
34756,204247745,204247855,False,1,110
34757,204247745,204247855,True,6,110
34758,204254442,204255219,False,1,777
34759,204254442,204255878,False,1,1436
34760,204257421,204257883,True,1,462
34761,204257421,204261937,True,1,4516
34762,204257478,204258572,False,1,1094
34763,204257478,204258621,False,4,1143
34764,204258895,204259261,False,1,366
34765,204262392,204263175,False,1,783
34766,204266873,204269283,False,1,2410
34767,204267101,204274303,False,2,7202
34768,204267734,204268478,False,1,744
34769,204280293,204282151,True,1,1858
34770,204284653,204362350,True,1,77697
34771,204307856,204309560,True,1,1704
34772,204307856,204311180,True,1,3324
34773,204323625,204325484,True,1,1859
34774,204346135,204346404,True,1,269
34775,204347110,204358467,True,1,11357
34776,204357337,204358416,True,3,1079
34777,204364895,204367336,True,3,2441
34778,204373709,204376812,True,1,3103
34779,204376482,204380746,True,1,4264
34780,204379691,204380104,False,1,413
34781,204383409,204384958,True,1,1549
34782,204388887,204390022,False,1,1135
34783,204388887,204391077,True,2,2190
34784,204393597,204394465,True,1,868
34785,204403514,204404501,True,6,987
34786,204420732,204421481,True,4,749
34787,204436019,204437239,True,1,1220
34788,204436019,204438642,True,1,2623
34789,204436680,204437431,True,1,751
34790,204443431,204443541,False,1,110
34791,204443431,204443541,True,6,110
34792,204445804,204461618,True,1,15814
34793,204455767,204456229,True,1,462
34794,204455767,204460280,True,1,4513
34795,204456391,204457374,True,3,983
34796,204461348,204463335,True,1,1987
34797,204466072,204466816,False,1,744
34798,204467098,204467291,False,1,193
34799,204493954,204494184,True,5,230
34800,204509904,204510614,True,1,710
34801,204531075,204531193,True,4,118
34802,204534505,204534844,False,1,339
34803,204536677,204539323,True,2,2646
34804,204538099,204538412,True,1,313
34805,204538597,204539756,False,3,1159
34806,204538597,204539756,True,3,1159
34807,204542802,204562743,True,2,19941
34808,204552512,204599160,True,5,46648
34809,204555274,204556353,False,1,1079
34810,204555274,204556353,True,2,1079
34811,204567182,204569650,True,1,2468
34812,204572261,204574121,True,1,1860
34813,204581595,204583144,True,1,1549
34814,204591341,204592438,True,1,1097
34815,204591532,204591806,True,1,274
34816,204619959,204633039,False,1,13080
34817,204628763,204629097,True,7,334
34818,204635787,204636148,True,1,361
34819,204643531,204643641,True,1,110
34820,204661677,204661916,True,1,239
34821,204665215,204666027,True,2,812
34822,204673906,204674300,True,2,394
34823,204675227,204696177,False,1,20950
34824,204682371,204684905,True,1,2534
34825,204686521,204688613,True,1,2092
34826,204696999,204697232,False,1,233
34827,204697105,204698089,True,1,984
34828,204748327,204753870,False,1,5543
34829,204748521,204752164,True,2,3643
34830,204764672,204765444,True,1,772
34831,204779262,204781535,False,1,2273
34832,204779262,204787697,True,1,8435
34833,204779500,204781554,False,1,2054
34834,204779503,204781535,True,1,2032
34835,204782773,204785207,True,1,2434
34836,204790803,204793261,True,1,2458
34837,204796119,204796202,True,1,83
34838,204813686,204826466,True,1,12780
34839,204814419,204853217,True,1,38798
34840,204827540,204854083,True,1,26543
34841,204845579,204853946,True,2,8367
34842,204845579,204861946,True,1,16367
34843,204862148,204872911,True,1,10763
34844,204883671,204887744,True,1,4073
34845,204895722,204897333,True,1,1611
34846,204907285,204915792,False,1,8507
34847,204907285,204915792,True,4,8507
34848,204912149,204920965,False,1,8816
34849,204912149,204920965,True,1,8816
34850,204912149,204928391,True,1,16242
34851,204921335,204932999,True,1,11664
34852,204930416,204934164,True,1,3748
34853,204936217,204936749,True,1,532
34854,204940185,204940627,True,1,442
34855,204940185,204941094,True,1,909
34856,204942051,204950312,True,1,8261
34857,204952523,204957587,True,1,5064
34858,204962889,204964279,True,1,1390
34859,204963110,204963632,True,1,522
34860,204990535,204990773,False,1,238
34861,205002859,205007286,False,3,4427
34862,205002859,205007286,True,2,4427
34863,205002859,205013812,False,1,10953
34864,205007774,205012632,True,1,4858
34865,205009684,205060134,True,3,50450
34866,205011527,205014968,True,5,3441
34867,205011527,205014971,True,1,3444
34868,205012698,205013962,False,1,1264
34869,205016867,205017453,True,1,586
34870,205016867,205017926,True,1,1059
34871,205018279,205019057,True,1,778
34872,205023652,205024184,True,1,532
34873,205026977,205027215,False,2,238
34874,205028019,205031617,True,7,3598
34875,205028431,205031824,True,1,3393
34876,205028953,205029616,False,1,663
34877,205034527,205035207,True,1,680
34878,205034709,205035207,False,1,498
34879,205034709,205035231,False,1,522
34880,205035482,205059669,True,2,24187
34881,205035482,205065308,True,1,29826
34882,205035482,205107390,True,1,71908
34883,205058135,205058818,True,1,683
34884,205095232,205095520,True,2,288
34885,205098640,205098882,True,1,242
34886,205099009,205099251,True,1,242
34887,205106935,205127562,True,2,20627
34888,205125155,205126081,True,1,926
34889,205129182,205129557,True,4,375
34890,205166713,205167008,True,3,295
34891,205168825,205172075,True,3,3250
34892,205170345,205170962,True,1,617
34893,205180715,205180985,True,1,270
34894,205189038,205196048,True,1,7010
34895,205190616,205196731,True,1,6115
34896,205208091,205212446,False,1,4355
34897,205212697,205265986,True,1,53289
34898,205212697,205267461,True,4,54764
34899,205212697,205281126,True,2,68429
34900,205212733,205267461,True,1,54728
34901,205216778,205233280,True,2,16502
34902,205222913,205223388,True,2,475
34903,205222913,205223920,True,1,1007
34904,205222913,205223923,True,1,1010
34905,205231001,205240398,True,1,9397
34906,205245797,205246969,False,1,1172
34907,205250080,205251158,True,1,1078
34908,205262808,205263221,True,2,413
34909,205282856,205283973,True,1,1117
34910,205297576,205305759,False,1,8183
34911,205309201,205318280,False,1,9079
34912,205321892,205322072,True,2,180
34913,205337902,205346372,False,1,8470
34914,205337902,205346372,True,2,8470
34915,205345332,205348079,True,3,2747
34916,205353383,205354465,True,1,1082
34917,205355103,205368517,False,1,13414
34918,205373828,205457234,True,1,83406
34919,205381964,205382263,False,1,299
34920,205390860,205390949,False,3,89
34921,205390860,205390949,True,3,89
34922,205400403,205403786,True,8,3383
34923,205413484,205414554,True,1,1070
34924,205423870,205462726,True,1,38856
34925,205423870,205487953,True,1,64083
34926,205431185,205431549,True,2,364
34927,205431185,205439454,True,4,8269
34928,205458637,205461573,True,1,2936
34929,205458960,205461563,False,1,2603
34930,205465078,205465169,True,2,91
34931,205467394,205468338,True,1,944
34932,205470077,205485945,True,1,15868
34933,205476707,205481088,True,2,4381
34934,205482009,205483841,False,1,1832
34935,205482433,205484643,False,1,2210
34936,205482433,205484643,True,2,2210
34937,205483591,205483891,True,1,300
34938,205484023,205495527,True,2,11504
34939,205486457,205488709,False,1,2252
34940,205486457,205488709,True,1,2252
34941,205492354,205492529,True,1,175
34942,205492758,205492871,True,1,113
34943,205494662,205496691,True,2,2029
34944,205496502,205496691,False,1,189
34945,205496502,205496691,True,2,189
34946,205510434,205526980,True,1,16546
34947,205513854,205519115,True,1,5261
34948,205516307,205520392,True,1,4085
34949,205518725,205529644,True,1,10919
34950,205519316,205521859,True,1,2543
34951,205521935,205522494,True,1,559
34952,205524956,205525515,False,1,559
34953,205536046,205536444,True,1,398
34954,205536491,205556508,True,1,20017
34955,205540877,205544577,True,1,3700
34956,205542313,205542475,True,1,162
34957,205554460,205554942,True,1,482
34958,205567716,205576033,True,1,8317
34959,205571489,205577954,True,1,6465
34960,205572477,205578407,False,1,5930
34961,205572477,205578407,True,1,5930
34962,205582286,205583064,True,1,778
34963,205584309,205586517,True,1,2208
34964,205585545,205590278,True,1,4733
34965,205585545,205593210,True,1,7665
34966,205585988,205601375,True,1,15387
34967,205585988,205602929,True,2,16941
34968,205596141,205598847,True,1,2706
34969,205603444,205606420,True,1,2976
34970,205606978,205607746,True,1,768
34971,205607007,205607779,True,1,772
34972,205618018,205618925,False,1,907
34973,205623234,205624738,True,1,1504
34974,205628815,205630093,True,1,1278
34975,205629711,205630869,True,2,1158
34976,205629711,205636718,True,1,7007
34977,205631319,205639908,False,2,8589
34978,205631319,205641344,True,1,10025
34979,205642870,205643295,False,1,425
34980,205642870,205643295,True,1,425
34981,205645119,205646275,True,1,1156
34982,205652360,205653058,True,1,698
34983,205658752,205672284,True,4,13532
34984,205680970,205681563,True,2,593
34985,205681029,205681563,True,1,534
34986,205699536,205735792,True,1,36256
34987,205723199,205728279,True,7,5080
34988,205725819,205726363,True,1,544
34989,205725831,205726363,True,1,532
34990,205767368,205768067,True,1,699
34991,205767844,205768311,True,2,467
34992,205771227,205772471,True,2,1244
34993,205782926,205784990,True,2,2064
34994,205791056,205793507,True,1,2451
34995,205829612,205831597,True,2,1985
34996,205854555,205856414,True,2,1859
34997,205856044,205882535,True,1,26491
34998,205856044,205883400,True,1,27356
34999,205856044,205907052,True,1,51008
35000,205862404,205863850,True,13,1446
35001,205862404,205870032,True,2,7628
35002,205862404,205870522,True,2,8118
35003,205875877,205876885,True,3,1008
35004,205876302,205876915,True,1,613
35005,205881371,205884904,True,1,3533
35006,205884625,205885089,False,1,464
35007,205891059,205951127,False,1,60068
35008,205891059,205963462,False,1,72403
35009,205906010,205906312,True,4,302
35010,205907513,205908290,True,1,777
35011,205924713,205930717,True,1,6004
35012,205928154,205928971,False,1,817
35013,205931840,205932998,True,1,1158
35014,205947476,205948007,True,3,531
35015,205947700,205950579,True,1,2879
35016,205953946,205957897,True,1,3951
35017,205958270,205963375,True,3,5105
35018,205958270,205967503,True,1,9233
35019,205960657,205964423,True,3,3766
35020,205974279,205974978,True,1,699
35021,205976198,205982336,True,3,6138
35022,205978921,205981359,True,1,2438
35023,205986549,206010429,True,1,23880
35024,205986549,206022629,True,1,36080
35025,205986549,206031553,True,1,45004
35026,206026901,206033199,False,1,6298
35027,206029693,206031907,False,3,2214
35028,206029693,206031907,True,2,2214
35029,206063013,206063217,True,1,204
35030,206063084,206077683,False,1,14599
35031,206063680,206072262,True,2,8582
35032,206063707,206072454,True,1,8747
35033,206070653,206071272,True,1,619
35034,206072277,206075656,True,1,3379
35035,206072322,206076596,True,1,4274
35036,206082199,206082430,True,1,231
35037,206118519,206118596,True,1,77
35038,206128942,206130268,True,3,1326
35039,206158010,206159187,True,1,1177
35040,206180235,206185057,True,1,4822
35041,206184296,206194382,True,1,10086
35042,206225585,206225677,True,1,92
35043,206225585,206231064,True,1,5479
35044,206225585,206235548,True,1,9963
35045,206227774,206303889,True,2,76115
35046,206227774,206335525,True,1,107751
35047,206227774,206352912,False,1,125138
35048,206231205,206231619,False,2,414
35049,206345047,206345229,False,1,182
35050,206346784,206352807,True,1,6023
35051,206347353,206359066,False,1,11713
35052,206347353,206390070,False,1,42717
35053,206367170,206371465,True,3,4295
35054,206379169,206393680,True,2,14511
35055,206379562,206393896,True,1,14334
35056,206383739,206395981,True,1,12242
35057,206408825,206410595,False,1,1770
35058,206408825,206465232,True,1,56407
35059,206409454,206410704,False,1,1250
35060,206433889,206435670,True,1,1781
35061,206436108,206436318,False,1,210
35062,206436354,206436464,False,1,110
35063,206437241,206441730,True,3,4489
35064,206440066,206444555,False,1,4489
35065,206440066,206444555,True,1,4489
35066,206440066,206470606,False,1,30540
35067,206461380,206461800,False,1,420
35068,206465099,206466279,True,1,1180
35069,206471541,206496564,True,1,25023
35070,206472761,206510186,True,1,37425
35071,206487827,206540484,True,2,52657
35072,206487827,206580335,True,2,92508
35073,206497573,206508835,True,1,11262
35074,206498838,206506426,True,1,7588
35075,206512185,206519861,False,1,7676
35076,206531243,206534359,True,3,3116
35077,206531753,206532978,True,1,1225
35078,206589486,206589908,True,1,422
35079,206630632,206631463,False,1,831
35080,206660911,206670318,True,1,9407
35081,206669331,206673822,False,1,4491
35082,206669331,206673822,True,2,4491
35083,206676871,206677384,True,1,513
35084,206678212,206678641,False,1,429
35085,206678212,206678641,True,11,429
35086,206681168,206688380,True,1,7212
35087,206685743,206687259,True,5,1516
35088,206686284,206687203,True,1,919
35089,206693868,206745454,True,1,51586
35090,206696245,206702501,True,1,6256
35091,206701934,206703491,False,1,1557
35092,206704231,206704589,True,1,358
35093,206706865,206728239,True,1,21374
35094,206706865,206732437,True,1,25572
35095,206714798,206714990,False,1,192
35096,206714798,206714990,True,1,192
35097,206741587,206741803,True,1,216
35098,206757297,206757533,True,1,236
35099,206778060,206779038,True,1,978
35100,206779424,206779528,True,1,104
35101,206784454,206792474,True,1,8020
35102,206798895,206803154,True,1,4259
35103,206821051,206822224,True,1,1173
35104,206822818,206831457,True,1,8639
35105,206828683,206845429,True,1,16746
35106,206837392,206838083,True,2,691
35107,206845430,206869152,True,2,23722
35108,206861642,206861885,True,1,243
35109,206873492,206875210,True,2,1718
35110,206903269,206909053,True,1,5784
35111,206903269,206920174,True,1,16905
35112,206919590,206928271,True,2,8681
35113,206946218,206946827,True,1,609
35114,206990295,206992180,True,1,1885
35115,206996894,207002656,True,2,5762
35116,206999066,207000560,True,1,1494
35117,207009110,207010572,False,1,1462
35118,207009110,207011103,True,1,1993
35119,207060262,207061104,True,6,842
35120,207065010,207065884,False,1,874
35121,207082470,207082563,True,1,93
35122,207090543,207091318,False,1,775
35123,207090543,207091318,True,3,775
35124,207106080,207108585,True,2,2505
35125,207114713,207115399,True,1,686
35126,207117810,207118595,True,1,785
35127,207128122,207136525,True,1,8403
35128,207131701,207133286,False,1,1585
35129,207133430,207134933,True,1,1503
35130,207157829,207166439,False,1,8610
35131,207172887,207173174,False,1,287
35132,207172887,207173174,True,11,287
35133,207174905,207175041,True,2,136
35134,207179598,207182423,False,1,2825
35135,207185692,207186003,True,1,311
35136,207185692,207189000,True,1,3308
35137,207187307,207189678,True,1,2371
35138,207198295,207198783,True,1,488
35139,207212732,207214886,False,1,2154
35140,207212732,207214886,True,1,2154
35141,207263048,207288470,False,1,25422
35142,207292237,207376472,False,1,84235
35143,207308164,207308269,False,1,105
35144,207323623,207324379,False,1,756
35145,207323623,207324379,True,2,756
35146,207323623,207325394,True,1,1771
35147,207392069,207395482,True,3,3413
35148,207394957,207397984,True,1,3027
35149,207435749,207437215,True,1,1466
35150,207435749,207437694,True,8,1945
35151,207498632,207513769,False,1,15137
35152,207534127,207544013,True,2,9886
35153,207558460,207575551,True,2,17091
35154,207578707,207581986,True,1,3279
35155,207580478,207596505,True,1,16027
35156,207582414,207738760,True,1,156346
35157,207582414,207823190,True,1,240776
35158,207600935,207601062,True,1,127
35159,207600935,207602326,True,1,1391
35160,207602719,207603185,True,1,466
35161,207603554,207603656,True,1,102
35162,207612650,207617940,False,1,5290
35163,207612689,207632873,True,2,20184
35164,207617596,207633012,True,1,15416
35165,207622727,207714569,True,1,91842
35166,207639830,207640209,False,1,379
35167,207644573,207648753,True,2,4180
35168,207679441,207680033,True,2,592
35169,207704117,207723111,True,6,18994
35170,207735404,207736108,True,2,704
35171,207737115,207737320,True,1,205
35172,207785764,207790391,True,3,4627
35173,207800617,207801656,False,1,1039
35174,207806997,207849546,False,1,42549
35175,207824219,207828706,True,4,4487
35176,207824219,207830880,True,1,6661
35177,207864016,207864193,True,1,177
35178,207864023,207864200,True,1,177
35179,207882876,207888051,True,1,5175
35180,207882932,207888909,True,1,5977
35181,207882932,207894241,True,1,11309
35182,207883274,207884015,False,1,741
35183,207894399,207896553,True,2,2154
35184,207894853,207895046,True,1,193
35185,207895272,207900379,True,1,5107
35186,207932741,207935421,True,1,2680
35187,207938775,208346223,True,2,407448
35188,207939924,207941142,True,1,1218
35189,207962403,207965741,True,1,3338
35190,207972373,207972451,True,1,78
35191,207972548,207973523,True,1,975
35192,207980803,207981288,True,1,485
35193,207991106,207991793,True,1,687
35194,207991106,207994425,True,1,3319
35195,207999693,208002017,True,1,2324
35196,208010792,208023938,True,4,13146
35197,208050409,208051128,True,1,719
35198,208050409,208051315,True,1,906
35199,208050409,208051831,True,1,1422
35200,208054435,208056920,True,2,2485
35201,208058759,208067256,True,2,8497
35202,208064302,208080336,True,1,16034
35203,208066700,208086271,True,1,19571
35204,208066700,208086314,True,1,19614
35205,208066700,208087813,True,1,21113
35206,208066700,208094386,True,1,27686
35207,208119113,208120918,False,1,1805
35208,208137461,208138892,True,3,1431
35209,208157563,208158709,True,1,1146
35210,208191355,208216423,True,4,25068
35211,208193626,208203950,True,1,10324
35212,208212365,208213563,False,1,1198
35213,208226726,208227064,True,1,338
35214,208236224,208238172,False,1,1948
35215,208247995,208253098,True,2,5103
35216,208266700,208278078,False,1,11378
35217,208284118,208285775,False,4,1657
35218,208284118,208285775,True,2,1657
35219,208290787,208298670,True,1,7883
35220,208297636,208297885,False,1,249
35221,208302890,208303978,True,1,1088
35222,208305380,208313029,True,1,7649
35223,208306205,208378065,True,1,71860
35224,208306205,208393135,True,1,86930
35225,208308223,208309509,True,1,1286
35226,208308867,208309979,True,1,1112
35227,208310979,208311069,True,2,90
35228,208311168,208311439,True,1,271
35229,208320228,208320572,True,2,344
35230,208322606,208322810,True,1,204
35231,208322606,208323299,True,1,693
35232,208322606,208323341,True,3,735
35233,208322606,208323344,True,1,738
35234,208325560,208325970,True,4,410
35235,208329307,208329421,True,4,114
35236,208337939,208340156,True,1,2217
35237,208353019,208354597,True,1,1578
35238,208356260,208361898,False,1,5638
35239,208356260,208424242,False,1,67982
35240,208358149,208358644,True,1,495
35241,208359821,208360572,True,1,751
35242,208360509,208360679,True,1,170
35243,208364396,208375207,True,2,10811
35244,208366330,208366413,False,1,83
35245,208366330,208366413,True,1,83
35246,208367027,208369964,True,1,2937
35247,208396448,208397045,True,1,597
35248,208396851,208397206,True,1,355
35249,208396866,208397085,False,1,219
35250,208401619,208402425,False,1,806
35251,208401619,208402425,True,1,806
35252,208413090,208414285,True,1,1195
35253,208419352,208419515,False,1,163
35254,208419352,208419515,True,1,163
35255,208420497,208420734,True,1,237
35256,208442376,208446906,True,4,4530
35257,208451380,208465773,False,1,14393
35258,208455889,208456422,True,1,533
35259,208460299,208461617,True,2,1318
35260,208475723,208475813,True,1,90
35261,208475723,208488412,True,1,12689
35262,208477058,208486836,True,1,9778
35263,208479707,208479872,True,3,165
35264,208514884,208515696,True,1,812
35265,208527809,208532642,True,3,4833
35266,208584724,208585322,True,1,598
35267,208585127,208585483,True,1,356
35268,208592328,208593810,True,1,1482
35269,208617665,208631462,True,1,13797
35270,208621458,208622842,True,1,1384
35271,208622281,208623240,True,3,959
35272,208624695,208632160,True,1,7465
35273,208628137,208634688,False,1,6551
35274,208648453,208649408,True,3,955
35275,208667428,208671681,True,2,4253
35276,208678107,208679457,True,1,1350
35277,208689388,208691170,False,1,1782
35278,208689388,208694387,True,1,4999
35279,208712974,208713160,False,1,186
35280,208713047,208713339,False,1,292
35281,208713047,208713342,False,1,295
35282,208719430,208726328,True,1,6898
35283,208719430,208730286,True,2,10856
35284,208719430,208733199,True,1,13769
35285,208747458,208748277,True,1,819
35286,208757655,208758920,True,2,1265
35287,208759167,208759660,True,1,493
35288,208759167,208760247,True,1,1080
35289,208766119,208769932,True,2,3813
35290,208767776,208771706,True,2,3930
35291,208769547,208772624,True,1,3077
35292,208789877,208816815,True,1,26938
35293,208809195,208818659,True,1,9464
35294,208814202,208814494,True,1,292
35295,208823639,208824607,True,3,968
35296,208854685,208859431,True,1,4746
35297,208854685,208865223,True,1,10538
35298,208870181,208879054,True,1,8873
35299,208873835,208878601,True,1,4766
35300,208874349,208877216,False,1,2867
35301,208879962,208882730,False,1,2768
35302,208916736,208918178,False,1,1442
35303,208916736,208918178,True,1,1442
35304,208927885,208927892,True,1,7
35305,208928052,208928255,True,1,203
35306,208948735,208958988,False,1,10253
35307,208948735,208960664,True,1,11929
35308,209007626,209061474,False,1,53848
35309,209007626,209061474,True,1,53848
35310,209021775,209023266,True,1,1491
35311,209024404,209025033,True,1,629
35312,209026265,209222287,True,1,196022
35313,209031771,209034070,True,1,2299
35314,209050525,209054133,False,1,3608
35315,209071585,209087435,False,1,15850
35316,209072061,209093635,True,1,21574
35317,209104211,209110990,True,3,6779
35318,209163844,209184081,False,1,20237
35319,209181029,209181550,True,1,521
35320,209210160,209210437,True,1,277
35321,209213177,209225079,True,1,11902
35322,209219227,209254859,True,1,35632
35323,209228150,209234053,True,3,5903
35324,209232170,209235009,False,1,2839
35325,209258559,209258769,True,2,210
35326,209309574,209335920,True,1,26346
35327,209309618,209333207,True,3,23589
35328,209309618,209335920,True,1,26302
35329,209357932,209365174,True,1,7242
35330,209357932,209487536,True,2,129604
35331,209361346,209363166,True,2,1820
35332,209361346,209385525,True,1,24179
35333,209361583,209363166,True,1,1583
35334,209361583,209385525,True,1,23942
35335,209361668,209363166,True,1,1498
35336,209362755,209383894,True,1,21139
35337,209365477,209387725,False,1,22248
35338,209369663,209389847,False,1,20184
35339,209407499,209408688,True,1,1189
35340,209430351,209431577,False,1,1226
35341,209435629,209437040,True,1,1411
35342,209483907,209484202,False,1,295
35343,209496180,209496797,False,1,617
35344,209496180,209497195,True,1,1015
35345,209499063,209500113,True,1,1050
35346,209511665,209513527,False,1,1862
35347,209513273,209513862,True,1,589
35348,209514958,209515340,False,1,382
35349,209514958,209515340,True,3,382
35350,209514958,209518518,True,4,3560
35351,209515289,209523513,True,3,8224
35352,209544658,209546391,False,2,1733
35353,209544661,209546391,False,1,1730
35354,209547001,209555903,True,1,8902
35355,209627293,209629066,True,2,1773
35356,209631052,209633282,True,1,2230
35357,209640050,209641196,True,1,1146
35358,209644855,209647595,True,1,2740
35359,209663272,209728939,True,3,65667
35360,209697438,209698139,True,4,701
35361,209701983,209846373,True,1,144390
35362,209701998,209846373,True,1,144375
35363,209730040,209731431,True,6,1391
35364,209785561,209790168,True,1,4607
35365,209792563,209793187,True,6,624
35366,209793319,209793803,True,2,484
35367,209794825,209796996,True,1,2171
35368,209794992,209797121,True,1,2129
35369,209803175,209804957,True,1,1782
35370,209824498,209826260,True,1,1762
35371,209824498,209827169,True,1,2671
35372,209848680,209852001,True,1,3321
35373,209855544,209856362,True,2,818
35374,209873859,209878216,False,1,4357
35375,209917750,209994459,False,1,76709
35376,209926506,209933283,True,1,6777
35377,209991504,210005588,True,1,14084
35378,210017272,210017984,True,1,712
35379,210074952,210076616,True,1,1664
35380,210074952,210083709,True,1,8757
35381,210092395,210098805,True,2,6410
35382,210101785,210173126,False,1,71341
35383,210105629,210106835,True,1,1206
35384,210121999,210123744,True,1,1745
35385,210126270,210136493,False,2,10223
35386,210126270,210136493,True,2,10223
35387,210133430,210141580,True,2,8150
35388,210171881,210324465,True,4,152584
35389,210194457,210195207,True,1,750
35390,210195332,210196572,True,3,1240
35391,210256028,210260836,True,2,4808
35392,210297731,210300754,True,3,3023
35393,210312018,210323634,True,3,11616
35394,210312898,210314582,True,1,1684
35395,210316510,210317835,True,1,1325
35396,210345335,210345800,True,2,465
35397,210347928,210348360,False,1,432
35398,210353606,210354143,True,5,537
35399,210381332,210391888,True,1,10556
35400,210385180,210386018,True,1,838
35401,210392777,210397582,False,1,4805
35402,210392777,210397582,True,1,4805
35403,210396389,210435522,True,1,39133
35404,210411473,210413491,True,1,2018
35405,210413867,210415684,True,2,1817
35406,210413867,210415697,True,1,1830
35407,210414708,210416419,True,1,1711
35408,210419427,210419708,True,1,281
35409,210428647,210431095,True,1,2448
35410,210439125,210441434,True,3,2309
35411,210439125,210442408,True,1,3283
35412,210466021,210468609,True,1,2588
35413,210472443,210472766,False,1,323
35414,210472443,210472766,True,6,323
35415,210493557,210496194,True,1,2637
35416,210493560,210496194,True,1,2634
35417,210504980,210505951,True,1,971
35418,210507963,210584361,True,1,76398
35419,210509183,210512157,True,1,2974
35420,210509183,210514565,True,1,5382
35421,210521414,210539444,False,1,18030
35422,210527624,210529436,True,1,1812
35423,210533969,210534448,True,1,479
35424,210554883,210555413,True,2,530
35425,210557985,210559035,True,1,1050
35426,210566852,210588795,True,1,21943
35427,210630306,210645763,True,1,15457
35428,210663499,210666408,True,1,2909
35429,210663499,210674240,True,1,10741
35430,210696980,210719620,True,1,22640
35431,210704113,210712790,True,2,8677
35432,210710475,210713691,True,1,3216
35433,210717329,210719336,True,5,2007
35434,210726703,210728872,False,2,2169
35435,210755181,210766183,True,3,11002
35436,210760342,210762040,True,1,1698
35437,210768725,210772219,False,1,3494
35438,210782513,210784624,True,1,2111
35439,210782513,210784662,True,1,2149
35440,210782985,210801361,True,1,18376
35441,210782985,210805123,False,1,22138
35442,210783722,210785061,True,1,1339
35443,210786282,210797750,True,1,11468
35444,210800294,210800406,True,1,112
35445,210800502,210804002,True,1,3500
35446,210802544,210829683,True,1,27139
35447,210810057,210810894,True,1,837
35448,210810485,210810798,True,1,313
35449,210812134,210880144,True,1,68010
35450,210824338,210976287,False,1,151949
35451,210824715,210827300,True,2,2585
35452,210824726,210824882,True,2,156
35453,210831818,210833882,False,1,2064
35454,210831818,210833882,True,2,2064
35455,210846183,210850771,False,1,4588
35456,210877984,210881758,False,1,3774
35457,210905806,210907893,False,2,2087
35458,210905806,210907893,True,1,2087
35459,210952879,210953404,True,1,525
35460,210954181,210963243,True,1,9062
35461,210961954,210962432,True,4,478
35462,210963222,210964411,True,2,1189
35463,210966804,210970656,True,1,3852
35464,211003130,211006392,True,2,3262
35465,211005225,211008761,True,3,3536
35466,211013390,211016074,False,1,2684
35467,211016344,211017099,True,1,755
35468,211034175,211036004,True,1,1829
35469,211034175,211037458,True,1,3283
35470,211034175,211039238,True,1,5063
35471,211034969,211068727,True,1,33758
35472,211037784,211117527,True,1,79743
35473,211044226,211045225,False,1,999
35474,211093786,211108257,True,3,14471
35475,211135300,211136885,True,4,1585
35476,211141927,211152936,True,1,11009
35477,211171359,211180710,True,1,9351
35478,211207466,211218944,False,1,11478
35479,211207466,211218944,True,1,11478
35480,211207466,211218983,True,1,11517
35481,211207466,211225068,True,1,17602
35482,211212400,211213358,False,1,958
35483,211212400,211213358,True,1,958
35484,211216824,211217134,True,3,310
35485,211278871,211279089,False,1,218
35486,211278871,211282142,True,1,3271
35487,211279916,211286145,True,2,6229
35488,211283963,211286849,True,1,2886
35489,211309167,211320109,True,1,10942
35490,211351761,211368203,False,1,16442
35491,211351761,211368214,False,1,16453
35492,211352547,211353079,True,7,532
35493,211355959,211361337,True,1,5378
35494,211386067,211388125,False,1,2058
35495,211429775,211429995,True,1,220
35496,211445408,211461578,True,1,16170
35497,211449128,211466791,False,1,17663
35498,211449128,211466791,True,1,17663
35499,211451754,211455060,True,1,3306
35500,211455122,211477900,True,2,22778
35501,211463198,211464206,True,2,1008
35502,211515271,211521450,True,1,6179
35503,211534485,211581997,True,1,47512
35504,211562125,211595579,True,2,33454
35505,211582396,211583005,False,1,609
35506,211583093,211583475,True,1,382
35507,211609142,211620635,False,1,11493
35508,211609142,211641119,False,1,31977
35509,211625681,211626464,True,1,783
35510,211646520,211647138,True,1,618
35511,211711112,211721038,True,3,9926
35512,211729891,211730556,True,1,665
35513,211759465,211759809,True,2,344
35514,211763727,211764536,True,2,809
35515,211763882,211764649,True,1,767
35516,211764790,211765416,True,1,626
35517,211767555,211769266,True,3,1711
35518,211772585,211791192,True,3,18607
35519,211779708,211780732,True,2,1024
35520,211780370,211782192,True,1,1822
35521,211802495,211804178,True,1,1683
35522,211807666,211812511,True,1,4845
35523,211808350,211809396,False,1,1046
35524,211810084,211816761,True,2,6677
35525,211847006,211851414,True,2,4408
35526,211847006,211869861,True,1,22855
35527,211849315,211851299,True,1,1984
35528,211854688,211855693,True,1,1005
35529,211874705,211953208,True,1,78503
35530,211878655,211878670,True,1,15
35531,211878655,211883875,False,1,5220
35532,211879123,211883875,True,1,4752
35533,211879246,211884182,True,1,4936
35534,211882353,211885712,False,1,3359
35535,211882353,211885712,True,1,3359
35536,211882353,211885896,False,1,3543
35537,211882353,211886571,True,1,4218
35538,211885274,211886796,False,1,1522
35539,211887520,211888183,False,1,663
35540,211896911,211898483,False,1,1572
35541,211896911,211898483,True,1,1572
35542,211906023,211908860,True,1,2837
35543,211906565,211906790,True,1,225
35544,211908155,211910050,True,2,1895
35545,211912513,211913507,True,1,994
35546,211913093,211913835,True,1,742
35547,211915444,211915542,True,3,98
35548,211917089,211918613,True,1,1524
35549,211922681,211923317,True,1,636
35550,211926748,211928906,True,1,2158
35551,211940520,211986034,True,1,45514
35552,211955173,211957022,False,1,1849
35553,211955173,211957022,True,9,1849
35554,211978193,211990819,True,1,12626
35555,211985942,211988009,True,1,2067
35556,211988538,212047239,False,1,58701
35557,211997047,211997495,False,1,448
35558,212028208,212028870,True,1,662
35559,212029187,212029386,True,2,199
35560,212057657,212063071,True,2,5414
35561,212069149,212069424,True,1,275
35562,212069978,212072536,True,3,2558
35563,212092131,212107809,True,3,15678
35564,212106892,212107113,False,1,221
35565,212106892,212107113,True,1,221
35566,212116116,212293558,True,1,177442
35567,212128138,212128221,False,1,83
35568,212128540,212130632,False,1,2092
35569,212133011,212133093,True,2,82
35570,212134274,212178546,True,1,44272
35571,212135977,212179356,True,2,43379
35572,212135977,212222893,True,1,86916
35573,212145275,212158074,True,1,12799
35574,212145275,212162547,True,1,17272
35575,212145275,212167455,True,1,22180
35576,212212700,212212807,False,1,107
35577,212224342,212226051,False,1,1709
35578,212227185,212231618,True,1,4433
35579,212236624,212236778,False,1,154
35580,212236624,212236778,True,1,154
35581,212237044,212237763,True,1,719
35582,212237245,212237918,True,1,673
35583,212237245,212237964,False,2,719
35584,212238891,212239358,False,1,467
35585,212241739,212244261,False,1,2522
35586,212244371,212245649,False,1,1278
35587,212260681,212261625,False,1,944
35588,212269359,212269455,True,1,96
35589,212272068,212274079,False,1,2011
35590,212287127,212314672,True,1,27545
35591,212287430,212287994,True,1,564
35592,212287430,212289653,True,1,2223
35593,212290953,212291556,False,1,603
35594,212313561,212319042,False,1,5481
35595,212323288,212332868,True,1,9580
35596,212327386,212334884,True,1,7498
35597,212340723,212341002,False,1,279
35598,212368825,212369129,True,1,304
35599,212368825,212369167,True,2,342
35600,212371600,212371683,False,1,83
35601,212406861,212409077,True,1,2216
35602,212418520,212422774,False,1,4254
35603,212419870,212423051,False,1,3181
35604,212462592,212462699,False,1,107
35605,212463174,212464988,True,1,1814
35606,212581143,212582225,True,5,1082
35607,212606591,212606874,True,1,283
35608,212609412,212611348,True,2,1936
35609,212611673,212611882,True,2,209
35610,212614105,212615901,True,1,1796
35611,212620455,212622015,True,1,1560
35612,212653247,212654112,False,1,865
35613,212653898,212672144,True,1,18246
35614,212662355,212762516,True,1,100161
35615,212712034,212742899,True,2,30865
35616,212718483,212718664,False,1,181
35617,212723114,212794404,True,2,71290
35618,212734218,212757627,False,1,23409
35619,212734218,212757627,True,1,23409
35620,212749526,212761635,False,1,12109
35621,212768513,212770844,False,1,2331
35622,212802570,213003406,True,1,200836
35623,212849256,212849570,False,1,314
35624,212872901,212873598,True,1,697
35625,212899781,212900237,True,1,456
35626,212899781,212905962,True,1,6181
35627,212918857,212921674,True,1,2817
35628,212936556,212939705,True,1,3149
35629,212947894,212984179,True,2,36285
35630,212965551,212967204,False,1,1653
35631,213011517,213013715,True,1,2198
35632,213011611,213013733,True,1,2122
35633,213012144,213013916,True,1,1772
35634,213068664,213070268,True,1,1604
35635,213093705,213093909,True,1,204
35636,213103219,213123973,True,3,20754
35637,213113286,213113977,False,1,691
35638,213153884,213161648,False,1,7764
35639,213208258,213211631,True,2,3373
35640,213260113,213268688,True,3,8575
35641,213260113,213277674,True,1,17561
35642,213263989,213270717,True,1,6728
35643,213265785,213272803,True,1,7018
35644,213266902,213282196,False,2,15294
35645,213266902,213282196,True,5,15294
35646,213364411,213370410,True,1,5999
35647,213370836,213395901,True,1,25065
35648,213393299,213401397,True,3,8098
35649,213395279,213402087,False,1,6808
35650,213406280,213504061,True,1,97781
35651,213420371,213422930,True,5,2559
35652,213429666,213435523,True,1,5857
35653,213434680,213438354,True,1,3674
35654,213488829,213488931,False,1,102
35655,213503164,213509081,True,1,5917
35656,213503859,213509505,True,1,5646
35657,213525886,213768864,True,1,242978
35658,213609099,213609685,False,1,586
35659,213618877,213629727,True,1,10850
35660,213619089,213629781,True,1,10692
35661,213620792,213625108,True,1,4316
35662,213633476,213635652,True,5,2176
35663,213640830,213643139,True,2,2309
35664,213657487,213659541,False,1,2054
35665,213659487,213660561,False,1,1074
35666,213686263,213693157,True,2,6894
35667,213699347,213699839,True,1,492
35668,213713298,213714101,True,1,803
35669,213713298,213714118,True,1,820
35670,213713298,213714143,True,1,845
35671,213713305,213714179,True,1,874
35672,213713305,213717301,True,1,3996
35673,213713307,213714143,True,1,836
35674,213713949,213714433,True,1,484
35675,213743633,213754176,True,2,10543
35676,213743633,213760058,True,1,16425
35677,213779327,213781490,False,1,2163
35678,213780511,213784039,False,1,3528
35679,213875348,213897279,False,1,21931
35680,213877098,213883227,False,1,6129
35681,213914430,213915578,True,5,1148
35682,213919472,213924391,False,1,4919
35683,213919472,213970145,False,1,50673
35684,213920218,213926308,True,1,6090
35685,213935069,213983869,True,6,48800
35686,213953825,213979257,True,1,25432
35687,213978178,213978467,True,1,289
35688,213990038,213997487,False,1,7449
35689,213990038,213997487,True,2,7449
35690,213997246,214001303,False,1,4057
35691,214038880,214050103,True,3,11223
35692,214042820,214050673,True,1,7853
35693,214057923,214058123,False,1,200
35694,214069201,214069283,True,1,82
35695,214138743,214152981,True,2,14238
35696,214149470,214150302,False,1,832
35697,214155020,214165662,True,2,10642
35698,214157162,214159136,True,1,1974
35699,214221391,214222316,True,1,925
35700,214287854,214289305,True,1,1451
35701,214299581,214329294,False,1,29713
35702,214331443,214337766,False,2,6323
35703,214337005,214346171,False,1,9166
35704,214337005,214346171,True,3,9166
35705,214392169,214405055,True,1,12886
35706,214392294,214411469,True,1,19175
35707,214394850,214397713,False,2,2863
35708,214394850,214397713,True,1,2863
35709,214408905,214409432,True,2,527
35710,214409055,214409432,False,1,377
35711,214409055,214409432,True,2,377
35712,214409093,214409432,True,1,339
35713,214421400,214423573,True,1,2173
35714,214430831,214570575,True,1,139744
35715,214431092,214432146,True,1,1054
35716,214433260,214435537,False,1,2277
35717,214438240,214440654,False,1,2414
35718,214441167,214441623,True,1,456
35719,214441167,214444746,True,1,3579
35720,214442512,214445528,True,1,3016
35721,214448882,214448990,True,1,108
35722,214473559,214482906,True,1,9347
35723,214474353,214482992,True,1,8639
35724,214475414,214483803,True,1,8389
35725,214483736,214486954,True,3,3218
35726,214518336,214518418,True,1,82
35727,214540538,214548890,False,1,8352
35728,214558939,214567537,True,1,8598
35729,214565000,214654107,True,2,89107
35730,214576608,214589465,True,2,12857
35731,214597611,214599005,False,1,1394
35732,214602379,214603161,True,1,782
35733,214612729,214627219,False,1,14490
35734,214655791,214658348,True,1,2557
35735,214655791,214658427,True,1,2636
35736,214661356,214662254,True,1,898
35737,214664856,214667180,True,1,2324
35738,214664856,214667398,True,1,2542
35739,214667918,214668622,True,1,704
35740,214669964,214704203,False,1,34239
35741,214669964,214704203,True,4,34239
35742,214698881,214710357,True,1,11476
35743,214699386,214700401,True,1,1015
35744,214699386,214710430,True,1,11044
35745,214699407,214700633,True,1,1226
35746,214699407,214710357,True,1,10950
35747,214721820,214725743,True,1,3923
35748,214729677,214743156,True,1,13479
35749,214729677,214794040,True,1,64363
35750,214743617,214749959,True,3,6342
35751,214743880,214750226,True,1,6346
35752,214749393,214755063,True,4,5670
35753,214749393,214769617,False,1,20224
35754,214768899,214773601,True,3,4702
35755,214770921,214771705,True,1,784
35756,214773841,214787028,True,1,13187
35757,214778538,214806137,True,1,27599
35758,214799326,214801526,True,4,2200
35759,214812234,214813933,True,2,1699
35760,214841460,214864575,True,2,23115
35761,214859211,214876051,True,1,16840
35762,214920427,214991320,True,1,70893
35763,214923951,214950645,True,3,26694
35764,214925197,214925515,True,1,318
35765,214949741,214988784,True,3,39043
35766,214987269,214990781,True,1,3512
35767,215020101,215023203,True,3,3102
35768,215023253,215064847,False,2,41594
35769,215053031,215055054,False,1,2023
35770,215053031,215055054,True,1,2023
35771,215062558,215064095,True,1,1537
35772,215063319,215065228,False,1,1909
35773,215063319,215065228,True,4,1909
35774,215090019,215090958,True,1,939
35775,215121374,215121458,False,1,84
35776,215121567,215123029,False,1,1462
35777,215122010,215123472,False,2,1462
35778,215128777,215128918,True,2,141
35779,215156831,215160787,True,1,3956
35780,215171105,215180620,True,1,9515
35781,215200229,215200838,True,1,609
35782,215204204,215244527,True,1,40323
35783,215206857,215208344,True,1,1487
35784,215247799,215269036,True,1,21237
35785,215260764,215321789,True,1,61025
35786,215325242,215335441,True,2,10199
35787,215328618,215333481,True,2,4863
35788,215334374,215336500,True,1,2126
35789,215340431,215361554,True,1,21123
35790,215340448,215361471,True,1,21023
35791,215340448,215421719,False,1,81271
35792,215352335,215357124,True,1,4789
35793,215365449,215373317,True,4,7868
35794,215366509,215466047,True,2,99538
35795,215367310,215374237,True,1,6927
35796,215380101,215381697,False,1,1596
35797,215426048,215626458,True,3,200410
35798,215437982,215441457,True,1,3475
35799,215476871,215488080,True,1,11209
35800,215476871,215490018,True,1,13147
35801,215528079,215530404,True,1,2325
35802,215528079,215532724,True,1,4645
35803,215545452,215553459,True,1,8007
35804,215578662,215579208,False,1,546
35805,215578662,215587976,True,7,9314
35806,215598797,215631946,True,1,33149
35807,215623232,215636175,True,2,12943
35808,215644012,215683808,True,1,39796
35809,215651888,215653433,True,1,1545
35810,215688319,215688658,True,1,339
35811,215690834,215691931,True,1,1097
35812,215691558,215692655,False,1,1097
35813,215759505,215783933,False,1,24428
35814,215759505,215783933,True,1,24428
35815,215761160,215762166,True,2,1006
35816,215800007,215821501,False,1,21494
35817,215875723,215888077,False,3,12354
35818,215875723,215888077,True,1,12354
35819,215875723,215961006,True,1,85283
35820,215949417,215949560,True,1,143
35821,215984662,215994889,True,3,10227
35822,216014113,216068427,True,1,54314
35823,216030838,216044892,True,3,14054
35824,216042972,216068446,True,1,25474
35825,216049892,216052431,True,3,2539
35826,216057343,216057668,True,1,325
35827,216057864,216059723,True,2,1859
35828,216082355,216106309,True,2,23954
35829,216086450,216088843,True,1,2393
35830,216159337,216161812,False,1,2475
35831,216159337,216161812,True,1,2475
35832,216167223,216187314,True,1,20091
35833,216167223,216217345,False,1,50122
35834,216167223,216217545,True,1,50322
35835,216169356,216188454,True,2,19098
35836,216187471,216189067,True,1,1596
35837,216187471,216191878,True,1,4407
35838,216188668,216192575,True,1,3907
35839,216199621,216201655,True,1,2034
35840,216223984,216230491,True,7,6507
35841,216229775,216230448,True,5,673
35842,216236418,216238379,True,1,1961
35843,216254941,216259800,False,1,4859
35844,216254941,216259800,True,1,4859
35845,216278472,216281112,False,1,2640
35846,216316346,216317606,True,2,1260
35847,216316768,216318028,True,1,1260
35848,216335809,216338139,True,1,2330
35849,216350980,216356286,True,1,5306
35850,216359043,216435890,True,1,76847
35851,216382010,216382969,True,2,959
35852,216404219,216407870,False,1,3651
35853,216408219,216408942,True,2,723
35854,216420735,216422347,True,1,1612
35855,216420830,216434113,True,1,13283
35856,216420830,216436829,True,3,15999
35857,216423556,216437570,True,2,14014
35858,216507628,216510371,True,1,2743
35859,216520796,216542135,True,1,21339
35860,216525952,216538156,True,3,12204
35861,216538883,216539796,True,1,913
35862,216559183,216561462,True,1,2279
35863,216574162,216575235,True,2,1073
35864,216593308,216602394,True,1,9086
35865,216617022,216632516,True,1,15494
35866,216617844,216633081,True,1,15237
35867,216640856,216656344,True,2,15488
35868,216640856,216657634,True,2,16778
35869,216643451,216645877,True,1,2426
35870,216653940,216656954,True,1,3014
35871,216670463,216672267,True,1,1804
35872,216670463,216672545,True,1,2082
35873,216670733,216672267,True,1,1534
35874,216670733,216672545,True,1,1812
35875,216674643,216696102,True,1,21459
35876,216677429,216677545,True,1,116
35877,216677652,216695527,True,1,17875
35878,216688511,216691164,True,2,2653
35879,216707536,216709178,True,1,1642
35880,216726143,216726444,False,1,301
35881,216728656,216733067,True,1,4411
35882,216761759,216765117,True,3,3358
35883,216880160,216881642,False,2,1482
35884,216881166,216927456,False,1,46290
35885,216886928,216896443,True,1,9515
35886,216889818,216922243,False,1,32425
35887,216907899,216908614,True,1,715
35888,216913858,216924681,True,2,10823
35889,216919159,216919503,False,1,344
35890,216949237,216949838,True,1,601
35891,216975208,216979874,True,1,4666
35892,217014190,217043189,False,1,28999
35893,217047213,217112567,True,1,65354
35894,217048343,217048520,True,1,177
35895,217051193,217086756,True,1,35563
35896,217066174,217068416,False,1,2242
35897,217066174,217068416,True,2,2242
35898,217070364,217087606,True,1,17242
35899,217071881,217080007,True,2,8126
35900,217083411,217091145,True,1,7734
35901,217083411,217099409,True,1,15998
35902,217149428,217150495,False,1,1067
35903,217206213,217207553,True,2,1340
35904,217206213,217207556,True,1,1343
35905,217206213,217211554,True,1,5341
35906,217232362,217235259,False,1,2897
35907,217232362,217235259,True,1,2897
35908,217232519,217261124,True,1,28605
35909,217237152,217239280,True,1,2128
35910,217238341,217238432,True,1,91
35911,217253697,217261573,True,1,7876
35912,217253697,217261613,True,1,7916
35913,217343466,217350298,True,1,6832
35914,217355053,217359345,True,2,4292
35915,217356802,217359021,True,2,2219
35916,217368556,217369184,True,3,628
35917,217368556,217405590,True,1,37034
35918,217491669,217525346,True,1,33677
35919,217532330,217535261,False,1,2931
35920,217532330,217535261,True,1,2931
35921,217543319,217546417,True,1,3098
35922,217558215,217559173,True,1,958
35923,217560308,217561330,True,1,1022
35924,217560845,217561618,True,1,773
35925,217570236,217572696,False,1,2460
35926,217609231,217619243,False,1,10012
35927,217628957,217630883,True,1,1926
35928,217629233,217630883,True,1,1650
35929,217706005,217710387,True,1,4382
35930,217706005,217718840,True,1,12835
35931,217711148,217711249,True,1,101
35932,217723357,217726677,True,1,3320
35933,217723435,217726675,True,2,3240
35934,217723435,217726699,True,1,3264
35935,217723435,217730299,True,1,6864
35936,217727472,217732469,True,1,4997
35937,217740760,217876941,False,1,136181
35938,217741769,217752307,True,1,10538
35939,217762243,217763312,True,1,1069
35940,217765100,217866724,True,1,101624
35941,217771978,217787144,True,3,15166
35942,217794153,217794273,True,1,120
35943,217810620,217815195,True,4,4575
35944,217813070,217815086,True,1,2016
35945,217818188,217819740,True,1,1552
35946,217821926,217895564,True,1,73638
35947,217822089,217841782,True,2,19693
35948,217824961,217881849,True,3,56888
35949,217833401,217834081,True,4,680
35950,217837062,217837163,False,1,101
35951,217840205,217843792,True,1,3587
35952,217840250,217843842,True,1,3592
35953,217844558,217844662,True,2,104
35954,217848005,217848897,False,1,892
35955,217851863,217856703,True,1,4840
35956,217877610,217882760,True,1,5150
35957,217910394,217910752,False,1,358
35958,217912805,217914127,True,2,1322
35959,217912805,217914346,True,4,1541
35960,217927506,217937520,False,1,10014
35961,217938607,217953477,True,4,14870
35962,217938607,217954190,True,1,15583
35963,217955289,217962204,True,1,6915
35964,217969597,217970268,False,1,671
35965,217969794,217975365,True,1,5571
35966,217983744,217991192,False,1,7448
35967,217985989,217986090,True,2,101
35968,217989382,217992636,False,1,3254
35969,217989382,217992636,True,2,3254
35970,218025485,218031850,True,1,6365
35971,218033716,218033745,True,1,29
35972,218033767,218041312,True,1,7545
35973,218033767,218043193,True,1,9426
35974,218051408,218052649,False,1,1241
35975,218051408,218074374,True,1,22966
35976,218080182,218081263,True,4,1081
35977,218091858,218092722,True,2,864
35978,218098838,218099758,True,1,920
35979,218131312,218131663,True,2,351
35980,218145908,218153475,False,2,7567
35981,218160889,218160982,False,1,93
35982,218160889,218160982,True,1,93
35983,218177669,218183253,False,1,5584
35984,218187489,218187848,False,1,359
35985,218206157,218246156,True,1,39999
35986,218248073,218252380,False,1,4307
35987,218257890,218265414,True,1,7524
35988,218301860,218426869,True,1,125009
35989,218339367,218345044,True,2,5677
35990,218359485,218362525,True,2,3040
35991,218372299,218378468,True,2,6169
35992,218382522,218382870,True,1,348
35993,218382522,218383740,True,2,1218
35994,218402990,218404854,True,1,1864
35995,218409637,218480815,True,1,71178
35996,218410005,218480980,True,1,70975
35997,218426265,218533847,False,1,107582
35998,218428123,218429181,True,2,1058
35999,218437867,218438452,True,1,585
36000,218447327,218499675,True,1,52348
36001,218470420,218471141,True,1,721
36002,218470420,218473253,True,2,2833
36003,218475618,218513760,True,1,38142
36004,218491862,218556435,True,1,64573
36005,218492747,218493068,True,2,321
36006,218493843,218494900,True,1,1057
36007,218497086,218566731,True,1,69645
36008,218505518,218523151,True,1,17633
36009,218505518,218531479,True,1,25961
36010,218511173,218511686,True,1,513
36011,218530170,218533326,True,1,3156
36012,218542979,218547326,True,1,4347
36013,218547338,218552110,False,1,4772
36014,218547338,218552110,True,1,4772
36015,218557749,218559997,False,1,2248
36016,218563790,218599802,True,1,36012
36017,218578692,218584161,True,2,5469
36018,218585834,218586944,True,1,1110
36019,218611174,218614214,True,1,3040
36020,218616472,218617383,True,3,911
36021,218672070,218681522,True,1,9452
36022,218717443,218718187,False,1,744
36023,218717443,218718187,True,1,744
36024,218731559,218731646,True,1,87
36025,218756935,218778776,False,1,21841
36026,218799961,218800616,False,2,655
36027,218806589,218807704,True,4,1115
36028,218833133,218837748,True,1,4615
36029,218833133,218882775,True,3,49642
36030,218839452,218847497,True,2,8045
36031,218839452,218847729,True,1,8277
36032,218879275,218881593,True,3,2318
36033,218891851,218904888,True,1,13037
36034,218901201,218916926,True,1,15725
36035,218911779,218917902,True,1,6123
36036,218921315,218921999,True,1,684
36037,218921315,218922518,False,1,1203
36038,218921865,218923499,True,1,1634
36039,218947252,218949374,True,4,2122
36040,218954810,218956943,True,1,2133
36041,218972333,218972552,True,1,219
36042,218980388,218981334,False,1,946
36043,218980945,218984864,True,1,3919
36044,219024611,219033688,True,3,9077
36045,219027031,219029993,True,4,2962
36046,219040888,219040986,True,1,98
36047,219051976,219055046,True,1,3070
36048,219052309,219053804,True,3,1495
36049,219052309,219056302,True,2,3993
36050,219071014,219071633,True,1,619
36051,219072365,219072914,True,1,549
36052,219077304,219079212,True,1,1908
36053,219083477,219084826,True,1,1349
36054,219083616,219084853,True,1,1237
36055,219108908,219131599,True,1,22691
36056,219115799,219118345,True,1,2546
36057,219143690,219148458,True,3,4768
36058,219155064,219181865,True,1,26801
36059,219204187,219290422,True,1,86235
36060,219214312,219215752,True,1,1440
36061,219231166,219232233,False,1,1067
36062,219231166,219232233,True,1,1067
36063,219239072,219240057,False,1,985
36064,219250074,219281848,False,1,31774
36065,219251013,219311010,True,1,59997
36066,219266906,219268912,True,1,2006
36067,219266906,219270439,False,1,3533
36068,219297292,219297727,False,1,435
36069,219297292,219297727,True,2,435
36070,219307026,219502174,False,1,195148
36071,219313542,219361098,True,3,47556
36072,219313542,219363703,True,1,50161
36073,219319495,219321780,True,1,2285
36074,219324647,219350663,True,1,26016
36075,219326969,219328144,True,5,1175
36076,219333241,219337047,False,1,3806
36077,219333241,219337047,True,1,3806
36078,219333241,219338126,False,1,4885
36079,219334053,219569573,True,1,235520
36080,219377244,219377839,True,1,595
36081,219377244,219379328,True,1,2084
36082,219377936,219379328,True,2,1392
36083,219377936,219384991,True,1,7055
36084,219378453,219379217,True,2,764
36085,219389999,219392695,True,1,2696
36086,219402584,219435480,True,1,32896
36087,219425557,219432653,False,1,7096
36088,219425557,219432653,True,2,7096
36089,219433517,219434992,True,3,1475
36090,219459462,219459967,True,1,505
36091,219461576,219462286,True,1,710
36092,219465288,219465734,False,1,446
36093,219466961,219470427,True,1,3466
36094,219468944,219472410,True,1,3466
36095,219476048,219560542,False,1,84494
36096,219480371,219481288,False,2,917
36097,219490420,219491387,True,2,967
36098,219490420,219493326,True,2,2906
36099,219492565,219710124,True,1,217559
36100,219507271,219509587,False,1,2316
36101,219511654,219515719,True,2,4065
36102,219513264,219513681,False,1,417
36103,219513264,219523112,True,1,9848
36104,219524304,219524488,True,2,184
36105,219530807,219531191,True,4,384
36106,219571495,219572511,False,1,1016
36107,219571495,219572572,False,1,1077
36108,219571495,219572572,True,2,1077
36109,219588651,219593692,True,1,5041
36110,219592711,219595048,True,1,2337
36111,219605408,219606450,True,1,1042
36112,219628832,219629240,True,2,408
36113,219632691,219635234,False,1,2543
36114,219644953,219645191,True,5,238
36115,219653172,219657657,True,1,4485
36116,219670196,219671812,True,2,1616
36117,219670616,219671815,False,1,1199
36118,219700349,219704525,True,1,4176
36119,219708866,219709068,True,2,202
36120,219754936,219755888,True,1,952
36121,219776077,219780380,False,1,4303
36122,219776077,219780380,True,4,4303
36123,219776875,219778475,True,1,1600
36124,219830996,219834867,True,2,3871
36125,219830996,219836761,True,1,5765
36126,219831008,219834867,True,1,3859
36127,219831341,219834867,False,1,3526
36128,219831341,219834867,True,2,3526
36129,219836672,219839645,True,5,2973
36130,219886364,219894200,True,4,7836
36131,219893895,219894523,True,1,628
36132,219907205,219907284,True,1,79
36133,219925539,219928535,False,1,2996
36134,219927874,219971311,True,1,43437
36135,219928244,219971472,True,1,43228
36136,219935564,219936037,True,1,473
36137,219935571,219936044,True,1,473
36138,219986461,219988419,False,1,1958
36139,219986461,219988419,True,2,1958
36140,220003559,220009114,True,1,5555
36141,220014717,220030220,True,1,15503
36142,220015526,220031029,True,1,15503
36143,220018618,220018778,True,3,160
36144,220023177,220024111,True,3,934
36145,220023177,220024120,True,1,943
36146,220025127,220048702,True,2,23575
36147,220025327,220026423,False,1,1096
36148,220025327,220026423,True,1,1096
36149,220038989,220039828,True,1,839
36150,220053262,220055237,True,1,1975
36151,220064218,220064359,True,1,141
36152,220073433,220074420,True,1,987
36153,220073433,220075033,True,1,1600
36154,220073609,220073840,True,3,231
36155,220073609,220074463,True,2,854
36156,220073609,220075076,True,1,1467
36157,220091492,220107936,True,2,16444
36158,220091563,220098119,False,1,6556
36159,220091563,220115908,True,1,24345
36160,220092801,220108753,True,1,15952
36161,220094243,220109469,True,1,15226
36162,220101066,220101485,True,1,419
36163,220133175,220136589,True,3,3414
36164,220147809,220151607,True,1,3798
36165,220149856,220152499,True,1,2643
36166,220165068,220167535,True,1,2467
36167,220182645,220207542,True,1,24897
36168,220200182,220230927,True,1,30745
36169,220202923,220204125,True,4,1202
36170,220292054,220292459,True,1,405
36171,220304888,220334090,True,1,29202
36172,220324403,220324885,False,1,482
36173,220325334,220325968,True,1,634
36174,220325334,220330357,True,1,5023
36175,220327090,220331125,True,1,4035
36176,220327423,220331817,True,1,4394
36177,220333320,220334532,True,1,1212
36178,220336462,220336828,True,1,366
36179,220344060,220344801,True,1,741
36180,220344411,220345407,False,2,996
36181,220375368,220444566,True,1,69198
36182,220375368,220553815,True,1,178447
36183,220397744,220398029,True,5,285
36184,220397744,220409742,True,1,11998
36185,220398377,220401046,False,1,2669
36186,220421416,220421688,False,1,272
36187,220421416,220421688,True,2,272
36188,220442474,220443010,True,6,536
36189,220452162,220502885,False,1,50723
36190,220460948,220461207,True,2,259
36191,220495339,220496439,True,5,1100
36192,220495339,220498341,False,1,3002
36193,220497316,220505479,False,1,8163
36194,220508677,220510696,True,3,2019
36195,220509833,220510101,True,2,268
36196,220537417,220546827,False,1,9410
36197,220556344,220556630,True,2,286
36198,220560189,220560276,True,1,87
36199,220575305,220580775,True,1,5470
36200,220579289,220582169,False,2,2880
36201,220579289,220582169,True,1,2880
36202,220585725,220585981,True,4,256
36203,220588558,220588769,True,1,211
36204,220590649,220591044,True,1,395
36205,220599178,220599403,True,1,225
36206,220599178,220599804,True,1,626
36207,220601689,220607216,True,1,5527
36208,220602274,220603408,True,1,1134
36209,220602274,220603998,False,1,1724
36210,220602274,220603998,True,3,1724
36211,220604187,220611035,True,2,6848
36212,220606882,220829752,True,2,222870
36213,220643902,220645129,True,1,1227
36214,220676309,220678908,False,1,2599
36215,220676309,220678908,True,1,2599
36216,220676858,220679152,True,1,2294
36217,220679017,220679990,True,1,973
36218,220692920,220712689,False,1,19769
36219,220693182,220694906,True,1,1724
36220,220693254,220694906,False,2,1652
36221,220693254,220694906,True,1,1652
36222,220703054,220703964,False,1,910
36223,220705385,220708225,False,1,2840
36224,220710128,220725541,True,1,15413
36225,220710128,220739025,True,4,28897
36226,220732810,220751626,True,3,18816
36227,220738601,220739431,True,6,830
36228,220749587,220751479,True,1,1892
36229,220772517,220774836,True,1,2319
36230,220777619,220779393,True,1,1774
36231,220812992,220813398,False,1,406
36232,220814838,220840570,True,1,25732
36233,220815148,220815973,True,1,825
36234,220818354,220820653,True,1,2299
36235,220842903,220843810,True,4,907
36236,220853391,220854887,True,1,1496
36237,220856185,220858485,True,1,2300
36238,220856185,220860644,False,1,4459
36239,220874114,220886798,False,1,12684
36240,220874823,220887042,True,3,12219
36241,220895642,220897880,True,1,2238
36242,220899707,220900801,True,5,1094
36243,220906916,220910111,True,4,3195
36244,220927174,220929057,True,1,1883
36245,220932150,220932984,True,1,834
36246,220934722,220935730,True,1,1008
36247,220959246,220961205,True,1,1959
36248,220959246,220965148,True,1,5902
36249,220959246,220973974,True,2,14728
36250,220959975,220961781,False,1,1806
36251,220962946,221061519,True,2,98573
36252,220976267,220998389,True,1,22122
36253,220978313,220978920,True,2,607
36254,221003422,221015969,True,1,12547
36255,221055180,221079040,True,1,23860
36256,221055551,221079040,True,1,23489
36257,221081977,221092874,True,5,10897
36258,221087158,221088398,True,1,1240
36259,221093631,221098223,True,1,4592
36260,221093642,221098223,True,1,4581
36261,221100900,221102074,True,2,1174
36262,221104076,221114965,True,1,10889
36263,221104999,221115346,False,1,10347
36264,221104999,221115346,True,1,10347
36265,221120288,221239666,True,2,119378
36266,221123263,221127304,True,1,4041
36267,221124387,221127302,True,1,2915
36268,221124805,221127302,True,2,2497
36269,221130493,221131013,False,1,520
36270,221134611,221187271,True,2,52660
36271,221148460,221154709,True,1,6249
36272,221154661,221157733,True,2,3072
36273,221174646,221176499,True,18,1853
36274,221205509,221205917,True,1,408
36275,221206659,221207051,True,1,392
36276,221220508,221221788,True,2,1280
36277,221222436,221222969,True,1,533
36278,221266795,221269846,True,2,3051
36279,221312495,221316836,False,1,4341
36280,221312495,221316836,True,1,4341
36281,221312794,221313688,True,1,894
36282,221324113,221325492,True,3,1379
36283,221358481,221361139,False,1,2658
36284,221386636,221402594,True,1,15958
36285,221410362,221427203,False,1,16841
36286,221427927,221439357,True,1,11430
36287,221427927,221442917,True,1,14990
36288,221438743,221439438,True,2,695
36289,221459753,221464226,True,1,4473
36290,221462621,221468142,True,1,5521
36291,221462621,221470996,True,1,8375
36292,221462621,221493530,True,1,30909
36293,221470447,221472326,True,1,1879
36294,221473366,221473972,True,1,606
36295,221473625,221473972,True,1,347
36296,221474144,221474290,True,1,146
36297,221474842,221476398,True,1,1556
36298,221489323,221489692,False,2,369
36299,221489323,221496532,False,1,7209
36300,221492179,221498263,True,2,6084
36301,221498438,221503442,True,1,5004
36302,221508134,221518919,False,1,10785
36303,221508134,221518919,True,4,10785
36304,221509951,221510113,False,1,162
36305,221528918,221535511,False,1,6593
36306,221538812,221541997,True,1,3185
36307,221545617,221558758,True,1,13141
36308,221554851,221574354,True,1,19503
36309,221567164,221567245,True,1,81
36310,221568131,221569201,False,1,1070
36311,221581629,221621480,True,2,39851
36312,221582371,221621889,True,1,39518
36313,221604100,221605988,True,1,1888
36314,221622842,221624573,True,1,1731
36315,221627292,221628467,True,1,1175
36316,221636280,221637367,True,1,1087
36317,221660191,221664005,False,1,3814
36318,221668657,221696139,True,3,27482
36319,221669825,221670719,True,3,894
36320,221669825,221670803,False,1,978
36321,221672757,221673601,True,1,844
36322,221684780,221686593,True,1,1813
36323,221684780,221714709,False,1,29929
36324,221696129,221853037,False,1,156908
36325,221745727,221746618,True,1,891
36326,221762553,221764125,True,5,1572
36327,221765770,221766082,True,1,312
36328,221766834,221770103,True,1,3269
36329,221766834,221770872,True,1,4038
36330,221781191,221781836,True,3,645
36331,221803963,221806408,True,1,2445
36332,221811987,221823550,True,5,11563
36333,221812007,221823550,True,1,11543
36334,221812558,221817109,True,1,4551
36335,221813054,221817112,True,2,4058
36336,221848872,221849703,True,5,831
36337,221848872,221849807,False,1,935
36338,221848872,221849807,True,1,935
36339,221849049,221849755,True,4,706
36340,221849049,221849859,True,2,810
36341,221849938,221850242,True,1,304
36342,221859256,221860128,False,2,872
36343,221859256,221860128,True,2,872
36344,221867049,221873485,True,4,6436
36345,221872087,221873162,True,1,1075
36346,221880192,221881613,True,3,1421
36347,221880276,221881704,True,2,1428
36348,221888081,221890415,True,1,2334
36349,221901006,221905223,False,1,4217
36350,221919505,221919835,True,1,330
36351,221938304,221938895,False,1,591
36352,221939918,221940158,False,1,240
36353,221940243,221941845,False,1,1602
36354,221943146,221950985,True,2,7839
36355,221947136,221948183,True,1,1047
36356,221960060,221963717,True,2,3657
36357,221987697,221990368,True,1,2671
36358,221999758,222003750,False,1,3992
36359,222006584,222022221,False,1,15637
36360,222032793,222032941,False,1,148
36361,222037771,222039752,True,1,1981
36362,222046836,222048782,False,1,1946
36363,222047612,222048339,True,1,727
36364,222104038,222105911,True,1,1873
36365,222104038,222109470,False,1,5432
36366,222104038,222109470,True,4,5432
36367,222104179,222109550,False,1,5371
36368,222104179,222109550,True,2,5371
36369,222131626,222153616,True,1,21990
36370,222131742,222136124,True,11,4382
36371,222173770,222174461,True,3,691
36372,222238695,222258455,True,1,19760
36373,222238928,222258604,True,1,19676
36374,222250368,222264301,True,1,13933
36375,222253523,222278827,True,1,25304
36376,222267330,222267910,False,2,580
36377,222267330,222272964,False,1,5634
36378,222267330,222274575,False,1,7245
36379,222271841,222344529,True,1,72688
36380,222272751,222280851,True,1,8100
36381,222288961,222325223,False,1,36262
36382,222293342,222293786,True,1,444
36383,222310197,222314914,False,1,4717
36384,222315621,222316520,True,1,899
36385,222316582,222317550,True,1,968
36386,222321493,222324758,False,1,3265
36387,222331110,222346750,False,1,15640
36388,222333504,222334430,False,1,926
36389,222333504,222339664,False,1,6160
36390,222338583,222340520,True,1,1937
36391,222339347,222340814,True,1,1467
36392,222340424,222341225,True,1,801
36393,222351956,222389105,True,1,37149
36394,222392404,222404692,True,1,12288
36395,222392404,222406044,True,1,13640
36396,222392404,222409348,True,1,16944
36397,222392404,222409486,True,1,17082
36398,222445831,222448297,True,1,2466
36399,222448280,222451148,True,1,2868
36400,222496621,222523936,False,1,27315
36401,222512316,222512438,False,1,122
36402,222522081,222524816,True,4,2735
36403,222535800,222542367,False,2,6567
36404,222535800,222542367,True,2,6567
36405,222535800,222547590,True,1,11790
36406,222535800,222554696,True,1,18896
36407,222536051,222542491,True,2,6440
36408,222544600,222552449,True,1,7849
36409,222559791,222560135,True,1,344
36410,222569719,222575471,True,1,5752
36411,222569719,222576017,True,1,6298
36412,222569719,222581198,True,2,11479
36413,222570431,222570527,False,1,96
36414,222574014,222574704,True,1,690
36415,222584306,222585032,True,1,726
36416,222587711,222588416,True,1,705
36417,222592297,222593694,True,1,1397
36418,222592629,222592712,False,1,83
36419,222606622,222609497,True,2,2875
36420,222625659,222625891,True,1,232
36421,222644197,222646195,True,1,1998
36422,222652597,222700461,True,1,47864
36423,222676661,222704141,True,1,27480
36424,222697602,222699521,True,2,1919
36425,222730293,222736543,True,1,6250
36426,222731542,222737183,True,1,5641
36427,222732241,222737183,True,1,4942
36428,222734939,222738443,True,6,3504
36429,222735658,222739357,True,1,3699
36430,222735713,222738932,True,1,3219
36431,222735958,222736545,True,1,587
36432,222748907,222749392,False,1,485
36433,222762923,222765067,False,1,2144
36434,222771244,222771743,True,3,499
36435,222787777,222820293,True,2,32516
36436,222791144,222792725,True,3,1581
36437,222795442,222806923,True,1,11481
36438,222818078,222902676,True,2,84598
36439,222822885,222823517,True,1,632
36440,222822885,222825878,True,2,2993
36441,222824368,222826704,True,1,2336
36442,222827701,222829596,True,1,1895
36443,222831591,222849733,True,1,18142
36444,222831647,222849789,True,1,18142
36445,222837862,222842282,True,1,4420
36446,222897262,222908025,False,1,10763
36447,222902876,223015992,True,1,113116
36448,222943871,223123829,True,1,179958
36449,222946591,222960134,True,1,13543
36450,222957714,222959713,True,1,1999
36451,222980500,223016092,True,1,35592
36452,222980832,222982282,True,3,1450
36453,222993214,222993620,False,1,406
36454,222997282,223012908,True,1,15626
36455,222999129,223002748,False,1,3619
36456,222999129,223002748,True,1,3619
36457,223063345,223066784,True,1,3439
36458,223063345,223066929,True,1,3584
36459,223074760,223075052,True,1,292
36460,223078423,223080897,True,6,2474
36461,223083957,223084842,True,1,885
36462,223090654,223091498,True,1,844
36463,223113267,223115817,True,2,2550
36464,223150845,223155325,True,1,4480
36465,223156449,223180935,True,2,24486
36466,223157292,223181476,True,3,24184
36467,223161411,223163939,True,1,2528
36468,223195412,223203634,False,1,8222
36469,223195412,223205801,True,2,10389
36470,223199835,223201050,True,1,1215
36471,223207068,223234973,True,1,27905
36472,223212053,223214174,False,1,2121
36473,223220940,223221379,True,4,439
36474,223241592,223248795,True,4,7203
36475,223249593,223252893,True,3,3300
36476,223261027,223262620,True,1,1593
36477,223261261,223266972,False,1,5711
36478,223261261,223266972,True,5,5711
36479,223264733,223266824,False,1,2091
36480,223272910,223273041,True,2,131
36481,223310162,223312081,True,1,1919
36482,223310162,223333283,True,5,23121
36483,223320842,223321378,False,1,536
36484,223320842,223321378,True,2,536
36485,223361950,223366249,True,1,4299
36486,223364631,223372510,True,2,7879
36487,223365761,223368935,True,1,3174
36488,223365761,223373094,True,1,7333
36489,223393517,223394588,False,1,1071
36490,223393517,223394588,True,1,1071
36491,223395772,223398351,True,2,2579
36492,223395772,223402831,True,1,7059
36493,223395772,223403481,True,1,7709
36494,223409964,223410089,True,2,125
36495,223410001,223410089,True,1,88
36496,223411369,223412268,False,2,899
36497,223416528,223417160,True,1,632
36498,223435546,223435677,True,1,131
36499,223435546,223435756,True,1,210
36500,223435546,223435851,True,1,305
36501,223436455,223437623,True,1,1168
36502,223458893,223459341,True,2,448
36503,223491607,223491982,True,2,375
36504,223500276,223503037,True,1,2761
36505,223503838,223504589,True,1,751
36506,223512311,223521827,True,1,9516
36507,223517060,223519229,True,2,2169
36508,223531630,223626102,True,1,94472
36509,223531683,223626159,True,1,94476
36510,223535661,223573873,True,2,38212
36511,223535661,223625257,True,1,89596
36512,223535767,223628091,True,2,92324
36513,223540671,223542752,True,1,2081
36514,223540671,223543642,True,1,2971
36515,223544835,223545694,True,1,859
36516,223559040,223560398,True,1,1358
36517,223560199,223572999,False,1,12800
36518,223560199,223572999,True,2,12800
36519,223561658,223562731,True,1,1073
36520,223567106,223567622,False,1,516
36521,223567106,223567622,True,1,516
36522,223567106,223572859,True,1,5753
36523,223595978,223598407,True,1,2429
36524,223599721,223599901,True,1,180
36525,223599721,223601820,True,1,2099
36526,223599721,223602369,True,1,2648
36527,223599721,223602388,True,1,2667
36528,223609542,223609993,True,1,451
36529,223609542,223700496,False,1,90954
36530,223609542,223723713,True,1,114171
36531,223610573,223617386,True,3,6813
36532,223612103,223612285,False,1,182
36533,223612103,223612285,True,1,182
36534,223612398,223663694,True,1,51296
36535,223616209,223643197,True,2,26988
36536,223646320,223647316,False,1,996
36537,223660927,223661484,False,1,557
36538,223667045,223686493,True,5,19448
36539,223667045,223687782,True,1,20737
36540,223667045,223690633,True,2,23588
36541,223678509,223696806,True,1,18297
36542,223682306,223683758,True,3,1452
36543,223687832,223699672,True,1,11840
36544,223693504,223773568,True,3,80064
36545,223693504,223773572,True,1,80068
36546,223696551,223699492,True,1,2941
36547,223706152,223708895,True,1,2743
36548,223710870,223713040,True,1,2170
36549,223712593,223740467,True,1,27874
36550,223712603,223740477,True,1,27874
36551,223714641,223715393,True,1,752
36552,223719449,223722807,True,1,3358
36553,223719879,223730453,True,3,10574
36554,223745496,223757220,True,1,11724
36555,223748707,223777731,True,2,29024
36556,223748707,223788113,True,1,39406
36557,223748707,223796933,False,1,48226
36558,223757255,223759798,True,18,2543
36559,223757334,223760746,True,4,3412
36560,223766809,223768359,True,1,1550
36561,223777350,223782551,True,1,5201
36562,223778487,223778724,True,3,237
36563,223780661,223781496,False,1,835
36564,223780661,223781496,True,3,835
36565,223784314,223785270,True,1,956
36566,223787174,223789708,True,2,2534
36567,223788105,223790763,True,1,2658
36568,223792012,223792457,True,2,445
36569,223792479,223793051,True,1,572
36570,223799487,223803201,True,1,3714
36571,223854357,223856497,False,1,2140
36572,223869678,223875891,True,1,6213
36573,223870250,223873032,True,1,2782
36574,223871156,223873082,True,1,1926
36575,223877251,223879680,True,1,2429
36576,223881885,223882220,True,1,335
36577,223890049,223891256,True,3,1207
36578,223890607,223891256,True,3,649
36579,223901619,223904232,True,1,2613
36580,223911724,223912238,False,1,514
36581,223911724,223912900,True,1,1176
36582,223914902,223915879,True,3,977
36583,223915230,223916126,True,4,896
36584,223915230,223917136,True,1,1906
36585,223931596,223956561,False,1,24965
36586,223932494,223934167,True,1,1673
36587,223935202,223955307,True,1,20105
36588,223940061,223957933,True,1,17872
36589,223946123,223946216,True,1,93
36590,223964684,223977234,True,4,12550
36591,223966522,223967156,True,2,634
36592,223967698,223967762,True,1,64
36593,223971802,223973706,True,2,1904
36594,223974499,223975185,False,1,686
36595,223983032,223983276,True,1,244
36596,223983945,223984199,True,1,254
36597,224006100,224007907,True,1,1807
36598,224028513,224033297,True,3,4784
36599,224031308,224031406,True,1,98
36600,224033255,224035241,True,1,1986
36601,224039996,224040327,True,2,331
36602,224042885,224066691,False,1,23806
36603,224045132,224046336,True,1,1204
36604,224052348,224054329,True,2,1981
36605,224076260,224078089,True,1,1829
36606,224076304,224078068,True,1,1764
36607,224085228,224087675,True,1,2447
36608,224086780,224145222,True,1,58442
36609,224092619,224096206,True,2,3587
36610,224092619,224110402,True,1,17783
36611,224094269,224097087,True,3,2818
36612,224094269,224111283,True,1,17014
36613,224103986,224106703,True,1,2717
36614,224103986,224111662,True,2,7676
36615,224103986,224115722,True,2,11736
36616,224106335,224107596,True,1,1261
36617,224106842,224107781,True,1,939
36618,224126685,224153759,True,1,27074
36619,224126685,224159014,True,1,32329
36620,224147177,224147603,True,1,426
36621,224147177,224164123,True,2,16946
36622,224162315,224167690,True,3,5375
36623,224170185,224319008,True,1,148823
36624,224181319,224186298,True,2,4979
36625,224181399,224186378,False,1,4979
36626,224184678,224187928,True,1,3250
36627,224194336,224196402,False,1,2066
36628,224194336,224196402,True,1,2066
36629,224215601,224219703,True,1,4102
36630,224238572,224241944,True,1,3372
36631,224241944,224244374,False,1,2430
36632,224241944,224245772,True,1,3828
36633,224242466,224245930,True,1,3464
36634,224247899,224254355,True,5,6456
36635,224249742,224377050,False,1,127308
36636,224279886,224281903,False,1,2017
36637,224279886,224281903,True,8,2017
36638,224284345,224286440,False,2,2095
36639,224300762,224303924,True,1,3162
36640,224306800,224306932,False,1,132
36641,224315280,224328238,True,1,12958
36642,224324960,224332494,True,1,7534
36643,224324960,224396358,True,1,71398
36644,224368042,224371415,True,2,3373
36645,224374082,224439345,False,1,65263
36646,224393998,224395087,True,4,1089
36647,224393998,224397036,True,1,3038
36648,224409590,224424410,True,2,14820
36649,224426612,224434790,False,2,8178
36650,224426612,224434790,True,2,8178
36651,224426612,224450155,True,1,23543
36652,224434357,224434432,True,1,75
36653,224502985,224504472,True,1,1487
36654,224504540,224506676,True,1,2136
36655,224510505,224511636,True,1,1131
36656,224515882,224520101,True,1,4219
36657,224535111,224546491,True,1,11380
36658,224535111,224563006,True,1,27895
36659,224555380,224555708,False,2,328
36660,224555380,224556702,False,1,1322
36661,224555853,224556701,False,1,848
36662,224555853,224557058,False,1,1205
36663,224560604,224583083,True,2,22479
36664,224561976,224563086,True,1,1110
36665,224565161,224569457,False,1,4296
36666,224565161,224571142,False,1,5981
36667,224578260,224583652,False,1,5392
36668,224597036,224597455,True,2,419
36669,224606228,224606344,True,1,116
36670,224625089,224632075,False,1,6986
36671,224625089,224633936,True,2,8847
36672,224625089,224640773,True,1,15684
36673,224637353,224638099,True,2,746
36674,224648018,224649429,True,2,1411
36675,224648018,224652231,True,1,4213
36676,224652115,224654835,True,1,2720
36677,224655037,224656142,True,1,1105
36678,224720974,224721962,False,1,988
36679,224720974,224722424,True,2,1450
36680,224738717,224739474,True,4,757
36681,224748257,224748585,True,1,328
36682,224750641,224750813,False,1,172
36683,224750641,224750813,True,1,172
36684,224750978,224757562,True,1,6584
36685,224769568,224773992,True,1,4424
36686,224784632,224784962,True,1,330
36687,224806213,224945833,True,1,139620
36688,224808557,224944711,True,1,136154
36689,224813585,224818620,True,3,5035
36690,224813721,224825345,True,1,11624
36691,224817596,224826915,True,1,9319
36692,224859918,224864410,True,3,4492
36693,224902564,224908709,True,1,6145
36694,224902564,224911103,True,1,8539
36695,224921629,224931815,True,2,10186
36696,224931949,224935527,False,1,3578
36697,224931949,224935527,True,1,3578
36698,224954175,224955315,True,2,1140
36699,225052196,225055129,True,1,2933
36700,225066998,225072236,True,1,5238
36701,225069377,225073172,True,3,3795
36702,225070192,225072488,True,1,2296
36703,225085389,225172345,True,4,86956
36704,225126770,225131661,False,1,4891
36705,225126770,225131661,True,2,4891
36706,225127301,225131661,True,1,4360
36707,225150476,225150625,True,1,149
36708,225150476,225150642,True,1,166
36709,225198318,225198835,True,1,517
36710,225259497,225272475,True,1,12978
36711,225263328,225267274,True,3,3946
36712,225282342,225283054,True,1,712
36713,225284177,225284866,True,2,689
36714,225284177,225289192,True,1,5015
36715,225296118,225297715,True,2,1597
36716,225312563,225342885,True,2,30322
36717,225317694,225394362,False,1,76668
36718,225318771,225319781,True,4,1010
36719,225318771,225336364,True,1,17593
36720,225337140,225338924,True,1,1784
36721,225358715,225390664,True,1,31949
36722,225358715,225403181,True,1,44466
36723,225358715,225424684,True,1,65969
36724,225375541,225376133,True,3,592
36725,225419981,225421670,True,1,1689
36726,225419981,225423779,True,1,3798
36727,225419981,225425536,False,1,5555
36728,225445413,225446512,True,4,1099
36729,225446142,225448307,False,1,2165
36730,225446142,225448307,True,9,2165
36731,225448701,225484053,True,1,35352
36732,225514434,225514893,False,1,459
36733,225514434,225514893,True,1,459
36734,225622012,225709282,True,2,87270
36735,225626132,225630351,True,3,4219
36736,225661576,225662089,False,1,513
36737,225664354,225905067,True,6,240713
36738,225686173,225686648,True,2,475
36739,225691757,225692686,True,1,929
36740,225699169,225700357,True,3,1188
36741,225703385,225704206,False,1,821
36742,225705172,225750881,True,1,45709
36743,225713464,225740613,True,2,27149
36744,225775656,225786185,True,1,10529
36745,225792268,225813212,True,3,20944
36746,225799225,225829083,True,1,29858
36747,225861274,225865443,True,2,4169
36748,225862914,225866406,True,3,3492
36749,225870464,225903764,True,1,33300
36750,225877693,225893613,True,1,15920
36751,225925599,225931510,True,1,5911
36752,225947483,225961916,True,1,14433
36753,225979778,225980142,True,1,364
36754,225997522,225998073,True,1,551
36755,225999435,226004614,False,1,5179
36756,226012590,226013147,True,2,557
36757,226016371,226018573,False,1,2202
36758,226016371,226019308,True,2,2937
36759,226020252,226043670,True,1,23418
36760,226020252,226067533,True,1,47281
36761,226026023,226242846,True,1,216823
36762,226061443,226077983,True,1,16540
36763,226066780,226090601,True,1,23821
36764,226103435,226108863,True,1,5428
36765,226115031,226118229,True,1,3198
36766,226131854,226132611,True,2,757
36767,226133441,226174399,True,1,40958
36768,226134873,226149539,False,1,14666
36769,226134873,226150711,False,1,15838
36770,226134873,226150711,True,6,15838
36771,226163865,226164033,True,1,168
36772,226169124,226177633,True,3,8509
36773,226169284,226183060,False,1,13776
36774,226186537,226212828,True,1,26291
36775,226245747,226258904,False,1,13157
36776,226253321,226257464,True,1,4143
36777,226253734,226261573,True,2,7839
36778,226256368,226259729,True,2,3361
36779,226279792,226283220,True,2,3428
36780,226280623,226281177,False,1,554
36781,226288211,226289728,True,1,1517
36782,226293424,226294150,True,1,726
36783,226301481,226302878,True,1,1397
36784,226306224,226327256,True,3,21032
36785,226306395,226306502,True,1,107
36786,226324579,226351904,True,1,27325
36787,226325771,226326998,False,1,1227
36788,226325771,226326998,True,1,1227
36789,226337044,226339992,True,1,2948
36790,226370590,226372213,False,1,1623
36791,226370590,226372213,True,2,1623
36792,226370972,226371036,True,1,64
36793,226396371,226403575,True,1,7204
36794,226403940,226404294,True,1,354
36795,226410758,226412873,True,1,2115
36796,226434299,226434515,True,1,216
36797,226434398,226434499,True,2,101
36798,226434398,226434515,True,1,117
36799,226435005,226438601,True,2,3596
36800,226435140,226447055,True,1,11915
36801,226437123,226455453,False,2,18330
36802,226437123,226455453,True,4,18330
36803,226459365,226459494,True,2,129
36804,226460015,226496051,True,2,36036
36805,226472317,226476141,True,4,3824
36806,226476757,226480075,True,1,3318
36807,226479820,226483234,True,1,3414
36808,226488083,226488931,True,4,848
36809,226503307,226536482,False,1,33175
36810,226503307,226536482,True,3,33175
36811,226505309,226505695,False,1,386
36812,226505547,226505695,True,2,148
36813,226517303,226522713,True,1,5410
36814,226526444,226528041,False,2,1597
36815,226526444,226528041,True,2,1597
36816,226549189,226550030,True,1,841
36817,226561958,226563592,True,4,1634
36818,226569768,226570726,True,1,958
36819,226599739,226602897,True,1,3158
36820,226599739,226604078,True,2,4339
36821,226599739,226604487,True,1,4748
36822,226599739,226621432,True,1,21693
36823,226600220,226604630,True,1,4410
36824,226600220,226608413,True,1,8193
36825,226603269,226634846,True,1,31577
36826,226607261,226636534,True,1,29273
36827,226613553,226613647,True,1,94
36828,226642523,226643098,True,1,575
36829,226645848,226648586,True,1,2738
36830,226647579,226650695,True,1,3116
36831,226684261,226685584,True,2,1323
36832,226689411,226784089,True,2,94678
36833,226689762,226691077,True,6,1315
36834,226725958,226729068,False,1,3110
36835,226747504,226750390,True,2,2886
36836,226752760,226755621,True,3,2861
36837,226785570,226812871,False,1,27301
36838,226798965,226799064,False,1,99
36839,226801516,226808568,False,1,7052
36840,226807139,226807571,True,1,432
36841,226828782,226830364,True,1,1582
36842,226832863,226841114,True,3,8251
36843,226862313,226876002,True,4,13689
36844,226871303,226871672,True,1,369
36845,226876090,226877057,True,3,967
36846,226879019,226898717,True,1,19698
36847,226911256,226914267,True,2,3011
36848,226919474,226923418,True,1,3944
36849,226921333,226921505,False,1,172
36850,226921333,226921505,True,2,172
36851,226931825,226963451,True,2,31626
36852,226958186,226958455,True,1,269
36853,226991917,227010888,True,1,18971
36854,226992068,226993836,True,3,1768
36855,226993282,227001938,False,1,8656
36856,226998614,227002133,False,2,3519
36857,226999414,227002167,False,1,2753
36858,227019894,227023395,True,1,3501
36859,227021815,227035463,True,1,13648
36860,227037061,227038973,True,1,1912
36861,227064335,227067053,True,1,2718
36862,227074496,227075054,True,4,558
36863,227081740,227082593,True,1,853
36864,227083435,227083513,True,1,78
36865,227090301,227090789,True,1,488
36866,227094154,227110376,True,1,16222
36867,227110769,227145351,False,1,34582
36868,227113193,227127934,False,1,14741
36869,227115463,227121028,False,1,5565
36870,227115463,227121028,True,1,5565
36871,227116514,227116917,True,1,403
36872,227116514,227123941,True,2,7427
36873,227117263,227118752,True,6,1489
36874,227117263,227119218,True,1,1955
36875,227117370,227124433,True,1,7063
36876,227175380,227177383,True,1,2003
36877,227175486,227176203,True,2,717
36878,227191891,227194050,True,1,2159
36879,227191894,227194050,True,1,2156
36880,227208440,227211244,False,1,2804
36881,227208440,227211244,True,1,2804
36882,227219077,227229347,True,1,10270
36883,227232097,227249768,True,2,17671
36884,227232977,227236193,True,1,3216
36885,227245841,227291888,True,1,46047
36886,227247306,227292609,True,1,45303
36887,227247380,227247542,True,1,162
36888,227266939,227278486,True,1,11547
36889,227267726,227302729,True,1,35003
36890,227267989,227282863,True,1,14874
36891,227274055,227339752,True,7,65697
36892,227312324,227325102,True,2,12778
36893,227318690,227322306,True,1,3616
36894,227318690,227323790,True,1,5100
36895,227333784,227334386,True,1,602
36896,227333854,227334352,True,1,498
36897,227338733,227340799,True,4,2066
36898,227341218,227341914,True,2,696
36899,227341218,227345251,True,1,4033
36900,227341218,227345757,True,1,4539
36901,227345605,227347473,True,1,1868
36902,227353118,227353628,True,1,510
36903,227364803,227380426,True,1,15623
36904,227367189,227380014,True,1,12825
36905,227369154,227370371,True,1,1217
36906,227394210,227394735,False,1,525
36907,227396973,227397616,True,2,643
36908,227398170,227398551,True,1,381
36909,227403253,227405728,True,1,2475
36910,227446769,227447529,True,1,760
36911,227449163,227453971,True,1,4808
36912,227453030,227529361,False,1,76331
36913,227453030,227654436,False,1,201406
36914,227463954,227465684,False,1,1730
36915,227471260,227471800,True,2,540
36916,227474349,227476513,False,1,2164
36917,227474349,227478694,True,3,4345
36918,227478658,227564847,True,2,86189
36919,227480715,227483796,False,1,3081
36920,227517366,227517513,True,1,147
36921,227520320,227521258,True,1,938
36922,227520320,227525103,True,2,4783
36923,227520320,227528260,True,1,7940
36924,227526906,227526997,True,1,91
36925,227538852,227567970,False,1,29118
36926,227538852,227567970,True,1,29118
36927,227551224,227555532,True,1,4308
36928,227551292,227551425,True,1,133
36929,227551292,227559663,True,2,8371
36930,227551292,227565052,True,1,13760
36931,227554351,227560876,False,1,6525
36932,227554351,227560876,True,2,6525
36933,227560021,227563345,True,1,3324
36934,227560131,227582058,True,1,21927
36935,227566481,227567372,False,1,891
36936,227570204,227574545,True,1,4341
36937,227570827,227571649,True,1,822
36938,227593065,227603289,True,2,10224
36939,227615995,227617947,False,1,1952
36940,227626011,227626478,True,1,467
36941,227626011,227627293,True,1,1282
36942,227632534,227633201,True,1,667
36943,227633502,227633671,True,1,169
36944,227637682,227666821,True,3,29139
36945,227651139,227655832,True,1,4693
36946,227660241,227661798,True,1,1557
36947,227661204,227661945,True,1,741
36948,227664142,227664338,True,2,196
36949,227664174,227664338,True,3,164
36950,227664453,227665130,True,2,677
36951,227664542,227664842,True,1,300
36952,227669898,227671019,True,1,1121
36953,227691910,227694287,False,1,2377
36954,227691910,227694287,True,2,2377
36955,227695315,227697519,True,4,2204
36956,227696519,227696712,True,1,193
36957,227714102,227725627,False,1,11525
36958,227720497,227725148,True,1,4651
36959,227720497,227725980,True,1,5483
36960,227726267,227727370,True,1,1103
36961,227728019,227728215,True,1,196
36962,227751074,227753110,True,1,2036
36963,227751074,227754492,True,1,3418
36964,227751074,227760733,True,1,9659
36965,227764648,227766047,True,1,1399
36966,227770454,227772288,True,1,1834
36967,227782248,227784789,True,1,2541
36968,227802055,227805752,True,1,3697
36969,227823045,227824006,True,2,961
36970,227831904,227832829,True,1,925
36971,227856237,227994628,True,1,138391
36972,227861034,227864361,True,2,3327
36973,227862593,227865218,True,1,2625
36974,227863190,227871480,True,3,8290
36975,227866634,227885424,False,1,18790
36976,227867445,228025609,True,4,158164
36977,227885183,227885473,True,1,290
36978,227903278,227912266,True,2,8988
36979,227907969,227908356,False,1,387
36980,227910129,227910243,True,1,114
36981,227910261,227911086,True,1,825
36982,227912937,227914867,True,1,1930
36983,227941752,228043018,True,1,101266
36984,227941752,228066354,True,2,124602
36985,227949759,227951240,True,4,1481
36986,227957396,227958478,True,1,1082
36987,227959537,227959608,True,1,71
36988,227959782,227978552,True,1,18770
36989,227986250,227987191,True,1,941
36990,227986250,227988768,False,1,2518
36991,227986250,227988768,True,1,2518
36992,227986250,228006068,True,1,19818
36993,227988044,228002187,False,1,14143
36994,227997957,227998237,True,1,280
36995,228010451,228010554,False,1,103
36996,228025122,228026543,True,1,1421
36997,228062412,228141987,True,1,79575
36998,228087060,228087783,True,1,723
36999,228110466,228121606,True,7,11140
37000,228115219,228126065,True,7,10846
37001,228133290,228241226,True,2,107936
37002,228135974,228136900,False,1,926
37003,228141460,228145555,False,1,4095
37004,228153553,228154789,True,2,1236
37005,228222556,228223758,False,1,1202
37006,228222556,228223758,True,2,1202
37007,228247421,228248838,True,1,1417
37008,228257152,228262120,True,1,4968
37009,228266385,228270206,True,1,3821
37010,228267942,228288589,True,1,20647
37011,228270322,228289696,True,1,19374
37012,228272161,228290629,True,1,18468
37013,228290895,228295122,True,2,4227
37014,228309535,228313332,True,1,3797
37015,228333966,228335205,True,1,1239
37016,228338707,228339278,True,1,571
37017,228352440,228352881,True,1,441
37018,228357549,228359383,True,1,1834
37019,228366781,228393799,False,1,27018
37020,228378822,228380063,False,1,1241
37021,228380686,228381010,False,1,324
37022,228380722,228382053,True,2,1331
37023,228388276,228392146,True,1,3870
37024,228390866,228391862,True,1,996
37025,228390866,228394193,False,1,3327
37026,228390866,228394193,True,2,3327
37027,228413980,228415393,False,1,1413
37028,228413980,228427036,True,2,13056
37029,228428592,228428731,True,1,139
37030,228447145,228447350,False,1,205
37031,228451458,228463655,False,1,12197
37032,228477206,228478295,True,1,1089
37033,228478047,228479089,True,1,1042
37034,228478258,228479142,False,1,884
37035,228478258,228479142,True,1,884
37036,228479173,228481788,True,1,2615
37037,228479329,228479674,True,2,345
37038,228479448,228491072,True,1,11624
37039,228480170,228480705,True,2,535
37040,228480252,228505397,True,1,25145
37041,228488028,228489004,True,1,976
37042,228493235,228493732,True,1,497
37043,228497172,228497602,True,1,430
37044,228510533,228515554,True,1,5021
37045,228519571,228520189,True,3,618
37046,228520309,228520870,True,1,561
37047,228520984,228542329,True,1,21345
37048,228524556,228532878,True,1,8322
37049,228525915,228527014,True,1,1099
37050,228537326,228538452,True,1,1126
37051,228542872,228543801,True,3,929
37052,228574988,228576992,True,4,2004
37053,228582306,228603919,False,1,21613
37054,228589045,228590358,True,1,1313
37055,228589045,228593684,True,1,4639
37056,228595677,228597753,False,1,2076
37057,228596412,228597499,True,1,1087
37058,228606971,228607840,True,1,869
37059,228613528,228614172,False,1,644
37060,228613528,228614172,True,1,644
37061,228614139,228614386,True,1,247
37062,228620504,228621483,True,2,979
37063,228624080,228644370,True,1,20290
37064,228643996,228645596,True,1,1600
37065,228648468,228770350,True,1,121882
37066,228650757,228657615,True,2,6858
37067,228651794,228657621,True,1,5827
37068,228664507,228669030,True,1,4523
37069,228670277,228670515,False,1,238
37070,228682734,228687354,False,1,4620
37071,228692406,228698751,False,1,6345
37072,228692406,228698761,False,1,6355
37073,228693080,228702270,True,2,9190
37074,228703335,228703867,False,1,532
37075,228705374,228705580,False,1,206
37076,228706666,228706903,False,1,237
37077,228707424,228707600,True,1,176
37078,228714023,228718629,True,6,4606
37079,228714395,228714897,True,1,502
37080,228724196,228729682,True,2,5486
37081,228730503,228736402,False,1,5899
37082,228738639,228751999,False,3,13360
37083,228747858,228749067,True,2,1209
37084,228747858,228750632,True,1,2774
37085,228747858,228750676,True,1,2818
37086,228751328,228752497,True,1,1169
37087,228756103,228760650,True,2,4547
37088,228757062,228759644,True,3,2582
37089,228758895,228758990,False,1,95
37090,228758895,228762486,False,1,3591
37091,228769751,228769789,True,1,38
37092,228769793,228770941,True,1,1148
37093,228769793,228770945,True,2,1152
37094,228769917,228771069,True,2,1152
37095,228772420,228776620,True,1,4200
37096,228785661,228786035,True,2,374
37097,228787654,228798766,True,1,11112
37098,228787654,228803016,True,1,15362
37099,228787654,228822724,True,1,35070
37100,228798602,228799412,True,1,810
37101,228799071,228800412,True,1,1341
37102,228813294,228818445,False,1,5151
37103,228843197,228843828,True,1,631
37104,228843197,228848592,True,1,5395
37105,228843197,228849304,False,1,6107
37106,228846271,228851521,True,1,5250
37107,228847845,228852943,True,2,5098
37108,228849013,228854263,False,1,5250
37109,228875484,228875747,True,4,263
37110,228876341,228876559,True,1,218
37111,228876764,228878137,True,1,1373
37112,228883507,228892164,True,2,8657
37113,228885052,228887288,True,1,2236
37114,228896311,228897530,True,1,1219
37115,228896311,228898543,True,2,2232
37116,228898050,228902729,False,1,4679
37117,228898050,228902729,True,3,4679
37118,228923012,228926745,True,3,3733
37119,228924503,228931301,True,2,6798
37120,228933576,228935870,False,1,2294
37121,228933576,228937486,False,1,3910
37122,228944149,228954997,True,2,10848
37123,228944547,228944662,False,1,115
37124,228944704,228947260,True,1,2556
37125,228944999,228955440,True,1,10441
37126,228987680,228989152,True,1,1472
37127,228993052,228993744,True,1,692
37128,228999916,229000748,True,1,832
37129,229000950,229003902,True,1,2952
37130,229012151,229014761,True,1,2610
37131,229013717,229022468,True,1,8751
37132,229026804,229028905,True,1,2101
37133,229037246,229055045,False,1,17799
37134,229044281,229044624,True,1,343
37135,229044281,229044981,True,2,700
37136,229047512,229048450,True,3,938
37137,229048707,229060846,True,2,12139
37138,229094806,229099086,True,2,4280
37139,229098522,229099576,True,1,1054
37140,229124899,229125188,True,2,289
37141,229126090,229126420,False,1,330
37142,229134417,229135130,False,1,713
37143,229182677,229192770,False,1,10093
37144,229206499,229207461,True,3,962
37145,229209750,229223530,False,1,13780
37146,229266617,229268268,True,2,1651
37147,229266617,229272260,True,1,5643
37148,229295410,229318257,True,2,22847
37149,229296529,229318921,True,1,22392
37150,229318798,229336088,True,1,17290
37151,229420712,229420972,True,23,260
37152,229421913,229422121,True,3,208
37153,229438174,229477796,False,1,39622
37154,229474850,229501739,False,1,26889
37155,229496026,229498277,True,3,2251
37156,229506515,229549225,False,1,42710
37157,229517687,229853877,False,1,336190
37158,229565539,229566290,False,1,751
37159,229573863,229576632,False,1,2769
37160,229585645,229595702,True,3,10057
37161,229588145,229588661,False,1,516
37162,229590763,229639729,False,1,48966
37163,229590763,229639729,True,3,48966
37164,229599647,229648919,True,1,49272
37165,229606832,229607205,True,3,373
37166,229608097,229627180,True,1,19083
37167,229646270,229721030,True,1,74760
37168,229646423,229646518,True,1,95
37169,229648295,229651283,True,1,2988
37170,229655762,229672371,True,3,16609
37171,229692089,229692630,False,1,541
37172,229693370,229693827,False,1,457
37173,229717921,229735252,True,1,17331
37174,229749526,229752334,True,1,2808
37175,229749534,229754058,True,1,4524
37176,229755444,229756963,False,1,1519
37177,229773212,229787513,True,1,14301
37178,229778190,229790000,True,1,11810
37179,229779137,229790332,True,1,11195
37180,229831232,229866351,True,1,35119
37181,229831350,229852130,True,1,20780
37182,229831350,229866351,True,1,35001
37183,229875880,229875958,True,3,78
37184,229875880,229877475,True,1,1595
37185,229895328,229896508,True,1,1180
37186,229901046,229905034,True,2,3988
37187,229962647,229966405,True,1,3758
37188,229966257,229966405,True,5,148
37189,230000968,230002479,True,6,1511
37190,230069085,230096320,False,1,27235
37191,230080296,230089312,True,1,9016
37192,230091656,230093706,True,7,2050
37193,230094379,230094552,False,1,173
37194,230094379,230094552,True,3,173
37195,230103559,230108417,True,1,4858
37196,230103651,230103768,True,1,117
37197,230128204,230142574,False,1,14370
37198,230160082,230166547,True,2,6465
37199,230160082,230166586,True,1,6504
37200,230170709,230173819,True,1,3110
37201,230218165,230220026,True,2,1861
37202,230221057,230222791,True,1,1734
37203,230236711,230238375,True,1,1664
37204,230255447,230257201,True,2,1754
37205,230281588,230282473,True,1,885
37206,230284648,230308461,True,4,23813
37207,230284648,230310090,True,1,25442
37208,230331453,230332190,False,3,737
37209,230331453,230332190,True,2,737
37210,230355421,230366292,True,1,10871
37211,230355421,230379983,True,1,24562
37212,230400313,231266711,True,1,866398
37213,230431612,230431977,True,2,365
37214,230438896,230440149,False,1,1253
37215,230438896,230440149,True,1,1253
37216,230464119,230480670,False,1,16551
37217,230497755,230497857,True,1,102
37218,230498645,230585582,True,2,86937
37219,230520370,230520765,False,1,395
37220,230520370,230520765,True,6,395
37221,230540376,230555557,False,1,15181
37222,230597159,230617132,False,1,19973
37223,230597159,230617132,True,1,19973
37224,230604026,230604176,True,1,150
37225,230621309,230637835,True,1,16526
37226,230625726,230640023,False,1,14297
37227,230625726,230640023,True,2,14297
37228,230629097,230631069,False,1,1972
37229,230629097,230631069,True,3,1972
37230,230639825,230641841,False,1,2016
37231,230662332,230666530,False,3,4198
37232,230684716,230724516,True,1,39800
37233,230684716,230737008,True,1,52292
37234,230697420,230698005,True,3,585
37235,230697423,230698005,True,1,582
37236,230774420,230776871,True,1,2451
37237,230795093,230795511,True,2,418
37238,230795093,230795514,False,1,421
37239,230795093,230795514,True,1,421
37240,230841516,230843918,True,1,2402
37241,230878028,230896171,True,2,18143
37242,230879164,230891148,True,1,11984
37243,230879164,230891181,True,1,12017
37244,230879164,230896678,True,2,17514
37245,230898703,230900595,True,1,1892
37246,230898703,230905199,False,1,6496
37247,230938308,230949892,True,1,11584
37248,231022732,231026228,True,3,3496
37249,231026570,231080187,True,1,53617
37250,231039740,231063643,True,1,23903
37251,231049726,231050745,True,1,1019
37252,231050470,231056668,True,1,6198
37253,231050470,231081899,True,1,31429
37254,231062049,231062738,True,1,689
37255,231088380,231128671,True,1,40291
37256,231088892,231129183,False,1,40291
37257,231135671,231136702,False,1,1031
37258,231135671,231136702,True,1,1031
37259,231144925,231148425,True,1,3500
37260,231156186,231157146,True,3,960
37261,231162099,231170931,True,2,8832
37262,231172457,231176908,False,1,4451
37263,231183808,231186630,True,1,2822
37264,231183808,231190788,True,1,6980
37265,231186026,231186793,True,1,767
37266,231189553,231191301,True,2,1748
37267,231201696,231213856,True,1,12160
37268,231229199,231232675,True,1,3476
37269,231254060,231254907,False,1,847
37270,231257138,231257691,False,1,553
37271,231257138,231258877,False,1,1739
37272,231283298,231289937,True,1,6639
37273,231288148,231301876,False,1,13728
37274,231498017,231499870,False,1,1853
37275,231498017,231499870,True,1,1853
37276,231520817,231521342,True,1,525
37277,231562757,231564261,True,1,1504
37278,231562757,231582527,True,4,19770
37279,231562757,231588017,True,1,25260
37280,231610721,231615813,True,3,5092
37281,231644628,231889059,True,1,244431
37282,231657964,231664782,True,1,6818
37283,231701334,231725132,True,3,23798
37284,231712695,231714677,True,1,1982
37285,231726084,231737590,True,2,11506
37286,231739435,231740190,False,1,755
37287,231750618,231751010,False,1,392
37288,231766958,231767616,False,1,658
37289,231766958,231767616,True,2,658
37290,231766958,231769191,True,1,2233
37291,231778399,231779286,False,1,887
37292,231803569,231804058,False,1,489
37293,231826597,231833242,True,2,6645
37294,231833145,231841823,False,1,8678
37295,231839117,231986325,True,1,147208
37296,231839532,231986496,True,1,146964
37297,231844454,231854264,True,1,9810
37298,231844454,231855138,True,1,10684
37299,231856234,231858537,True,3,2303
37300,231856294,231858030,False,7,1736
37301,231856294,231858030,True,1,1736
37302,231860009,231886389,False,1,26380
37303,231860009,231886389,True,1,26380
37304,231860009,231889598,False,1,29589
37305,231860009,231889598,True,1,29589
37306,231860009,231901542,False,1,41533
37307,231860009,231923875,False,1,63866
37308,231863725,231864303,True,1,578
37309,231878192,231886633,True,1,8441
37310,231878203,231886611,True,2,8408
37311,231879151,231886932,True,1,7781
37312,231881990,231885953,True,2,3963
37313,231898894,231899382,True,1,488
37314,231926407,231927560,True,1,1153
37315,231926472,231926976,True,1,504
37316,231967765,232002199,True,2,34434
37317,231998340,232007473,False,1,9133
37318,231998340,232007473,True,3,9133
37319,232016986,232021870,True,1,4884
37320,232059008,232063994,True,1,4986
37321,232075963,232076736,True,1,773
37322,232075963,232076739,True,1,776
37323,232110409,232111317,True,6,908
37324,232111443,232111561,True,1,118
37325,232118192,232118969,True,1,777
37326,232119873,232120610,True,1,737
37327,232119873,232121222,True,1,1349
37328,232151906,232152082,False,1,176
37329,232157119,232158683,False,1,1564
37330,232157119,232158683,True,3,1564
37331,232223871,232228329,True,2,4458
37332,232272506,232273428,True,2,922
37333,232279639,232279966,True,1,327
37334,232279639,232285677,True,1,6038
37335,232280598,232286120,True,1,5522
37336,232299232,232299846,True,3,614
37337,232329984,232331415,True,1,1431
37338,232330921,232331639,True,1,718
37339,232332853,232332988,True,1,135
37340,232333089,232365344,True,1,32255
37341,232340780,232341405,True,3,625
37342,232346215,232348657,True,1,2442
37343,232346439,232348744,True,1,2305
37344,232369280,232378469,True,2,9189
37345,232370576,232379145,True,1,8569
37346,232387000,232388469,True,7,1469
37347,232401611,232402254,True,5,643
37348,232414215,232429531,True,1,15316
37349,232452140,232467748,True,2,15608
37350,232486672,232488165,True,2,1493
37351,232526480,232526873,True,1,393
37352,232527616,232531426,True,2,3810
37353,232535344,232536207,True,1,863
37354,232597954,232644484,True,1,46530
37355,232625089,232648260,True,1,23171
37356,232625089,232651581,True,4,26492
37357,232654873,232672961,True,1,18088
37358,232654873,232683941,True,1,29068
37359,232655984,232673702,True,1,17718
37360,232679462,232703948,True,1,24486
37361,232679462,232710844,True,9,31382
37362,232686441,232687506,True,1,1065
37363,232687694,232688900,True,1,1206
37364,232690622,232697526,True,1,6904
37365,232712817,232712907,True,1,90
37366,232712999,232713141,True,1,142
37367,232722760,232888858,True,1,166098
37368,232728393,232728999,True,1,606
37369,232759999,232761833,True,2,1834
37370,232795583,232797590,True,1,2007
37371,232844184,232849403,True,1,5219
37372,232848035,232851279,True,4,3244
37373,232857902,232859834,False,3,1932
37374,232863049,232867782,True,1,4733
37375,232883208,232886584,True,1,3376
37376,232902279,232952366,False,1,50087
37377,232924176,232926982,False,1,2806
37378,233005266,233030741,False,1,25475
37379,233005266,233030741,True,1,25475
37380,233038453,233053768,True,2,15315
37381,233049297,233060245,False,1,10948
37382,233150793,233154942,True,1,4149
37383,233150982,233151437,False,1,455
37384,233163384,233172111,True,2,8727
37385,233187125,233333194,True,3,146069
37386,233188115,233188465,True,1,350
37387,233201201,233320666,True,1,119465
37388,233202705,233278123,False,1,75418
37389,233202705,233321641,True,1,118936
37390,233238176,233246745,True,2,8569
37391,233262834,233264433,True,1,1599
37392,233277254,233369956,True,5,92702
37393,233280684,233290039,False,1,9355
37394,233299050,233299761,True,1,711
37395,233308806,233309401,True,1,595
37396,233310020,233394766,True,1,84746
37397,233320954,233398936,True,1,77982
37398,233320954,233400085,True,1,79131
37399,233321868,233322385,True,2,517
37400,233323132,233323813,True,1,681
37401,233382077,233411346,True,1,29269
37402,233384014,233384790,True,1,776
37403,233384393,233412468,True,1,28075
37404,233395909,233400316,True,1,4407
37405,233396249,233400353,True,1,4104
37406,233401279,233401907,True,1,628
37407,233413595,233414183,True,1,588
37408,233424540,233424631,False,1,91
37409,233425674,233426352,False,1,678
37410,233430462,233431214,True,5,752
37411,233457047,233457611,True,1,564
37412,233502642,233524425,False,1,21783
37413,233505066,233510298,False,1,5232
37414,233508404,233510439,True,1,2035
37415,233519388,233529459,True,1,10071
37416,233565124,233565565,True,1,441
37417,233565124,233566976,True,1,1852
37418,233581452,233585123,True,1,3671
37419,233635886,233639292,True,3,3406
37420,233644957,233645610,True,1,653
37421,233645533,233646911,False,1,1378
37422,233647060,233648144,True,1,1084
37423,233647574,233648658,False,1,1084
37424,233666206,233669568,True,1,3362
37425,233700473,233715101,True,1,14628
37426,233700528,233715101,True,3,14573
37427,233706518,233709523,False,1,3005
37428,233706925,233733070,True,2,26145
37429,233708197,233708528,False,1,331
37430,233708197,233708528,True,1,331
37431,233785400,233786601,True,1,1201
37432,233785400,233787801,True,1,2401
37433,233785400,233794038,True,1,8638
37434,233830316,233841637,True,1,11321
37435,233831939,233842428,True,2,10489
37436,233833351,233843122,True,1,9771
37437,233835123,233854349,True,2,19226
37438,233836522,233843223,True,1,6701
37439,233852166,233852625,True,1,459
37440,233861711,233870537,False,1,8826
37441,233861711,233870537,True,1,8826
37442,233871134,233879002,False,1,7868
37443,233876113,233881570,True,2,5457
37444,233883557,233885137,False,1,1580
37445,233896105,233896883,False,1,778
37446,233896105,233901216,False,1,5111
37447,233896105,233908414,False,1,12309
37448,233913822,233923655,True,1,9833
37449,233925699,233926421,False,1,722
37450,233933973,233935496,True,1,1523
37451,233942493,233942995,False,1,502
37452,233942660,233945162,False,1,2502
37453,233994423,234010830,True,1,16407
37454,234004867,234012847,True,1,7980
37455,234007077,234010679,True,3,3602
37456,234014590,234015398,False,1,808
37457,234014590,234015760,False,1,1170
37458,234030133,234038154,False,2,8021
37459,234030133,234038154,True,4,8021
37460,234030133,234049483,False,1,19350
37461,234065133,234067569,True,8,2436
37462,234100100,234102068,True,4,1968
37463,234114599,234119006,False,1,4407
37464,234114599,234119006,True,1,4407
37465,234119300,234120906,True,1,1606
37466,234122917,234136390,False,1,13473
37467,234123210,234125847,True,1,2637
37468,234123741,234126378,False,1,2637
37469,234129025,234143005,True,1,13980
37470,234133078,234134050,False,1,972
37471,234139748,234141228,True,1,1480
37472,234140187,234143755,False,1,3568
37473,234140187,234143755,True,1,3568
37474,234140584,234143755,True,1,3171
37475,234145121,234146180,True,1,1059
37476,234146497,234146609,True,1,112
37477,234147217,234156497,True,1,9280
37478,234152859,234153182,True,1,323
37479,234154910,234156080,False,1,1170
37480,234170829,234171243,True,2,414
37481,234184366,234184780,True,1,414
37482,234196018,234200243,True,7,4225
37483,234206782,234208321,True,1,1539
37484,234206942,234208432,True,2,1490
37485,234227660,234230120,True,3,2460
37486,234237203,234239031,True,2,1828
37487,234240217,234264321,True,2,24104
37488,234243440,234243540,True,2,100
37489,234254834,234258474,True,1,3640
37490,234276351,234276472,True,1,121
37491,234309293,234311161,True,2,1868
37492,234316924,234317603,True,6,679
37493,234322578,234323629,True,1,1051
37494,234323259,234324031,False,1,772
37495,234329310,234330619,True,1,1309
37496,234329575,234329854,True,4,279
37497,234352270,234354243,True,3,1973
37498,234385046,234401773,True,1,16727
37499,234396194,234402385,True,1,6191
37500,234397036,234397332,True,1,296
37501,234397190,234404889,True,1,7699
37502,234397721,234405116,True,2,7395
37503,234397721,234408077,True,1,10356
37504,234399226,234404238,False,1,5012
37505,234465259,234465668,False,1,409
37506,234469429,234476464,False,1,7035
37507,234481651,234507062,True,1,25411
37508,234513440,234516803,True,1,3363
37509,234594260,234594336,True,3,76
37510,234597495,234603676,False,1,6181
37511,234597495,234617003,True,1,19508
37512,234598007,234599924,True,1,1917
37513,234697722,234714586,True,1,16864
37514,234697920,234714586,True,1,16666
37515,234700193,234704823,True,1,4630
37516,234702541,234708775,True,1,6234
37517,234747549,234753101,True,2,5552
37518,234773368,234775803,True,1,2435
37519,234778566,234780932,True,1,2366
37520,234857739,234859197,True,1,1458
37521,234905562,234937023,True,1,31461
37522,234953742,234956477,False,1,2735
37523,234953742,234956477,True,2,2735
37524,234960578,234992415,True,3,31837
37525,235053828,235054610,True,1,782
37526,235088853,235096841,True,4,7988
37527,235100100,235101599,True,2,1499
37528,235165666,235175178,True,3,9512
37529,235173727,235176063,True,2,2336
37530,235205944,235206023,True,2,79
37531,235219494,235231664,False,1,12170
37532,235219494,235231664,True,1,12170
37533,235236690,235237674,False,1,984
37534,235259907,235306557,True,1,46650
37535,235278765,235280379,True,1,1614
37536,235299075,235301795,True,4,2720
37537,235308751,235309655,True,2,904
37538,235312066,235322127,True,1,10061
37539,235314396,235315762,True,2,1366
37540,235330029,235331530,True,1,1501
37541,235341706,235408740,True,1,67034
37542,235374055,235376441,False,1,2386
37543,235374055,235376441,True,4,2386
37544,235381876,235382168,True,4,292
37545,235385386,235387321,True,1,1935
37546,235390825,235395311,True,1,4486
37547,235416682,235418184,True,5,1502
37548,235544335,235545723,True,2,1388
37549,235547922,235548124,True,1,202
37550,235548281,235548431,True,1,150
37551,235557771,235561170,True,1,3399
37552,235558008,235559028,True,1,1020
37553,235565399,235568103,True,2,2704
37554,235583373,235584169,True,1,796
37555,235607875,235628747,True,2,20872
37556,235640496,235641523,True,3,1027
37557,235648393,235649791,True,1,1398
37558,235714354,235714425,True,1,71
37559,235714354,235714502,True,1,148
37560,235714354,235716200,True,2,1846
37561,235714642,235716209,True,1,1567
37562,235716668,235717606,True,1,938
37563,235718102,235719355,True,1,1253
37564,235720959,235722246,True,1,1287
37565,235723247,235736536,True,2,13289
37566,235729774,235739194,True,1,9420
37567,235765979,235769447,True,2,3468
37568,235773010,235789020,False,2,16010
37569,235773010,235816316,False,2,43306
37570,235773010,235843950,False,1,70940
37571,235773886,235774320,True,1,434
37572,235795826,235798281,True,1,2455
37573,235808243,235899549,True,1,91306
37574,235821191,235854890,True,1,33699
37575,235821191,235867417,True,1,46226
37576,235895746,235913255,True,2,17509
37577,235895746,235913261,False,1,17515
37578,235895746,235913261,True,4,17515
37579,235901269,235905258,True,1,3989
37580,235915754,235916086,True,1,332
37581,235925135,235925767,True,1,632
37582,235926547,235982417,True,1,55870
37583,235926547,236014645,True,1,88098
37584,235931100,235935228,True,1,4128
37585,235947256,235949294,False,1,2038
37586,235991069,236049513,False,1,58444
37587,235993864,236010819,True,1,16955
37588,236011926,236016011,True,3,4085
37589,236071319,236072316,True,1,997
37590,236129573,236131889,False,1,2316
37591,236129573,236131889,True,5,2316
37592,236136255,236138636,True,1,2381
37593,236137518,236139899,True,1,2381
37594,236168064,236168396,True,1,332
37595,236200970,236204508,False,2,3538
37596,236200970,236204508,True,2,3538
37597,236218272,236221018,False,1,2746
37598,236218272,236221018,True,2,2746
37599,236221202,236222600,True,1,1398
37600,236250078,236252081,True,1,2003
37601,236255655,236258394,True,1,2739
37602,236294973,236306392,True,1,11419
37603,236294973,236306527,True,1,11554
37604,236297378,236314065,True,1,16687
37605,236349350,236356351,True,1,7001
37606,236350785,236350901,True,2,116
37607,236374996,236383644,True,1,8648
37608,236419730,236419952,True,3,222
37609,236428064,236429573,True,1,1509
37610,236430251,236434798,True,1,4547
37611,236439506,236440197,True,1,691
37612,236454911,236497037,True,1,42126
37613,236457750,236704294,True,1,246544
37614,236460684,236466048,True,2,5364
37615,236504156,236539988,False,1,35832
37616,236504209,236539988,False,1,35779
37617,236544535,236548473,False,1,3938
37618,236544535,236549753,True,1,5218
37619,236610897,236611030,True,1,133
37620,236614863,236616941,True,1,2078
37621,236614863,236646692,True,2,31829
37622,236664070,236669158,False,1,5088
37623,236679048,236684381,True,1,5333
37624,236700996,236701129,True,2,133
37625,236701078,236701167,False,1,89
37626,236701078,236701167,True,1,89
37627,236705236,236705564,False,1,328
37628,236705236,236705564,True,1,328
37629,236705236,236707325,True,1,2089
37630,236740864,236744480,True,1,3616
37631,236740864,236747322,True,1,6458
37632,236760954,236761280,False,2,326
37633,236760954,236761280,True,1,326
37634,236796536,236796844,True,2,308
37635,236796536,236797525,True,1,989
37636,236803751,236804290,True,8,539
37637,236803751,236804293,True,1,542
37638,236813851,236814147,True,1,296
37639,236814434,236840755,True,3,26321
37640,236819344,236826735,True,1,7391
37641,236830968,236831364,True,2,396
37642,236840617,236844286,True,1,3669
37643,236846890,236847476,True,1,586
37644,236849133,236851563,True,1,2430
37645,236865631,236866610,True,2,979
37646,236886366,236887434,True,1,1068
37647,236886366,236895060,True,1,8694
37648,236886366,236896993,True,1,10627
37649,236909202,236909998,True,2,796
37650,236909202,236911380,True,2,2178
37651,236942654,236943280,True,3,626
37652,236944776,236948280,False,1,3504
37653,236944776,236948280,True,2,3504
37654,236945608,236946620,True,1,1012
37655,236954599,236961219,True,1,6620
37656,236956719,236962834,True,3,6115
37657,236957018,236962979,False,1,5961
37658,236992959,237002707,True,1,9748
37659,236997386,236999942,True,1,2556
37660,237001493,237002616,True,1,1123
37661,237005399,237005503,True,1,104
37662,237005399,237008738,True,1,3339
37663,237005896,237007577,True,1,1681
37664,237017095,237020396,True,1,3301
37665,237024770,237025238,True,1,468
37666,237025868,237027272,True,1,1404
37667,237057984,237057985,True,1,1
37668,237058091,237058328,True,2,237
37669,237063665,237063774,True,1,109
37670,237066256,237073852,True,2,7596
37671,237066898,237073678,False,1,6780
37672,237066898,237073678,True,2,6780
37673,237120867,237129436,False,1,8569
37674,237144692,237147272,True,1,2580
37675,237145117,237146690,True,1,1573
37676,237148018,237149711,True,2,1693
37677,237169090,237181048,True,1,11958
37678,237176568,237177635,True,4,1067
37679,237201709,237202063,False,1,354
37680,237201709,237202767,False,1,1058
37681,237204951,237205984,True,1,1033
37682,237209019,237332926,True,2,123907
37683,237218264,237224154,True,1,5890
37684,237218264,237237181,True,1,18917
37685,237232230,237259444,True,1,27214
37686,237241278,237243884,True,3,2606
37687,237241286,237242971,True,6,1685
37688,237288964,237304161,True,3,15197
37689,237288964,237314186,True,1,25222
37690,237301302,237317191,False,1,15889
37691,237319873,237321096,True,2,1223
37692,237323955,237325629,False,1,1674
37693,237338195,237397378,True,1,59183
37694,237345863,237347400,True,3,1537
37695,237351025,237361664,True,1,10639
37696,237383411,237420104,True,1,36693
37697,237388308,237390596,True,1,2288
37698,237417216,237417360,True,2,144
37699,237429856,237430846,True,1,990
37700,237447571,237448643,True,3,1072
37701,237500392,237502361,False,1,1969
37702,237500392,237508983,True,1,8591
37703,237500392,237512966,True,1,12574
37704,237503657,237514187,True,1,10530
37705,237504922,237510204,True,1,5282
37706,237509175,237518777,True,1,9602
37707,237518590,237522527,True,1,3937
37708,237526389,237530239,True,2,3850
37709,237537067,237537474,True,2,407
37710,237568665,237572167,True,2,3502
37711,237576465,237580145,True,2,3680
37712,237576465,237597738,True,1,21273
37713,237576717,237580209,True,2,3492
37714,237623737,237628560,True,1,4823
37715,237624742,237625433,True,2,691
37716,237625622,237645053,True,3,19431
37717,237628995,237632322,True,1,3327
37718,237654143,237654598,True,1,455
37719,237685118,237691906,False,1,6788
37720,237685118,237691906,True,1,6788
37721,237692166,237700042,True,1,7876
37722,237692166,237706820,True,1,14654
37723,237699057,237699156,True,1,99
37724,237721669,237725083,True,1,3414
37725,237731430,237732021,True,2,591
37726,237737878,237737989,False,3,111
37727,237737878,237737989,True,1,111
37728,237738996,237749427,True,1,10431
37729,237772889,237772970,True,1,81
37730,237773676,237839811,True,1,66135
37731,237778920,237779091,True,4,171
37732,237779844,237779980,True,1,136
37733,237784909,237797983,True,1,13074
37734,237784909,237799044,True,1,14135
37735,237786894,237788781,True,1,1887
37736,237790846,237790959,False,1,113
37737,237790846,237790959,True,4,113
37738,237811217,237812180,True,1,963
37739,237831261,237831386,True,5,125
37740,237832936,237865501,True,1,32565
37741,237838041,237838145,False,1,104
37742,237838517,237846535,False,1,8018
37743,237839644,237839995,True,1,351
37744,237841161,237844335,True,1,3174
37745,237862116,237865673,True,3,3557
37746,237865777,237868081,True,1,2304
37747,237870277,237872643,True,1,2366
37748,237877212,237878399,True,1,1187
37749,237877444,237878413,True,1,969
37750,237899927,237919165,True,1,19238
37751,237899927,237977566,True,1,77639
37752,237909838,237929681,True,1,19843
37753,237911246,237930408,True,2,19162
37754,237911362,237914549,True,3,3187
37755,237911453,237914549,True,1,3096
37756,237914221,237917667,True,1,3446
37757,237917484,237917659,True,1,175
37758,237930786,237933694,True,3,2908
37759,237930786,237934906,True,1,4120
37760,237934985,237935062,True,3,77
37761,237935351,237935516,True,1,165
37762,237936417,237938190,True,1,1773
37763,237936978,237939706,True,2,2728
37764,237956897,237958904,True,2,2007
37765,237984581,237986508,True,1,1927
37766,237984581,237989875,True,3,5294
37767,238001314,238001771,True,2,457
37768,238005431,238005517,True,1,86
37769,238011709,238012998,True,1,1289
37770,238027070,238097380,True,1,70310
37771,238039822,238040411,True,1,589
37772,238040696,238040960,True,1,264
37773,238059885,238060051,True,3,166
37774,238079039,238081499,True,2,2460
37775,238079069,238081502,True,2,2433
37776,238079490,238081542,True,1,2052
37777,238087587,238092300,True,1,4713
37778,238112384,238112721,True,1,337
37779,238112384,238112797,True,3,413
37780,238112869,238113007,True,1,138
37781,238118369,238122989,True,2,4620
37782,238122123,238122379,True,1,256
37783,238154307,238180141,True,1,25834
37784,238272068,238281919,True,1,9851
37785,238298867,238301413,True,2,2546
37786,238340697,238424960,False,1,84263
37787,238359858,238360290,True,1,432
37788,238360957,238361796,False,1,839
37789,238375408,238375635,True,1,227
37790,238375408,238375656,True,1,248
37791,238375408,238375690,True,1,282
37792,238375737,238376449,False,1,712
37793,238375737,238376449,True,2,712
37794,238375870,238390389,True,5,14519
37795,238399863,238400013,False,1,150
37796,238399863,238400458,False,1,595
37797,238400208,238400458,False,1,250
37798,238404590,238405176,True,1,586
37799,238411665,238593491,False,1,181826
37800,238411665,238593491,True,1,181826
37801,238413038,238416091,True,1,3053
37802,238420209,238420543,True,1,334
37803,238424513,238425335,True,1,822
37804,238430926,238437169,True,1,6243
37805,238435141,238436907,False,1,1766
37806,238435141,238436907,True,1,1766
37807,238435537,238437288,False,1,1751
37808,238453556,238453819,True,3,263
37809,238464695,238466219,True,1,1524
37810,238486270,238489787,True,1,3517
37811,238487735,238489717,True,1,1982
37812,238493267,238502561,True,1,9294
37813,238493267,238509974,True,1,16707
37814,238494225,238495333,False,2,1108
37815,238505105,238518176,False,1,13071
37816,238505105,238518176,True,1,13071
37817,238526903,238539663,True,1,12760
37818,238533184,238569278,False,1,36094
37819,238562344,238562927,False,1,583
37820,238562344,238563919,True,3,1575
37821,238578884,238579413,True,1,529
37822,238585201,238585385,True,1,184
37823,238597220,238597918,True,1,698
37824,238597220,238599501,True,1,2281
37825,238597220,238603652,True,1,6432
37826,238602225,238606041,True,1,3816
37827,238605139,238607096,True,1,1957
37828,238605139,238609529,True,1,4390
37829,238633527,238642313,False,1,8786
37830,238633527,238642313,True,2,8786
37831,238633527,238644309,True,1,10782
37832,238722315,238723119,True,2,804
37833,238722315,238727871,True,7,5556
37834,238722315,238728012,True,4,5697
37835,238722315,238734257,False,1,11942
37836,238722315,238745003,False,1,22688
37837,238742403,238744386,False,1,1983
37838,238749006,238753723,True,1,4717
37839,238769438,238771128,True,1,1690
37840,238769438,238771873,True,1,2435
37841,238776883,238782361,True,1,5478
37842,238780302,238780394,False,1,92
37843,238782165,238842295,True,1,60130
37844,238787387,238794601,True,3,7214
37845,238839117,238959338,True,1,120221
37846,238843937,238847522,True,4,3585
37847,238843937,238848117,True,1,4180
37848,238843937,238849304,True,1,5367
37849,238844000,238847536,True,1,3536
37850,238851227,238852255,True,1,1028
37851,238853804,238859153,True,1,5349
37852,238853804,238867314,True,1,13510
37853,238868518,238868926,True,1,408
37854,238875034,238881966,True,1,6932
37855,238899240,238909519,True,1,10279
37856,238899240,238909522,True,1,10282
37857,238933036,238933141,False,1,105
37858,238938750,238939086,False,1,336
37859,238992025,238996317,True,4,4292
37860,238999475,238999840,True,1,365
37861,239000477,239025404,True,2,24927
37862,239003255,239027630,True,1,24375
37863,239017764,239018246,True,1,482
37864,239025977,239029992,False,1,4015
37865,239055789,239059730,True,1,3941
37866,239060495,239061453,True,1,958
37867,239067709,239077569,True,1,9860
37868,239086503,239102901,True,2,16398
37869,239086503,239123065,True,1,36562
37870,239090455,239090965,True,1,510
37871,239122483,239135585,True,2,13102
37872,239125319,239135585,True,1,10266
37873,239143496,239145931,True,2,2435
37874,239149820,239150554,True,4,734
37875,239149849,239150554,True,1,705
37876,239152999,239164366,True,1,11367
37877,239171596,239179894,False,1,8298
37878,239200576,239203626,True,1,3050
37879,239213328,239215649,True,1,2321
37880,239234078,239241422,True,1,7344
37881,239266664,239267011,False,1,347
37882,239288787,239293691,False,1,4904
37883,239288787,239293691,True,2,4904
37884,239302944,239304168,True,1,1224
37885,239314605,239316295,False,1,1690
37886,239319156,239322400,True,3,3244
37887,239347894,239352725,False,1,4831
37888,239366463,239367415,False,2,952
37889,239366463,239372621,False,1,6158
37890,239366463,239376233,False,1,9770
37891,239399717,239402111,True,1,2394
37892,239399717,239426478,True,1,26761
37893,239437802,239445833,False,1,8031
37894,239444115,239444204,False,1,89
37895,239475845,239477003,True,1,1158
37896,239477273,239477811,True,1,538
37897,239478658,239479176,True,1,518
37898,239520554,239520637,True,1,83
37899,239520554,239523298,True,1,2744
37900,239533162,239539000,True,2,5838
37901,239545587,239639002,True,1,93415
37902,239550069,239550984,False,1,915
37903,239600358,239616880,True,1,16522
37904,239600358,239821665,True,1,221307
37905,239612945,239615352,False,5,2407
37906,239620291,239754578,True,4,134287
37907,239627630,239628652,False,1,1022
37908,239651867,239817146,False,1,165279
37909,239771558,239776484,True,2,4926
37910,239822926,239834526,True,1,11600
37911,239822926,239835100,True,1,12174
37912,239828375,239828978,True,1,603
37913,239829522,240286676,True,1,457154
37914,239872796,239874526,True,1,1730
37915,239877689,239879707,False,1,2018
37916,239889320,239892364,True,1,3044
37917,239905718,239906966,True,1,1248
37918,239915266,239915505,True,1,239
37919,239915453,239919308,True,1,3855
37920,239915567,239915694,True,2,127
37921,239962847,239969577,True,1,6730
37922,239962847,239978320,True,1,15473
37923,239962847,239984446,True,2,21599
37924,239965177,239966236,False,1,1059
37925,239965177,239968037,False,1,2860
37926,239965177,239968037,True,3,2860
37927,240013045,240014168,True,1,1123
37928,240022828,240023965,True,1,1137
37929,240022828,240075454,True,1,52626
37930,240063102,240098802,True,1,35700
37931,240093830,240097282,True,1,3452
37932,240099710,240099838,True,1,128
37933,240100184,240104064,True,1,3880
37934,240114075,240114603,True,1,528
37935,240120143,240129215,False,1,9072
37936,240120143,240129215,True,4,9072
37937,240135528,240136665,True,1,1137
37938,240138991,240139288,True,2,297
37939,240145250,240146387,True,1,1137
37940,240154970,240156107,True,1,1137
37941,240159091,240181340,True,1,22249
37942,240163964,240178114,True,1,14150
37943,240164692,240165829,True,1,1137
37944,240174412,240175549,True,1,1137
37945,240184178,240185315,True,2,1137
37946,240193900,240195037,True,1,1137
37947,240203620,240204757,True,1,1137
37948,240211606,240211795,True,1,189
37949,240211968,240215864,True,1,3896
37950,240213340,240214477,True,1,1137
37951,240214764,240224504,True,1,9740
37952,240221982,240228058,True,3,6076
37953,240223060,240224197,True,1,1137
37954,240228903,240231788,True,2,2885
37955,240229069,240229376,False,1,307
37956,240232780,240233917,True,1,1137
37957,240241581,240244758,False,1,3177
37958,240249139,240249480,False,1,341
37959,240249139,240249480,True,1,341
37960,240249139,240249636,True,1,497
37961,240249139,240249641,True,1,502
37962,240249139,240250265,True,1,1126
37963,240249218,240249685,True,1,467
37964,240249218,240249690,True,1,472
37965,240249218,240250314,True,1,1096
37966,240249413,240249756,True,1,343
37967,240249413,240250385,False,1,972
37968,240249654,240251548,True,3,1894
37969,240249932,240250590,True,1,658
37970,240250757,240251012,True,1,255
37971,240258634,240259502,True,1,868
37972,240267809,240269004,True,2,1195
37973,240321430,240326862,True,1,5432
37974,240328738,240330495,True,1,1757
37975,240352690,240354382,True,1,1692
37976,240377111,240377895,True,1,784
37977,240378945,240383908,True,1,4963
37978,240391914,240393666,True,2,1752
37979,240391914,240393985,True,2,2071
37980,240391914,240393996,True,1,2082
37981,240391914,240394010,True,1,2096
37982,240391914,240396521,True,1,4607
37983,240395251,240396550,True,2,1299
37984,240415601,240484442,True,3,68841
37985,240437507,240439062,True,2,1555
37986,240441386,240441386,True,1,0
37987,240478650,240479093,True,1,443
37988,240509201,240518209,True,3,9008
37989,240512221,240532851,True,2,20630
37990,240526193,240528246,True,1,2053
37991,240582082,240584036,True,2,1954
37992,240582481,240584443,True,1,1962
37993,240598670,240624332,False,1,25662
37994,240599956,240602380,True,1,2424
37995,240604093,240605666,True,3,1573
37996,240630513,240635083,True,2,4570
37997,240657970,240658062,True,1,92
37998,240673948,240677758,True,2,3810
37999,240690733,240696269,True,1,5536
38000,240694390,240699006,True,2,4616
38001,240707677,240707941,True,1,264
38002,240742004,240746123,False,1,4119
38003,240752225,240757273,False,1,5048
38004,240754914,240756005,True,1,1091
38005,240765063,240906859,True,1,141796
38006,240814262,240814821,True,1,559
38007,240835442,240837872,True,3,2430
38008,240855748,240863970,False,1,8222
38009,240855748,240863970,True,2,8222
38010,240856324,240873974,True,2,17650
38011,240857407,240857533,True,1,126
38012,240867146,240867493,False,1,347
38013,240867605,240879126,False,1,11521
38014,240870578,240959536,True,1,88958
38015,240870578,240966120,True,1,95542
38016,240873543,240875148,True,1,1605
38017,240873594,240875148,True,2,1554
38018,240873594,240879974,False,1,6380
38019,240873935,240875148,True,1,1213
38020,240886173,240886601,True,1,428
38021,240913492,240914461,True,1,969
38022,240923198,240930925,True,1,7727
38023,240933295,240936927,True,1,3632
38024,240933295,240937291,True,1,3996
38025,240933295,240941117,True,1,7822
38026,240955962,240957638,True,1,1676
38027,240986202,240988906,True,2,2704
38028,241005123,241011864,True,1,6741
38029,241019030,241019738,True,1,708
38030,241035166,241084617,True,1,49451
38031,241062086,241204377,True,1,142291
38032,241068075,241069511,True,2,1436
38033,241068075,241069730,True,1,1655
38034,241105227,241107400,False,1,2173
38035,241130791,241132091,True,1,1300
38036,241139247,241144411,True,5,5164
38037,241181794,241182032,True,6,238
38038,241182458,241184525,True,1,2067
38039,241254230,241255465,True,2,1235
38040,241257716,241258193,True,1,477
38041,241259028,241284821,True,1,25793
38042,241259368,241285161,True,1,25793
38043,241269239,241269625,True,3,386
38044,241278322,241283439,False,1,5117
38045,241279397,241279749,True,1,352
38046,241298624,241299884,False,1,1260
38047,241298624,241299884,True,6,1260
38048,241374758,241377349,True,1,2591
38049,241405768,241407108,True,1,1340
38050,241433344,241454393,True,1,21049
38051,241440651,241442050,False,1,1399
38052,241480304,241481485,True,1,1181
38053,241487439,241497785,True,1,10346
38054,241520033,241522648,True,1,2615
38055,241520033,241523575,True,1,3542
38056,241541389,241547254,True,3,5865
38057,241542041,241547435,True,1,5394
38058,241560040,241562503,True,1,2463
38059,241590320,241591169,True,2,849
38060,241595396,241598949,True,1,3553
38061,241669213,241669349,True,1,136
38062,241678989,241680977,True,1,1988
38063,241679276,241681384,True,1,2108
38064,241693421,241696677,True,1,3256
38065,241727319,241728431,True,1,1112
38066,241727319,241731068,True,2,3749
38067,241727319,241731088,False,1,3769
38068,241727319,241731088,True,1,3769
38069,241751924,241752072,True,1,148
38070,241764521,241765790,True,1,1269
38071,241768604,241768698,False,1,94
38072,241768604,241768698,True,1,94
38073,241772107,241826537,True,1,54430
38074,241772107,241863369,True,1,91262
38075,241789665,241811183,True,1,21518
38076,241789812,241801252,False,1,11440
38077,241789812,241811193,True,2,21381
38078,241799435,241801221,True,1,1786
38079,241801255,241802187,False,1,932
38080,241801255,241806170,True,2,4915
38081,241806531,241810164,True,1,3633
38082,241812452,241820745,False,1,8293
38083,241815566,241841876,True,1,26310
38084,241853544,241854456,False,1,912
38085,241853544,241856164,True,2,2620
38086,241855259,241855901,True,2,642
38087,241856261,241857683,True,1,1422
38088,241858053,241861764,False,1,3711
38089,241859780,241863866,True,1,4086
38090,241867877,241868061,True,1,184
38091,241867877,241868075,True,1,198
38092,241882769,241882852,True,2,83
38093,241930954,241935039,True,1,4085
38094,241934677,242053222,True,2,118545
38095,241936096,242053960,True,1,117864
38096,241938530,241938708,True,1,178
38097,241939491,241948553,True,1,9062
38098,241944902,241956337,False,1,11435
38099,241944902,241956337,True,1,11435
38100,241946812,241949912,True,1,3100
38101,241962023,241962605,True,2,582
38102,241968611,241974507,True,1,5896
38103,241979508,241980099,True,2,591
38104,241995340,242033831,True,1,38491
38105,242020969,242046605,False,1,25636
38106,242020969,242046605,True,2,25636
38107,242034062,242034162,True,2,100
38108,242157563,242176100,True,1,18537
38109,242176794,242182203,True,1,5409
38110,242176794,242185988,True,1,9194
38111,242187710,242191314,True,1,3604
38112,242207930,242210391,True,1,2461
38113,242214367,242222981,True,1,8614
38114,242250282,242256840,True,1,6558
38115,242274925,242297389,True,1,22464
38116,242296758,242299312,True,1,2554
38117,242301536,242302035,True,2,499
38118,242326912,242337460,True,3,10548
38119,242327304,242328397,True,2,1093
38120,242327363,242337649,True,1,10286
38121,242403185,242404376,True,2,1191
38122,242418214,242419077,True,1,863
38123,242418214,242424975,True,1,6761
38124,242519109,242534357,True,3,15248
38125,242522166,242559215,False,1,37049
38126,242564686,242572621,True,1,7935
38127,242573637,242576324,True,1,2687
38128,242595418,242607544,True,1,12126
38129,242613134,242613983,True,1,849
38130,242624518,242651560,True,1,27042
38131,242638647,242641421,False,1,2774
38132,242646236,242663625,True,1,17389
38133,242668280,242669098,True,4,818
38134,242672837,242673083,True,1,246
38135,242701074,242701191,True,2,117
38136,242702588,242703090,False,1,502
38137,242726534,242726630,True,1,96
38138,242765506,242765816,True,4,310
38139,242801333,242804635,True,5,3302
38140,242802662,242812623,True,1,9961
38141,242816446,242834310,False,1,17864
38142,242816446,242834310,True,1,17864
38143,242822248,242840242,True,2,17994
38144,242830363,242831244,True,2,881
38145,242832948,242851745,True,1,18797
38146,242833096,242850871,True,1,17775
38147,242833096,242851745,True,1,18649
38148,242833445,242843182,False,1,9737
38149,242833445,242843182,True,5,9737
38150,242833445,242847869,True,1,14424
38151,242868530,242870523,False,1,1993
38152,242868530,242870523,True,2,1993
38153,242883139,242883651,True,2,512
38154,242883532,242884041,True,3,509
38155,242895315,242895456,True,1,141
38156,242915465,242916308,False,1,843
38157,242915465,242916308,True,2,843
38158,242916955,242919885,True,2,2930
38159,242916955,242927337,True,1,10382
38160,242922733,242922835,True,1,102
38161,242930592,242952686,True,1,22094
38162,242971429,242996144,True,2,24715
38163,242978030,242980011,False,1,1981
38164,242978030,242980011,True,2,1981
38165,242986455,243048063,True,1,61608
38166,242987683,243048687,True,1,61004
38167,242991827,243011113,True,1,19286
38168,243026769,243081366,True,3,54597
38169,243099193,243102032,True,1,2839
38170,243099870,243104721,False,1,4851
38171,243099870,243104721,True,4,4851
38172,243108271,243109067,False,1,796
38173,243108271,243117331,True,2,9060
38174,243109910,243239801,True,3,129891
38175,243109910,243263683,True,1,153773
38176,243141519,243163207,False,1,21688
38177,243141519,243163207,True,4,21688
38178,243157819,243159124,True,1,1305
38179,243166103,243169823,True,1,3720
38180,243180027,243180437,True,3,410
38181,243205231,243209416,True,1,4185
38182,243226598,243228421,True,2,1823
38183,243232358,243247390,True,3,15032
38184,243294862,243374167,True,1,79305
38185,243295764,243302419,True,1,6655
38186,243295764,243302598,False,3,6834
38187,243295764,243302598,True,3,6834
38188,243295764,243307377,True,1,11613
38189,243295798,243372079,True,1,76281
38190,243295798,243374601,True,5,78803
38191,243297133,243375300,True,1,78167
38192,243304541,243310021,True,1,5480
38193,243304541,243314393,True,1,9852
38194,243353839,243357868,True,2,4029
38195,243354166,243357868,True,3,3702
38196,243354166,243358435,True,3,4269
38197,243358063,243359354,False,1,1291
38198,243363322,243363764,True,2,442
38199,243413424,243418164,True,4,4740
38200,243424246,243442811,True,1,18565
38201,243430258,243431487,False,2,1229
38202,243430258,243431487,True,3,1229
38203,243453669,243463462,False,1,9793
38204,243453669,243463462,True,1,9793
38205,243453669,243466269,True,2,12600
38206,243474946,243476723,True,1,1777
38207,243492541,243493549,False,1,1008
38208,243492541,243493549,True,5,1008
38209,243513722,243524720,True,3,10998
38210,243518928,243533070,True,1,14142
38211,243545223,243558431,False,1,13208
38212,243547104,243551508,False,1,4404
38213,243548558,243584654,True,2,36096
38214,243548558,243596565,True,1,48007
38215,243560277,243565388,True,1,5111
38216,243593587,243607141,True,2,13554
38217,243675906,243678428,True,2,2522
38218,243675906,243691845,True,1,15939
38219,243675906,243693547,True,1,17641
38220,243734865,243734973,True,1,108
38221,243734865,243734977,True,1,112
38222,243734865,243734993,True,1,128
38223,243734865,243735042,False,1,177
38224,243734865,243735042,True,2,177
38225,243735171,243744557,True,3,9386
38226,243735171,243757820,True,1,22649
38227,243736351,243745737,True,1,9386
38228,243798589,243803056,False,1,4467
38229,243805188,243875322,True,1,70134
38230,243806556,243875973,True,1,69417
38231,243859409,243899902,True,1,40493
38232,243864129,243879029,True,1,14900
38233,243883856,243884298,True,2,442
38234,243888033,243888336,False,1,303
38235,243915593,243917864,True,1,2271
38236,243918869,243924006,True,5,5137
38237,243922240,243930893,False,1,8653
38238,243922240,243931966,False,1,9726
38239,243922258,243930890,False,1,8632
38240,243922258,243986067,False,1,63809
38241,243929765,243939228,False,1,9463
38242,243952330,243976828,True,1,24498
38243,243956126,243957299,False,1,1173
38244,243956126,243957299,True,1,1173
38245,243956126,243965828,True,1,9702
38246,244088215,244100402,True,1,12187
38247,244102149,244214033,False,1,111884
38248,244106380,244112340,True,1,5960
38249,244106380,244115532,True,2,9152
38250,244129410,244143399,True,1,13989
38251,244151226,244153639,True,1,2413
38252,244157201,244160248,True,1,3047
38253,244178842,244179924,False,1,1082
38254,244178842,244179924,True,1,1082
38255,244193874,244199963,False,5,6089
38256,244193874,244199963,True,7,6089
38257,244206168,244224627,True,2,18459
38258,244221596,244241649,True,1,20053
38259,244222147,244241649,True,1,19502
38260,244244565,244246867,True,1,2302
38261,244286766,244287130,True,5,364
38262,244301527,244332190,True,2,30663
38263,244318332,244321025,True,1,2693
38264,244362547,244453586,True,3,91039
38265,244428520,244428896,False,1,376
38266,244433227,244434435,True,1,1208
38267,244433338,244479793,True,5,46455
38268,244437304,244437379,True,1,75
38269,244466804,244467267,False,1,463
38270,244474640,244474828,False,1,188
38271,244485454,244485659,True,2,205
38272,244494349,244501772,True,6,7423
38273,244500665,244501375,False,1,710
38274,244500665,244501375,True,2,710
38275,244505808,244506398,True,1,590
38276,244523052,244562748,True,1,39696
38277,244526206,244526418,True,1,212
38278,244555176,244555268,True,2,92
38279,244566644,244567888,True,2,1244
38280,244593148,244621229,True,2,28081
38281,244626778,244626962,True,1,184
38282,244636591,244637777,False,1,1186
38283,244636591,244637777,True,3,1186
38284,244637616,244638446,True,1,830
38285,244653536,244659279,False,2,5743
38286,244653536,244659279,True,1,5743
38287,244653536,244667546,True,1,14010
38288,244669228,244670384,True,2,1156
38289,244713063,244715652,True,1,2589
38290,244713076,244715652,True,1,2576
38291,244718775,244720554,True,1,1779
38292,244729300,244736389,True,1,7089
38293,244799588,244803701,True,1,4113
38294,244815186,244815271,False,2,85
38295,244815243,244815439,False,1,196
38296,244822537,244825418,True,1,2881
38297,244828781,244832507,False,1,3726
38298,244838651,244840756,True,1,2105
38299,244838718,244840823,True,1,2105
38300,244850054,244850533,True,1,479
38301,244851995,244861041,False,1,9046
38302,244918565,244918691,True,2,126
38303,244919949,244928464,True,2,8515
38304,244948384,244951723,True,1,3339
38305,244970008,244970382,True,1,374
38306,244976638,244977628,True,1,990
38307,245026541,245027934,True,3,1393
38308,245026541,245029404,False,1,2863
38309,245026541,245032103,False,1,5562
38310,245026541,245033699,False,1,7158
38311,245026649,245032103,True,1,5454
38312,245028282,245039602,False,1,11320
38313,245028282,245039602,True,1,11320
38314,245028282,245059545,True,1,31263
38315,245033823,245128452,True,1,94629
38316,245044510,245057568,False,1,13058
38317,245053315,245173322,True,1,120007
38318,245178833,245179906,True,2,1073
38319,245196249,245197672,False,1,1423
38320,245221704,245222720,True,2,1016
38321,245224182,245230188,True,1,6006
38322,245224944,245226111,True,1,1167
38323,245230870,245233283,True,1,2413
38324,245236363,245237598,True,1,1235
38325,245252548,245254613,True,1,2065
38326,245257187,245257724,False,1,537
38327,245257187,245257724,True,5,537
38328,245264178,245264286,True,1,108
38329,245281730,245281846,False,1,116
38330,245303993,245305013,False,1,1020
38331,245304594,245321329,False,1,16735
38332,245304594,245321329,True,1,16735
38333,245313864,245314965,True,1,1101
38334,245335507,245336730,True,1,1223
38335,245349531,245350541,True,1,1010
38336,245361713,245362775,True,1,1062
38337,245363025,245366214,True,3,3189
38338,245376575,245377294,True,1,719
38339,245376575,245379090,True,1,2515
38340,245385332,245393241,False,2,7909
38341,245385332,245393241,True,3,7909
38342,245418554,245430028,True,1,11474
38343,245433067,245433438,True,1,371
38344,245441670,245454211,True,3,12541
38345,245445116,245445451,True,2,335
38346,245445823,245446574,True,1,751
38347,245451690,245454469,False,1,2779
38348,245466341,245468431,True,1,2090
38349,245469600,245479178,True,1,9578
38350,245473326,245480494,False,1,7168
38351,245476439,245476795,True,1,356
38352,245490657,245492538,False,1,1881
38353,245490657,245492538,True,1,1881
38354,245492631,245494782,True,1,2151
38355,245498305,245498436,True,1,131
38356,245506915,245509702,True,2,2787
38357,245509296,245511110,True,2,1814
38358,245513627,245514563,True,4,936
38359,245523362,245527080,True,1,3718
38360,245525450,245526037,True,1,587
38361,245530816,245532409,True,1,1593
38362,245556952,245557053,True,1,101
38363,245564949,245566485,True,1,1536
38364,245571908,245593868,False,1,21960
38365,245571908,245593868,True,1,21960
38366,245586247,245592055,True,3,5808
38367,245601215,245603689,True,5,2474
38368,245651771,245661183,True,1,9412
38369,245671264,245672845,True,1,1581
38370,245696056,245728901,True,1,32845
38371,245696056,245736591,True,1,40535
38372,245696056,245756877,True,1,60821
38373,245696955,245698323,True,1,1368
38374,245760300,245761216,False,1,916
38375,245762645,245769909,True,3,7264
38376,245841606,245848817,True,1,7211
38377,245855414,245869572,True,1,14158
38378,245856735,245857672,True,1,937
38379,245856826,245857157,True,3,331
38380,245860676,245860762,True,1,86
38381,245861497,245861820,True,1,323
38382,245863056,245885802,True,2,22746
38383,245887514,245888440,True,1,926
38384,245914967,245918531,True,5,3564
38385,245934231,245960698,False,1,26467
38386,245947793,245970094,True,1,22301
38387,245979442,245980568,False,1,1126
38388,245979442,245980568,True,4,1126
38389,245985761,245988418,True,1,2657
38390,245987416,246013140,True,1,25724
38391,245988159,246013495,True,1,25336
38392,245988159,246016483,True,1,28324
38393,246004725,246006672,True,3,1947
38394,246023706,246026344,True,1,2638
38395,246023706,246026375,True,1,2669
38396,246038108,246040866,True,1,2758
38397,246078020,246085183,True,1,7163
38398,246183656,246185946,True,1,2290
38399,246185214,246189668,False,1,4454
38400,246185214,246189668,True,3,4454
38401,246189190,246249689,True,1,60499
38402,246189190,246250853,True,1,61663
38403,246190448,246190797,True,1,349
38404,246191261,246250770,True,2,59509
38405,246191261,246251934,True,1,60673
38406,246201657,246202079,True,3,422
38407,246205587,246207586,True,1,1999
38408,246210072,246224867,False,1,14795
38409,246214567,246215774,True,1,1207
38410,246220573,246226790,True,1,6217
38411,246220573,246227937,True,1,7364
38412,246235735,246236138,True,1,403
38413,246260805,246261284,True,1,479
38414,246284330,246290866,True,1,6536
38415,246302716,246303163,False,2,447
38416,246302716,246303163,True,8,447
38417,246322178,246324821,True,1,2643
38418,246339170,246339827,True,1,657
38419,246352069,246352243,True,1,174
38420,246363356,246366745,True,1,3389
38421,246392250,246392575,True,1,325
38422,246427179,246432722,True,1,5543
38423,246474867,246475608,True,1,741
38424,246477027,246481053,True,1,4026
38425,246477378,246481053,True,9,3675
38426,246478980,246482563,False,1,3583
38427,246483057,246484576,True,2,1519
38428,246483888,246486004,True,1,2116
38429,246486528,246488118,True,1,1590
38430,246491272,246491964,True,1,692
38431,246498262,246501439,True,1,3177
38432,246498262,246503664,True,1,5402
38433,246518308,246521091,False,1,2783
38434,246518308,246521091,True,1,2783
38435,246520924,246524924,True,1,4000
38436,246523334,246526813,True,1,3479
38437,246546780,246549869,True,1,3089
38438,246553702,246556216,True,2,2514
38439,246553809,246555026,True,1,1217
38440,246559160,246577581,True,1,18421
38441,246592150,246597772,True,1,5622
38442,246596281,246608854,True,1,12573
38443,246600390,246600645,True,1,255
38444,246601334,246601809,True,1,475
38445,246601433,246601844,True,1,411
38446,246609050,246652741,False,1,43691
38447,246635472,246635943,True,1,471
38448,246638847,246651870,True,1,13023
38449,246640228,246652614,True,3,12386
38450,246646630,246651090,True,1,4460
38451,246664338,246668626,True,10,4288
38452,246681182,246681273,True,1,91
38453,246702028,246702899,True,1,871
38454,246731114,246733212,True,2,2098
38455,246745642,246747488,True,1,1846
38456,246793406,246844600,True,2,51194
38457,246801034,246811457,True,1,10423
38458,246811087,246822234,True,1,11147
38459,246818428,246825808,True,1,7380
38460,246828256,246830275,True,4,2019
38461,246832759,246835701,True,1,2942
38462,246833613,246836555,True,1,2942
38463,246842132,246896313,True,1,54181
38464,246848828,246849349,True,1,521
38465,246862204,246879042,True,2,16838
38466,246862344,246879057,True,1,16713
38467,246909277,246913585,False,1,4308
38468,246912477,246913829,True,1,1352
38469,246919021,246919709,True,7,688
38470,246919021,246920552,True,1,1531
38471,246919707,246920133,True,2,426
38472,246919707,246920976,True,1,1269
38473,246930171,246930553,False,1,382
38474,246930171,246930553,True,4,382
38475,246930475,246930715,True,1,240
38476,246931521,246931815,True,1,294
38477,246938923,246939007,True,2,84
38478,246942562,246983699,True,1,41137
38479,246958026,246959017,True,1,991
38480,246960556,246984299,False,1,23743
38481,246960760,246979740,False,1,18980
38482,246960760,246979740,True,2,18980
38483,246960760,246984155,False,1,23395
38484,246960760,246984210,False,1,23450
38485,246969877,246970175,True,1,298
38486,246970961,246973363,True,1,2402
38487,246976354,246996417,True,1,20063
38488,247004378,247004721,True,2,343
38489,247005997,247052306,False,2,46309
38490,247005997,247052306,True,5,46309
38491,247024899,247026273,True,3,1374
38492,247046378,247052877,True,5,6499
38493,247067697,247067786,True,1,89
38494,247067865,247070617,True,1,2752
38495,247077368,247080113,True,2,2745
38496,247080784,247081258,False,1,474
38497,247111974,247116625,False,1,4651
38498,247130691,247155209,True,2,24518
38499,247130870,247155209,True,1,24339
38500,247132026,247153664,True,1,21638
38501,247132026,247155832,True,1,23806
38502,247132469,247133363,False,1,894
38503,247158772,247161446,True,2,2674
38504,247190182,247194578,True,1,4396
38505,247192695,247193178,True,4,483
38506,247211036,247212588,False,1,1552
38507,247238494,247240296,False,1,1802
38508,247238494,247240296,True,2,1802
38509,247264075,247264571,True,1,496
38510,247266553,247282521,True,1,15968
38511,247266838,247282220,True,5,15382
38512,247269449,247269658,False,1,209
38513,247270137,247288144,False,1,18007
38514,247282400,247286271,False,1,3871
38515,247282400,247286271,True,3,3871
38516,247303133,247304548,False,1,1415
38517,247307895,247308913,True,1,1018
38518,247307895,247316892,True,1,8997
38519,247332186,247336176,True,3,3990
38520,247344350,247357897,True,1,13547
38521,247344591,247361442,False,1,16851
38522,247375946,247376765,True,1,819
38523,247396863,247397747,False,1,884
38524,247396863,247408290,False,1,11427
38525,247429759,247430619,True,1,860
38526,247433376,247435439,True,2,2063
38527,247435921,247456035,False,1,20114
38528,247435921,247456035,True,1,20114
38529,247436498,247456219,True,1,19721
38530,247436731,247456482,True,1,19751
38531,247439454,247440469,True,1,1015
38532,247442893,247444022,True,1,1129
38533,247491866,247495257,False,2,3391
38534,247491866,247495257,True,3,3391
38535,247496369,247545336,True,1,48967
38536,247497691,247530138,True,4,32447
38537,247505201,247634095,False,1,128894
38538,247507691,247508412,True,1,721
38539,247521670,247550707,False,1,29037
38540,247524285,247530151,True,1,5866
38541,247554252,247556178,False,1,1926
38542,247554252,247556178,True,3,1926
38543,247554899,247555890,True,1,991
38544,247571523,247610257,True,1,38734
38545,247578204,247582793,True,1,4589
38546,247588085,247669614,True,1,81529
38547,247597826,247599985,False,1,2159
38548,247610658,247611325,True,4,667
38549,247627278,247694582,False,1,67304
38550,247627278,247760362,True,1,133084
38551,247627308,247694612,False,1,67304
38552,247627308,247760392,True,3,133084
38553,247628178,247632575,True,2,4397
38554,247648018,247656418,True,1,8400
38555,247674586,247679823,True,1,5237
38556,247688684,247693011,True,1,4327
38557,247688684,247693014,True,1,4330
38558,247700265,247701476,True,1,1211
38559,247701394,247703124,True,1,1730
38560,247737458,247742681,True,1,5223
38561,247745301,247764675,True,1,19374
38562,247749592,247750514,True,1,922
38563,247768307,247770285,True,2,1978
38564,247772885,247778350,True,1,5465
38565,247800403,247807524,True,1,7121
38566,247812540,247813299,True,1,759
38567,247829291,247831317,True,1,2026
38568,247839625,247839763,True,1,138
38569,247846611,247877657,True,3,31046
38570,247884265,247885620,True,1,1355
38571,247885413,247886159,False,1,746
38572,247885413,247892733,True,1,7320
38573,247885413,247898287,False,1,12874
38574,247888832,247894468,True,1,5636
38575,247904274,247906515,True,1,2241
38576,247913137,247916116,True,1,2979
38577,247913137,247924633,True,2,11496
38578,247927638,247933836,True,1,6198
38579,247940779,247944460,True,1,3681
38580,247946208,247947082,False,1,874
38581,247946208,247947082,True,1,874
38582,247946208,247947433,True,1,1225
38583,247954987,247959946,False,1,4959
38584,247967197,247967672,True,2,475
38585,247972299,247973381,True,3,1082
38586,247972299,247974312,True,2,2013
38587,248053228,248056836,True,3,3608
38588,248057933,248060073,True,1,2140
38589,248060876,248074125,True,6,13249
38590,248060876,248094618,True,1,33742
38591,248061849,248065373,True,2,3524
38592,248096821,248112597,True,1,15776
38593,248097896,248113096,True,1,15200
38594,248124361,248126317,True,1,1956
38595,248128526,248129268,True,1,742
38596,248138438,248140367,True,1,1929
38597,248148514,248149958,True,1,1444
38598,248170005,248174268,False,1,4263
38599,248170005,248174268,True,4,4263
38600,248173474,248177147,True,2,3673
38601,248180431,248180521,True,1,90
38602,248184303,248185411,True,1,1108
38603,248203184,248212661,True,1,9477
38604,248204932,248211628,True,1,6696
38605,248204951,248211556,True,2,6605
38606,248204951,248219594,True,1,14643
38607,248206527,248207120,True,1,593
38608,248207554,248217651,True,1,10097
38609,248211812,248215350,False,1,3538
38610,248212036,248212750,True,1,714
38611,248222950,248225961,True,1,3011
38612,248226293,248230572,True,1,4279
38613,248236704,248242094,True,3,5390
38614,248236704,248248285,True,1,11581
38615,248241618,248241620,True,1,2
38616,248250467,248423065,False,1,172598
38617,248250467,248568089,True,1,317622
38618,248250467,248729217,True,3,478750
38619,248268415,248286788,True,1,18373
38620,248276724,248277041,True,1,317
38621,248291287,248297401,True,1,6114
38622,248303706,248304513,True,1,807
38623,248311528,248311711,True,2,183
38624,248383755,248385550,True,2,1795
38625,248389841,248398306,True,2,8465
38626,248389841,248400527,True,1,10686
38627,248394093,248400032,True,2,5939
38628,248417143,248421688,False,1,4545
38629,248417143,248425199,False,1,8056
38630,248427105,248427293,False,1,188
38631,248427105,248427857,False,1,752
38632,248428718,248430599,True,1,1881
38633,248435437,248439698,True,2,4261
38634,248442680,248469456,True,1,26776
38635,248447382,248505273,True,1,57891
38636,248464732,248470933,True,1,6201
38637,248477300,248481966,True,1,4666
38638,248494138,248499192,True,1,5054
38639,248506214,248507226,False,1,1012
38640,248523249,248526249,True,3,3000
38641,248523249,248540200,False,1,16951
38642,248549141,248552960,True,1,3819
38643,248549141,248555674,True,1,6533
38644,248607258,248654770,True,2,47512
38645,248636036,248636713,True,1,677
38646,248636036,248640639,True,1,4603
38647,248639208,248642230,True,1,3022
38648,248640527,248645661,True,8,5134
38649,248641593,248643334,True,1,1741
38650,248658905,248770353,True,1,111448
38651,248659402,248660081,True,1,679
38652,248665505,248667266,False,1,1761
38653,248665505,248667266,True,2,1761
38654,248712159,248725662,True,1,13503
38655,248714067,248715082,True,1,1015
38656,248715017,248715777,True,1,760
38657,248761468,248769926,True,1,8458
38658,248773051,248789660,True,1,16609
38659,248819347,248820778,True,1,1431
38660,248834961,248839400,True,1,4439
38661,248843331,248848243,True,3,4912
38662,248858136,248869126,True,1,10990
38663,248858140,248869206,True,1,11066
38664,248898686,248899563,True,2,877
38665,248898686,248903150,False,1,4464
38666,248898686,248903150,True,2,4464
38667,248898686,248905625,True,2,6939
38668,248915228,248916075,True,1,847
38669,248915611,248916192,True,1,581
38670,248915660,248916192,True,2,532
38671,248926567,248927743,False,4,1176
38672,248926567,248927743,True,2,1176
38673,248963085,248964326,True,1,1241
38674,248964359,248965030,False,1,671
38675,248964359,248965030,True,1,671
38676,248985870,248987566,False,1,1696
38677,248985870,248987566,True,3,1696
38678,248991365,248992153,True,1,788
38679,249010263,249024353,True,1,14090
38680,249012782,249014120,True,2,1338
38681,249025828,249026968,True,3,1140
38682,249032748,249032884,False,1,136
38683,249059468,249068023,True,1,8555
38684,249061622,249063533,True,1,1911
38685,249087587,249088871,True,1,1284
38686,249140021,249150283,False,3,10262
38687,249142908,249145361,False,1,2453
38688,249147998,249156847,False,1,8849
38689,249169361,249206817,False,1,37456
38690,249169361,249206817,True,1,37456
38691,249183636,249184856,True,8,1220
38692,249208438,249280561,True,1,72123
38693,249217564,249218547,True,2,983
38694,249219823,249225225,True,2,5402
38695,249224223,249230498,True,1,6275
38696,249234932,249235653,True,1,721
38697,249236431,249236539,True,1,108
38698,249244607,249246133,True,1,1526
38699,249246875,249247126,False,2,251
38700,249246875,249247126,True,2,251
38701,249249877,249251280,True,1,1403
38702,249274317,249279281,True,4,4964
38703,249278743,249279337,True,1,594
38704,249294768,249372799,False,1,78031
38705,249316182,249317061,True,1,879
38706,249340551,249341363,True,1,812
38707,249341497,249342223,False,1,726
38708,249374198,249377126,True,3,2928
38709,249382595,249387637,True,2,5042
38710,249386632,249389881,True,2,3249
38711,249390948,249445666,False,1,54718
38712,249470937,249474000,True,1,3063
38713,249472690,249473448,True,1,758
38714,249479766,249481802,True,1,2036
38715,249493565,249493792,True,3,227
38716,249493565,249494150,True,1,585
38717,249494837,249495114,True,1,277
38718,249503238,249545189,True,1,41951
38719,249503238,249552738,True,1,49500
38720,249504560,249505829,True,5,1269
38721,249508922,249509048,True,2,126
38722,249512998,249513151,True,1,153
38723,249513131,249513274,True,1,143
38724,249515364,249518821,True,1,3457
38725,249537015,249562298,True,1,25283
38726,249537077,249562364,True,1,25287
38727,249547625,249570071,True,1,22446
38728,249560250,249576430,True,1,16180
38729,249561895,249567199,True,3,5304
38730,249566172,249762143,True,2,195971
38731,249580481,249581427,True,2,946
38732,249585249,249585769,True,1,520
38733,249604375,249608631,True,3,4256
38734,249604375,249627802,True,1,23427
38735,249619085,249619691,True,4,606
38736,249648282,249648634,True,1,352
38737,249649301,249649389,True,1,88
38738,249662505,249663478,True,1,973
38739,249675312,249676320,True,1,1008
38740,249728651,249832456,True,1,103805
38741,249740527,249756028,False,1,15501
38742,249791532,249792138,True,1,606
38743,249809103,249811547,True,1,2444
38744,249812994,249816726,True,1,3732
38745,249815799,249816721,True,1,922
38746,249827760,249828191,True,3,431
38747,249827760,249828224,True,1,464
38748,249827760,249828931,True,1,1171
38749,249844487,249851234,True,3,6747
38750,249866334,249879663,True,2,13329
38751,249897295,249897565,True,4,270
38752,249902412,249904056,True,1,1644
38753,249906354,249906743,True,2,389
38754,249931901,249935360,False,6,3459
38755,249931901,249935360,True,12,3459
38756,249931914,249936746,True,3,4832
38757,249931914,249940738,True,2,8824
38758,249994390,250012805,False,1,18415
38759,250006155,250007854,False,1,1699
38760,250006155,250009366,False,2,3211
38761,250006155,250009366,True,1,3211
38762,250054098,250054620,True,1,522
38763,250054098,250060022,False,1,5924
38764,250054098,250060022,True,2,5924
38765,250066480,250075846,False,1,9366
38766,250066496,250075862,True,1,9366
38767,250069230,250139497,True,3,70267
38768,250069230,250236271,True,1,167041
38769,250117330,250118109,False,1,779
38770,250265929,250266271,True,2,342
38771,250266653,250266746,True,4,93
38772,250266914,250273539,True,1,6625
38773,250275323,250277776,True,1,2453
38774,250332157,250335634,True,2,3477
38775,250462832,250469337,True,1,6505
38776,250463396,250470723,False,1,7327
38777,250497125,250498404,True,1,1279
38778,250525305,250529400,True,2,4095
38779,250525305,250532824,True,1,7519
38780,250525305,250533074,True,1,7769
38781,250534585,250538129,True,1,3544
38782,250541307,250542208,True,1,901
38783,250563119,250580264,True,1,17145
38784,250568433,250650216,True,1,81783
38785,250609180,250622232,False,1,13052
38786,250609180,250622232,True,1,13052
38787,250631647,250634036,True,1,2389
38788,250649460,250655483,True,1,6023
38789,250651347,250655737,True,1,4390
38790,250717813,250724110,True,1,6297
38791,250730620,250731511,True,1,891
38792,250792747,250794342,True,1,1595
38793,250792787,250793014,True,1,227
38794,250792787,250793470,False,1,683
38795,250793147,250793374,True,1,227
38796,250794511,250795322,True,1,811
38797,250795270,250795360,True,1,90
38798,250796446,250796675,False,1,229
38799,250843245,250846499,False,1,3254
38800,250852461,250860202,True,1,7741
38801,250863802,250863997,True,1,195
38802,250864103,250865906,True,1,1803
38803,250878766,250881649,False,2,2883
38804,250878766,250881649,True,4,2883
38805,250925551,250926269,True,1,718
38806,250925551,250928512,True,2,2961
38807,250925551,250929690,True,1,4139
38808,250931643,250933737,False,1,2094
38809,250949994,251016100,True,3,66106
38810,250951097,251016641,True,2,65544
38811,250952555,250954197,True,1,1642
38812,250954636,250961061,False,1,6425
38813,250956742,250975271,True,1,18529
38814,250974538,250985077,True,1,10539
38815,250990937,250991672,True,4,735
38816,250992660,250992765,True,1,105
38817,250992720,250992892,True,1,172
38818,251001671,251006806,False,1,5135
38819,251001671,251006806,True,2,5135
38820,251011684,251019328,True,1,7644
38821,251049787,251066086,True,1,16299
38822,251084840,251088480,True,4,3640
38823,251100187,251108344,False,1,8157
38824,251100187,251108344,True,2,8157
38825,251102870,251106668,True,2,3798
38826,251122193,251131910,False,1,9717
38827,251128960,251131008,True,7,2048
38828,251163290,251165668,True,1,2378
38829,251173872,251175340,True,2,1468
38830,251180036,251181361,True,1,1325
38831,251193884,251194741,False,1,857
38832,251193884,251194741,True,1,857
38833,251223832,251225089,False,1,1257
38834,251223832,251225089,True,1,1257
38835,251227316,251229830,True,1,2514
38836,251232388,251232485,True,1,97
38837,251232438,251232741,True,2,303
38838,251271005,251273148,False,1,2143
38839,251271103,251273148,False,1,2045
38840,251273710,251275812,True,2,2102
38841,251293440,251293794,True,1,354
38842,251293440,251294472,True,1,1032
38843,251296527,251297515,True,2,988
38844,251305273,251307635,True,1,2362
38845,251316100,251317284,True,1,1184
38846,251344694,251345862,True,1,1168
38847,251362600,251373718,True,1,11118
38848,251362600,251374091,True,1,11491
38849,251368455,251368541,True,1,86
38850,251376270,251377985,True,1,1715
38851,251376270,251378911,True,2,2641
38852,251388928,251390064,True,1,1136
38853,251391938,251496903,True,1,104965
38854,251406287,251422399,False,1,16112
38855,251406522,251408105,False,1,1583
38856,251406522,251410971,True,1,4449
38857,251406522,251411409,False,1,4887
38858,251406659,251422575,True,1,15916
38859,251406665,251422586,True,1,15921
38860,251414381,251508189,True,1,93808
38861,251450606,251451154,True,2,548
38862,251451267,251452772,True,3,1505
38863,251471291,251477200,True,1,5909
38864,251507420,251514824,True,1,7404
38865,251514614,251518270,True,1,3656
38866,251518249,251559984,False,1,41735
38867,251518249,251559984,True,3,41735
38868,251527560,251528496,True,2,936
38869,251537036,251539028,True,2,1992
38870,251548735,251549365,True,2,630
38871,251560096,251577197,True,2,17101
38872,251591942,251592369,True,1,427
38873,251591942,251623546,True,1,31604
38874,251596170,251599152,True,1,2982
38875,251601698,251601853,True,1,155
38876,251622382,251645157,True,1,22775
38877,251643654,251647194,True,1,3540
38878,251644991,251645147,True,1,156
38879,251645092,251646970,False,1,1878
38880,251645092,251646970,True,3,1878
38881,251648719,251649933,True,1,1214
38882,251657712,251658260,True,1,548
38883,251657712,251658329,True,2,617
38884,251668886,251734072,True,1,65186
38885,251696368,251697457,True,1,1089
38886,251708423,251709523,True,1,1100
38887,251742366,251743337,True,2,971
38888,251750856,251750939,False,1,83
38889,251758243,251759546,True,3,1303
38890,251770117,251771693,True,1,1576
38891,251771859,251774398,True,4,2539
38892,251798294,251826074,True,1,27780
38893,251873356,251875866,True,1,2510
38894,251903917,251905586,False,1,1669
38895,251907592,251908386,True,1,794
38896,251909215,251909759,False,1,544
38897,251913499,251913806,False,1,307
38898,251934925,251935649,True,1,724
38899,251971196,251973384,True,1,2188
38900,251991119,251999019,False,1,7900
38901,252022655,252026135,True,1,3480
38902,252073417,252077362,True,2,3945
38903,252081039,252109358,False,1,28319
38904,252124215,252132159,True,1,7944
38905,252137651,252141724,True,1,4073
38906,252141736,252143676,True,1,1940
38907,252145540,252146112,True,3,572
38908,252157873,252163939,False,1,6066
38909,252157873,252164774,False,1,6901
38910,252157873,252164774,True,1,6901
38911,252157873,252164829,False,1,6956
38912,252157873,252164829,True,1,6956
38913,252163343,252180736,True,2,17393
38914,252172542,252175278,False,1,2736
38915,252172542,252175278,True,2,2736
38916,252204823,252209587,True,2,4764
38917,252208282,252218373,True,1,10091
38918,252214215,252235661,True,1,21446
38919,252224013,252224201,False,1,188
38920,252224121,252248343,True,5,24222
38921,252225780,252253310,True,1,27530
38922,252225873,252252780,False,1,26907
38923,252225873,252252780,True,1,26907
38924,252227602,252228564,True,1,962
38925,252229676,252240797,True,1,11121
38926,252237080,252243589,True,2,6509
38927,252266752,252266897,True,2,145
38928,252272713,252274294,True,1,1581
38929,252272913,252312527,True,1,39614
38930,252278120,252280264,True,2,2144
38931,252278120,252281305,True,1,3185
38932,252278120,252281796,False,1,3676
38933,252278120,252281796,True,1,3676
38934,252278349,252280369,True,1,2020
38935,252282391,252283701,True,1,1310
38936,252286836,252287864,True,5,1028
38937,252300896,252323046,True,3,22150
38938,252306029,252312539,True,3,6510
38939,252306029,252313336,True,2,7307
38940,252313747,252314916,False,1,1169
38941,252313747,252314916,True,1,1169
38942,252328060,252329548,True,2,1488
38943,252347822,252350109,True,1,2287
38944,252351021,252354954,True,1,3933
38945,252352416,252378186,True,1,25770
38946,252401335,252402217,True,2,882
38947,252409888,252417280,True,1,7392
38948,252423828,252436946,True,1,13118
38949,252451276,252501528,True,1,50252
38950,252451985,252501777,True,1,49792
38951,252480307,252557503,True,1,77196
38952,252480946,252482456,True,1,1510
38953,252486402,252498242,True,1,11840
38954,252501367,252504215,True,1,2848
38955,252537439,252539356,True,1,1917
38956,252546691,252549299,True,1,2608
38957,252552047,252552347,True,1,300
38958,252552528,252552912,True,1,384
38959,252552819,252553203,True,1,384
38960,252554372,252554595,True,1,223
38961,252555953,252565950,True,1,9997
38962,252556184,252565891,True,1,9707
38963,252581509,252581618,True,1,109
38964,252587853,252595600,False,1,7747
38965,252588313,252588926,True,2,613
38966,252602257,252605997,True,1,3740
38967,252613010,252675822,True,1,62812
38968,252615343,252622476,False,1,7133
38969,252615343,252622476,True,2,7133
38970,252620035,252678036,True,1,58001
38971,252630249,252635027,True,1,4778
38972,252652710,252653234,True,2,524
38973,252683691,252751727,True,1,68036
38974,252711747,252725932,True,1,14185
38975,252743580,252754331,True,1,10751
38976,252761856,252766552,False,1,4696
38977,252761856,252766552,True,1,4696
38978,252761985,252763094,True,1,1109
38979,252774634,252775298,True,1,664
38980,252785496,252794597,False,1,9101
38981,252839720,252851906,False,1,12186
38982,252846304,252868981,True,2,22677
38983,252867693,252877560,False,1,9867
38984,252886066,252888119,True,1,2053
38985,252886731,252889519,False,3,2788
38986,252889075,252890066,True,1,991
38987,252891952,252894188,True,1,2236
38988,252896477,252898272,True,2,1795
38989,252896477,252901364,True,1,4887
38990,252980823,252985751,True,1,4928
38991,253045520,253074372,False,1,28852
38992,253253203,253262141,True,2,8938
38993,253253203,253293436,True,2,40233
38994,253258087,253259995,True,1,1908
38995,253262567,253285852,True,1,23285
38996,253322797,253328601,True,1,5804
38997,253354684,253357679,True,6,2995
38998,253399731,253487864,False,1,88133
38999,253416066,253417661,True,1,1595
39000,253492156,253492249,True,1,93
39001,253540225,253541198,True,1,973
39002,253548635,253550126,True,2,1491
39003,253621461,253624851,False,1,3390
39004,253706776,253712458,True,2,5682
39005,253710487,253714699,False,1,4212
39006,253747023,253747724,False,1,701
39007,253824091,253827405,True,1,3314
39008,253854160,253854536,False,2,376
39009,253854160,253856455,False,1,2295
39010,253854235,253854536,False,1,301
39011,253869557,253883248,False,1,13691
39012,253873908,253905221,False,1,31313
39013,253911801,253916531,False,1,4730
39014,253969792,253973719,True,1,3927
39015,253977589,253977713,True,1,124
39016,254022221,254023747,True,3,1526
39017,254027968,254030118,True,1,2150
39018,254039884,254084097,True,1,44213
39019,254040559,254075321,True,1,34762
39020,254040559,254084408,True,1,43849
39021,254041169,254084742,True,1,43573
39022,254082719,254084525,False,1,1806
39023,254108616,254109375,True,1,759
39024,254108616,254118462,True,1,9846
39025,254109516,254118911,True,1,9395
39026,254231731,254234784,True,1,3053
39027,254237487,254265168,True,1,27681
39028,254282029,254345878,False,1,63849
39029,254399749,254403934,False,1,4185
39030,254426900,254427790,True,1,890
39031,254430595,254432133,False,1,1538
39032,254431268,254432074,False,1,806
39033,254443254,254448836,False,1,5582
39034,254444044,254444884,True,1,840
39035,254457024,254457540,True,2,516
39036,254461748,254463568,True,1,1820
39037,254463467,254466821,True,1,3354
39038,254467739,254468234,False,1,495
39039,254467739,254468589,True,1,850
39040,254467739,254469047,True,2,1308
39041,254488798,254496872,True,3,8074
39042,254501605,254501932,True,2,327
39043,254501903,254502451,True,1,548
39044,254503858,254504878,True,1,1020
39045,254526057,254526531,False,1,474
39046,254530715,254614860,True,1,84145
39047,254553043,254568625,False,2,15582
39048,254569774,254571700,True,3,1926
39049,254584537,254585932,False,1,1395
39050,254584537,254585932,True,2,1395
39051,254584706,254618866,True,1,34160
39052,254591399,254591494,True,1,95
39053,254604195,254698409,False,1,94214
39054,254634514,254635358,True,2,844
39055,254636550,254641609,False,1,5059
39056,254647076,254647187,True,1,111
39057,254689027,254693850,True,1,4823
39058,254696133,254706087,True,1,9954
39059,254709147,254711909,False,1,2762
39060,254717233,254754077,False,1,36844
39061,254717455,254719988,True,1,2533
39062,254743711,254746655,False,1,2944
39063,254783704,254784966,True,1,1262
39064,254783704,254785012,True,2,1308
39065,254786213,254786338,True,1,125
39066,254789627,254789826,False,1,199
39067,254791735,254791818,True,1,83
39068,254799768,254807024,False,1,7256
39069,254816567,254817854,True,4,1287
39070,254819070,254821720,True,4,2650
39071,254827398,254856912,True,1,29514
39072,254827398,254861339,True,1,33941
39073,254827398,254864948,True,1,37550
39074,254839884,254867986,False,1,28102
39075,254839884,254867986,True,2,28102
39076,254841734,254881309,False,1,39575
39077,254848685,254850697,True,1,2012
39078,254858244,254858592,True,1,348
39079,254869089,254874210,True,1,5121
39080,254875999,254879231,True,1,3232
39081,254880481,254909838,True,2,29357
39082,254910556,254911125,True,1,569
39083,254954720,254960593,True,2,5873
39084,254982218,254986605,False,1,4387
39085,254987535,254991029,True,1,3494
39086,255024394,255027261,True,5,2867
39087,255050332,255051681,True,3,1349
39088,255079075,255088688,True,2,9613
39089,255081881,255081971,True,1,90
39090,255126505,255126843,True,1,338
39091,255134412,255134959,True,1,547
39092,255170331,255247047,True,1,76716
39093,255170331,255253835,True,2,83504
39094,255175680,255189200,True,1,13520
39095,255176052,255189356,True,4,13304
39096,255176122,255189256,True,4,13134
39097,255176171,255189356,True,1,13185
39098,255189121,255191026,True,1,1905
39099,255221278,255245815,True,5,24537
39100,255231574,255232177,True,3,603
39101,255231574,255232210,True,1,636
39102,255240503,255242617,True,1,2114
39103,255252652,255256971,False,1,4319
39104,255263201,255267452,True,1,4251
39105,255268746,255280922,True,1,12176
39106,255268746,255316347,False,1,47601
39107,255283461,255284020,False,1,559
39108,255283461,255284020,True,1,559
39109,255284645,255288860,True,1,4215
39110,255284875,255288506,True,2,3631
39111,255321666,255322060,False,1,394
39112,255328293,255330043,True,1,1750
39113,255337636,255345847,True,1,8211
39114,255337916,255338087,True,1,171
39115,255348484,255357585,True,1,9101
39116,255408809,255411163,True,2,2354
39117,255420119,255438534,False,1,18415
39118,255420119,255438534,True,2,18415
39119,255460716,255461519,True,2,803
39120,255460722,255461519,True,1,797
39121,255524977,255527101,True,4,2124
39122,255524977,255527565,True,1,2588
39123,255542613,255542887,True,1,274
39124,255542698,255542976,True,1,278
39125,255543346,255550544,True,1,7198
39126,255555756,255559863,True,1,4107
39127,255567522,255567603,True,1,81
39128,255567690,255590174,True,1,22484
39129,255600051,255601123,True,1,1072
39130,255600051,255606346,True,1,6295
39131,255611807,255613593,True,13,1786
39132,255744978,255837989,True,1,93011
39133,255762689,255773372,True,1,10683
39134,255784258,255786501,True,1,2243
39135,255796949,255798147,True,1,1198
39136,255821051,255824661,True,4,3610
39137,255886374,255892079,True,2,5705
39138,255901419,255903661,True,2,2242
39139,255925676,255925877,True,3,201
39140,255926046,255928146,True,1,2100
39141,255929358,255930480,True,1,1122
39142,255981846,255982879,True,1,1033
39143,255983110,255989111,True,1,6001
39144,255996559,255997544,True,1,985
39145,256030168,256031735,True,4,1567
39146,256048348,256055323,True,3,6975
39147,256048348,256081845,True,1,33497
39148,256048348,256085277,True,1,36929
39149,256051417,256057285,False,1,5868
39150,256060499,256070169,True,4,9670
39151,256065412,256066660,True,9,1248
39152,256088871,256090512,True,1,1641
39153,256093989,256094175,False,1,186
39154,256095120,256097455,True,1,2335
39155,256121624,256122403,True,1,779
39156,256122553,256125428,True,2,2875
39157,256129366,256131601,True,1,2235
39158,256191846,256193136,True,1,1290
39159,256191960,256193136,True,1,1176
39160,256205744,256207804,False,1,2060
39161,256217388,256219835,True,1,2447
39162,256228044,256228131,True,3,87
39163,256233711,256233916,True,1,205
39164,256233711,256235992,True,1,2281
39165,256234337,256236320,True,1,1983
39166,256306819,256311583,True,1,4764
39167,256352063,256353491,True,1,1428
39168,256352063,256353495,True,4,1432
39169,256364227,256365391,True,1,1164
39170,256365006,256365177,False,1,171
39171,256382631,256383752,True,1,1121
39172,256395739,256397748,False,1,2009
39173,256398425,256398924,True,3,499
39174,256400963,256406450,False,3,5487
39175,256400963,256406450,True,8,5487
39176,256441590,256450681,False,1,9091
39177,256477133,256482509,True,1,5376
39178,256499210,256500401,False,1,1191
39179,256525587,256546008,True,1,20421
39180,256536918,256573558,True,1,36640
39181,256562727,256563563,True,1,836
39182,256567792,256589084,True,1,21292
39183,256581348,256584088,True,4,2740
39184,256583988,256584949,True,1,961
39185,256586784,256610650,True,1,23866
39186,256602654,256602878,True,1,224
39187,256603523,256622036,True,1,18513
39188,256604233,256637186,False,1,32953
39189,256604233,256735000,False,2,130767
39190,256624949,256628045,True,1,3096
39191,256624949,256628072,False,2,3123
39192,256624949,256628072,True,1,3123
39193,256639913,256644204,True,1,4291
39194,256642606,256643470,True,2,864
39195,256643999,256669743,True,1,25744
39196,256661126,256662057,True,3,931
39197,256661126,256678949,True,1,17823
39198,256678248,256679817,True,2,1569
39199,256698375,256703089,False,1,4714
39200,256698375,256703089,True,3,4714
39201,256711186,256712307,False,1,1121
39202,256711186,256712307,True,2,1121
39203,256732437,256744572,False,1,12135
39204,256755285,256755469,True,1,184
39205,256755613,256757127,True,1,1514
39206,256758831,256766950,True,3,8119
39207,256758831,256767970,True,5,9139
39208,256758831,256778268,True,1,19437
39209,256784243,256784678,True,1,435
39210,256792246,256792462,False,1,216
39211,256792998,256793638,True,9,640
39212,256800181,256818787,False,2,18606
39213,256807257,256809069,True,2,1812
39214,256807257,256811022,True,1,3765
39215,256807257,256811726,True,1,4469
39216,256825255,256826243,True,1,988
39217,256861209,256871088,True,1,9879
39218,256863068,256863835,True,1,767
39219,256864530,256866449,True,1,1919
39220,256882802,256885941,True,2,3139
39221,256890180,256959179,True,2,68999
39222,256892739,256893030,True,1,291
39223,256911559,256946920,False,1,35361
39224,256925933,256928056,True,1,2123
39225,256941525,256945860,True,2,4335
39226,256988581,257013587,True,1,25006
39227,257005570,257007458,False,1,1888
39228,257005972,257008028,True,1,2056
39229,257005972,257008285,True,1,2313
39230,257013347,257015181,True,1,1834
39231,257019548,257020443,True,3,895
39232,257021184,257021304,True,1,120
39233,257034283,257034454,True,1,171
39234,257042612,257042805,True,1,193
39235,257060567,257060957,True,1,390
39236,257103488,257107254,False,1,3766
39237,257108421,257118760,False,1,10339
39238,257108421,257118760,True,1,10339
39239,257113025,257184437,True,1,71412
39240,257123582,257124114,False,1,532
39241,257127981,257181940,True,1,53959
39242,257127981,257191818,True,2,63837
39243,257155656,257159891,True,1,4235
39244,257156096,257160116,True,6,4020
39245,257156569,257160393,True,1,3824
39246,257161115,257164473,False,1,3358
39247,257161700,257162894,True,3,1194
39248,257161755,257162754,True,2,999
39249,257161949,257163047,True,2,1098
39250,257164454,257168021,True,2,3567
39251,257188154,257362986,True,2,174832
39252,257189672,257191509,True,4,1837
39253,257189672,257201565,True,1,11893
39254,257197016,257201826,True,1,4810
39255,257197016,257210728,True,1,13712
39256,257197192,257201826,True,1,4634
39257,257197192,257210728,True,1,13536
39258,257209598,257212001,True,1,2403
39259,257212082,257283954,True,1,71872
39260,257233027,257233746,True,1,719
39261,257241985,257243678,True,2,1693
39262,257246548,257248162,True,1,1614
39263,257256230,257266020,True,1,9790
39264,257257884,257262668,True,1,4784
39265,257257884,257318836,True,1,60952
39266,257286002,257361256,True,1,75254
39267,257303451,257305577,True,1,2126
39268,257303486,257317379,True,1,13893
39269,257348706,257348970,True,2,264
39270,257356170,257369896,True,1,13726
39271,257380057,257384401,True,2,4344
39272,257398528,257398786,True,3,258
39273,257400255,257402620,False,1,2365
39274,257407264,257418682,True,2,11418
39275,257409538,257419933,True,1,10395
39276,257418067,257420183,True,1,2116
39277,257418067,257428522,True,2,10455
39278,257418067,257444324,True,1,26257
39279,257418067,257444974,True,1,26907
39280,257425477,257448116,True,1,22639
39281,257441638,257443106,True,1,1468
39282,257445852,257446983,False,1,1131
39283,257495846,257496449,True,1,603
39284,257497183,257498806,True,2,1623
39285,257503979,257651222,True,1,147243
39286,257522928,257541057,True,1,18129
39287,257522928,257542469,True,1,19541
39288,257542067,257542719,True,3,652
39289,257559337,257559979,True,1,642
39290,257561129,257561831,True,1,702
39291,257563183,257567380,True,1,4197
39292,257569633,257586229,True,1,16596
39293,257592277,257592895,True,1,618
39294,257594244,257641562,False,1,47318
39295,257604334,257604999,True,2,665
39296,257604923,257605382,True,1,459
39297,257609565,257611057,True,1,1492
39298,257610864,257611700,True,1,836
39299,257610876,257611700,True,1,824
39300,257612976,257613087,False,1,111
39301,257613027,257613518,True,1,491
39302,257613058,257617956,True,1,4898
39303,257613782,257614940,False,1,1158
39304,257613782,257674201,False,1,60419
39305,257613782,257709635,False,1,95853
39306,257616600,257617752,True,1,1152
39307,257616600,257620238,True,7,3638
39308,257642654,257644013,True,1,1359
39309,257658035,257671935,True,1,13900
39310,257676008,257677300,True,3,1292
39311,257680950,257681636,True,2,686
39312,257683554,257685113,True,1,1559
39313,257685604,257694514,True,1,8910
39314,257686132,257694850,False,1,8718
39315,257692200,257692293,True,1,93
39316,257695289,257695649,True,3,360
39317,257697737,257703782,True,1,6045
39318,257697742,257703754,True,1,6012
39319,257697951,257703782,True,1,5831
39320,257703809,257705975,True,1,2166
39321,257711753,257712190,True,1,437
39322,257730134,257884331,True,1,154197
39323,257730134,257884334,True,1,154200
39324,257746183,257749027,True,2,2844
39325,257773221,257790552,False,2,17331
39326,257773221,257790552,True,1,17331
39327,257776070,257776577,True,7,507
39328,257806078,257854586,False,1,48508
39329,257828021,257835840,True,1,7819
39330,257843996,257844355,True,1,359
39331,257861480,257863540,True,1,2060
39332,257864608,257888560,False,1,23952
39333,257865682,257871343,True,2,5661
39334,257865682,257874060,True,1,8378
39335,257869973,257885803,True,2,15830
39336,257869973,257907163,True,2,37190
39337,257877725,257882142,True,2,4417
39338,257897404,257906286,True,2,8882
39339,257937041,257937975,True,2,934
39340,257965058,257978115,True,5,13057
39341,257995431,257996234,True,2,803
39342,257995870,257996367,True,1,497
39343,257995957,257996462,True,1,505
39344,258016355,258027443,True,1,11088
39345,258031250,258034963,True,1,3713
39346,258049497,258098662,True,1,49165
39347,258056761,258064016,True,1,7255
39348,258066673,258066922,False,1,249
39349,258071301,258071886,False,1,585
39350,258080308,258081437,True,3,1129
39351,258086323,258142564,True,1,56241
39352,258109378,258109818,True,1,440
39353,258148715,258154134,True,2,5419
39354,258167931,258179952,True,1,12021
39355,258178411,258191907,True,2,13496
39356,258195211,258200310,True,1,5099
39357,258196346,258196606,True,1,260
39358,258201135,258221060,False,3,19925
39359,258204737,258214152,False,1,9415
39360,258204737,258214152,True,1,9415
39361,258222136,258222473,True,1,337
39362,258240857,258241527,True,1,670
39363,258241347,258242267,True,1,920
39364,258271504,258272431,True,1,927
39365,258277628,258282062,True,2,4434
39366,258278456,258285715,True,1,7259
39367,258284987,258294405,True,1,9418
39368,258297114,258301883,True,1,4769
39369,258300207,258301130,True,3,923
39370,258300207,258301183,True,1,976
39371,258302467,258302957,True,1,490
39372,258318181,258327679,True,8,9498
39373,258318318,258321572,True,1,3254
39374,258360495,258362552,False,1,2057
39375,258364432,258365439,True,2,1007
39376,258382959,258383906,True,1,947
39377,258400394,258402167,True,2,1773
39378,258400896,258402685,True,1,1789
39379,258408787,258575346,True,3,166559
39380,258413118,258413446,True,1,328
39381,258414273,258421320,True,1,7047
39382,258481846,258484290,True,1,2444
39383,258491997,258552524,True,1,60527
39384,258495418,258497198,True,1,1780
39385,258503219,258548735,True,2,45516
39386,258503219,258548738,True,1,45519
39387,258524205,258528288,True,1,4083
39388,258526940,258527280,True,6,340
39389,258534547,258535070,True,1,523
39390,258539927,258567099,True,1,27172
39391,258549326,258549513,True,3,187
39392,258556639,258561540,False,1,4901
39393,258556639,258561540,True,1,4901
39394,258612066,258618737,False,1,6671
39395,258612066,258624029,True,1,11963
39396,258675638,258675761,True,1,123
39397,258676274,258698537,False,1,22263
39398,258676274,258698537,True,1,22263
39399,258695252,258695363,True,1,111
39400,258697404,258709137,True,1,11733
39401,258698473,258698929,True,1,456
39402,258698677,258736985,False,1,38308
39403,258737272,258740443,True,4,3171
39404,258753588,258754381,True,3,793
39405,258836394,258836535,False,1,141
39406,258945473,258949617,True,3,4144
39407,258947877,258948006,True,2,129
39408,258947877,258953081,True,1,5204
39409,258948364,258953200,True,1,4836
39410,258948373,258953200,True,1,4827
39411,258948398,258953234,True,1,4836
39412,259071585,259072319,True,1,734
39413,259071953,259072169,True,1,216
39414,259115874,259119347,True,2,3473
39415,259134695,259138354,True,1,3659
39416,259134695,259162048,True,1,27353
39417,259143211,259143873,False,1,662
39418,259188543,259189777,False,2,1234
39419,259191221,259191500,False,2,279
39420,259222265,259230585,False,1,8320
39421,259225483,259233261,False,1,7778
39422,259244508,259245421,True,1,913
39423,259245961,259264610,True,1,18649
39424,259316697,259320282,True,2,3585
39425,259352797,259358071,True,2,5274
39426,259354306,259401554,True,1,47248
39427,259354343,259401554,True,3,47211
39428,259371533,259408108,True,1,36575
39429,259386901,259387885,True,1,984
39430,259410897,259468414,True,1,57517
39431,259410897,259485860,True,1,74963
39432,259420997,259447107,True,1,26110
39433,259420997,259466631,True,1,45634
39434,259420997,259470935,True,1,49938
39435,259440566,259442435,True,1,1869
39436,259449128,259452624,True,1,3496
39437,259461810,259483664,True,3,21854
39438,259462604,259484044,True,1,21440
39439,259465038,259485366,True,1,20328
39440,259468414,259468528,True,4,114
39441,259479544,259482165,True,1,2621
39442,259516775,259519286,True,4,2511
39443,259542011,259545131,True,6,3120
39444,259569139,259569779,True,1,640
39445,259571202,259624680,False,1,53478
39446,259571202,259624680,True,1,53478
39447,259594614,259635526,False,1,40912
39448,259601552,259610753,False,1,9201
39449,259601552,259610775,True,1,9223
39450,259601757,259603161,False,1,1404
39451,259602063,259602905,True,1,842
39452,259610845,259614983,True,5,4138
39453,259610899,259614792,True,2,3893
39454,259634825,259638229,False,2,3404
39455,259683035,259683474,True,1,439
39456,259691759,259691838,True,1,79
39457,259695636,259701021,True,1,5385
39458,259695723,259702178,True,1,6455
39459,259701044,259703574,True,2,2530
39460,259792443,259794444,True,2,2001
39461,259797988,259799452,True,2,1464
39462,259808529,259809482,True,1,953
39463,259808529,259824680,True,1,16151
39464,259813494,259815469,True,2,1975
39465,259858234,259861713,True,1,3479
39466,259863399,259864719,False,1,1320
39467,259866061,259871557,True,2,5496
39468,259866061,259873627,True,1,7566
39469,259879692,259919037,True,5,39345
39470,259879692,259930314,True,1,50622
39471,259881104,259919784,True,1,38680
39472,259917030,259917943,True,1,913
39473,259921714,259924895,True,1,3181
39474,259958820,259959754,True,1,934
39475,259958875,260063613,False,1,104738
39476,259969674,259970306,True,2,632
39477,259969674,259970861,True,2,1187
39478,259970422,259970932,True,1,510
39479,260000968,260001459,False,1,491
39480,260016367,260016437,False,1,70
39481,260019014,260019755,True,1,741
39482,260030011,260038583,True,2,8572
39483,260034645,260041036,True,1,6391
39484,260040715,260041226,True,3,511
39485,260052218,260053169,True,1,951
39486,260054055,260080200,True,1,26145
39487,260059636,260087688,True,1,28052
39488,260072491,260073489,True,3,998
39489,260072491,260074157,True,2,1666
39490,260119978,260120282,True,1,304
39491,260120722,260126668,True,1,5946
39492,260129182,260156810,False,1,27628
39493,260129182,260156810,True,2,27628
39494,260189180,260189852,True,1,672
39495,260194824,260196295,False,1,1471
39496,260200741,260203476,True,1,2735
39497,260202810,260204401,True,2,1591
39498,260218507,260239465,True,1,20958
39499,260235326,260236281,True,1,955
39500,260252251,260261222,True,2,8971
39501,260252547,260261394,True,1,8847
39502,260256705,260257578,False,1,873
39503,260262496,260266376,True,1,3880
39504,260264078,260267105,True,2,3027
39505,260292726,260293192,True,1,466
39506,260304919,260306991,True,1,2072
39507,260318678,260321327,True,1,2649
39508,260318981,260319069,True,2,88
39509,260318981,260321600,True,2,2619
39510,260368916,260378225,False,1,9309
39511,260373734,260377481,True,1,3747
39512,260373734,260377761,True,1,4027
39513,260373899,260377819,True,1,3920
39514,260384633,260407711,True,1,23078
39515,260384633,260407947,True,1,23314
39516,260419957,260420106,True,2,149
39517,260425418,260428422,True,1,3004
39518,260427712,260427970,True,2,258
39519,260428127,260430537,True,1,2410
39520,260429111,260431306,True,1,2195
39521,260435626,260435870,True,1,244
39522,260458364,260464177,False,1,5813
39523,260477725,260502176,False,2,24451
39524,260483445,260483777,True,1,332
39525,260515172,260515716,True,1,544
39526,260537327,260537761,True,2,434
39527,260538101,260538321,True,1,220
39528,260550840,260553174,True,2,2334
39529,260558449,260561087,True,1,2638
39530,260601745,260606181,True,1,4436
39531,260638693,260650250,True,1,11557
39532,260679536,260683097,True,2,3561
39533,260707508,260709984,True,2,2476
39534,260749204,260788365,True,2,39161
39535,260796106,260797232,True,1,1126
39536,260815387,260815537,True,4,150
39537,260837579,260837878,True,2,299
39538,260910861,260912478,True,1,1617
39539,260931395,260931929,True,3,534
39540,260938741,260940969,False,1,2228
39541,260938741,260940969,True,1,2228
39542,260952787,260952882,True,2,95
39543,260952787,260953106,True,1,319
39544,260956799,260957478,True,2,679
39545,260958971,260961623,True,1,2652
39546,260965218,260967940,True,1,2722
39547,260988359,260988643,True,3,284
39548,260988359,260989464,True,2,1105
39549,260989641,260990378,True,1,737
39550,260989641,260991199,True,1,1558
39551,260990279,260991322,False,2,1043
39552,260990279,260993238,False,1,2959
39553,260990279,260993238,True,1,2959
39554,260994138,260994223,True,1,85
39555,261001795,261002554,True,7,759
39556,261008586,261009378,True,1,792
39557,261009000,261009616,True,1,616
39558,261013371,261022426,True,1,9055
39559,261037811,261037921,False,1,110
39560,261073014,261077141,True,1,4127
39561,261085933,261125937,True,1,40004
39562,261096823,261097282,True,1,459
39563,261113966,261123437,False,1,9471
39564,261114648,261126324,False,1,11676
39565,261114648,261154117,False,1,39469
39566,261114767,261126324,False,1,11557
39567,261114767,261154117,False,1,39350
39568,261130494,261131715,True,3,1221
39569,261131190,261132069,True,1,879
39570,261133245,261134824,False,1,1579
39571,261139140,261218626,True,3,79486
39572,261155375,261155510,True,3,135
39573,261155622,261156716,True,1,1094
39574,261157966,261158380,False,1,414
39575,261199560,261251368,False,1,51808
39576,261199560,261251368,True,2,51808
39577,261199560,261294601,True,1,95041
39578,261226015,261226266,True,1,251
39579,261226015,261226384,True,1,369
39580,261226015,261262092,True,2,36077
39581,261226910,261262549,True,2,35639
39582,261227052,261262691,True,2,35639
39583,261258568,261259397,False,1,829
39584,261259113,261259356,True,1,243
39585,261259512,261297728,False,3,38216
39586,261274280,261275153,False,2,873
39587,261292269,261293400,False,1,1131
39588,261296663,261297361,False,1,698
39589,261296663,261297361,True,1,698
39590,261296667,261297361,True,5,694
39591,261341024,261342392,True,2,1368
39592,261361006,261361563,True,1,557
39593,261364684,261365535,True,1,851
39594,261368200,261371191,True,2,2991
39595,261375094,261393741,True,1,18647
39596,261375094,261448975,True,1,73881
39597,261395432,261396203,True,1,771
39598,261402418,261425309,False,1,22891
39599,261408376,261409752,True,2,1376
39600,261410122,261410213,True,1,91
39601,261429018,261430107,True,1,1089
39602,261450115,261450486,False,1,371
39603,261465951,261466744,True,1,793
39604,261465951,261467706,False,1,1755
39605,261465951,261467706,True,1,1755
39606,261484743,261503790,True,1,19047
39607,261491543,261492465,True,2,922
39608,261491543,261494148,True,4,2605
39609,261492568,261494177,True,2,1609
39610,261494214,261495282,True,4,1068
39611,261518884,261519811,True,1,927
39612,261521427,261522137,True,1,710
39613,261522597,261524206,True,4,1609
39614,261522597,261526163,True,2,3566
39615,261543590,261546788,False,1,3198
39616,261543590,261546788,True,2,3198
39617,261551294,261551397,True,1,103
39618,261551875,261552365,False,1,490
39619,261567333,261569455,False,1,2122
39620,261568681,261569451,False,1,770
39621,261589820,261622431,True,1,32611
39622,261598698,261627911,True,1,29213
39623,261599281,261607585,True,1,8304
39624,261645123,261649555,True,2,4432
39625,261647622,261649168,False,1,1546
39626,261649690,261652379,True,1,2689
39627,261661337,261693851,True,1,32514
39628,261664252,261665759,True,1,1507
39629,261674223,261680201,False,1,5978
39630,261691426,261729010,False,1,37584
39631,261706289,261710886,True,6,4597
39632,261708110,261717115,True,2,9005
39633,261721764,261724133,True,1,2369
39634,261721807,261724133,True,1,2326
39635,261748377,261749204,False,1,827
39636,261764386,261764902,True,1,516
39637,261766523,261767610,True,3,1087
39638,261774566,261779911,False,1,5345
39639,261794118,261794317,True,3,199
39640,261800591,261802023,True,1,1432
39641,261819421,261819578,True,12,157
39642,261823673,261824246,True,2,573
39643,261823673,261824383,False,1,710
39644,261833009,261835468,True,1,2459
39645,261845303,261846819,False,1,1516
39646,261845303,261848258,True,1,2955
39647,261857028,261857379,True,9,351
39648,261879525,261879698,True,1,173
39649,261882681,261883679,True,1,998
39650,261899017,261900674,True,1,1657
39651,261931572,261946170,True,5,14598
39652,261957862,261960187,True,2,2325
39653,261990034,261990389,False,1,355
39654,262009127,262013174,True,2,4047
39655,262015814,262020591,True,1,4777
39656,262025350,262072775,True,3,47425
39657,262026854,262028009,True,1,1155
39658,262037667,262037753,True,2,86
39659,262038667,262039279,True,1,612
39660,262046988,262047181,True,1,193
39661,262050683,262053174,True,1,2491
39662,262077105,262077288,True,2,183
39663,262089055,262089954,False,1,899
39664,262131401,262134548,True,3,3147
39665,262143549,262144559,True,1,1010
39666,262161600,262161702,False,1,102
39667,262162002,262162915,False,1,913
39668,262169997,262170083,True,2,86
39669,262170703,262172697,True,1,1994
39670,262192620,262192946,True,1,326
39671,262192620,262194294,True,1,1674
39672,262200996,262201145,True,1,149
39673,262201103,262201402,True,1,299
39674,262201394,262201496,True,2,102
39675,262201783,262202628,True,1,845
39676,262205955,262208242,True,2,2287
39677,262227352,262230017,True,1,2665
39678,262227352,262240283,True,1,12931
39679,262259697,262260085,True,1,388
39680,262267291,262273869,False,1,6578
39681,262267291,262273910,True,3,6619
39682,262285634,262297114,False,1,11480
39683,262285634,262297114,True,1,11480
39684,262296098,262297026,True,1,928
39685,262297335,262304552,True,1,7217
39686,262314679,262314778,True,4,99
39687,262315222,262346192,True,1,30970
39688,262322225,262339756,False,1,17531
39689,262322225,262339756,True,8,17531
39690,262348395,262355481,True,1,7086
39691,262350196,262350967,False,3,771
39692,262362763,262367977,True,3,5214
39693,262366111,262367903,True,1,1792
39694,262367722,262367888,True,1,166
39695,262372871,262373007,True,1,136
39696,262374287,262375645,True,2,1358
39697,262381968,262382168,True,1,200
39698,262387188,262388792,False,1,1604
39699,262424014,262425052,True,3,1038
39700,262434940,262439277,True,1,4337
39701,262436818,262437759,True,2,941
39702,262436818,262440128,False,1,3310
39703,262436818,262440128,True,6,3310
39704,262437533,262438153,True,1,620
39705,262437533,262440522,True,2,2989
39706,262438527,262438660,True,1,133
39707,262442105,262443611,True,1,1506
39708,262481153,262771191,True,1,290038
39709,262481153,263021826,True,2,540673
39710,262507749,262514975,True,5,7226
39711,262516710,262518824,True,1,2114
39712,262531013,262599956,True,1,68943
39713,262534153,262538123,True,3,3970
39714,262550666,262554682,True,1,4016
39715,262550666,262557212,True,1,6546
39716,262552874,262559481,True,1,6607
39717,262557746,262558050,True,1,304
39718,262575730,262580893,True,9,5163
39719,262590185,262595596,False,1,5411
39720,262590185,262595596,True,1,5411
39721,262590188,262601477,False,1,11289
39722,262594376,262596693,True,1,2317
39723,262618051,262619542,False,1,1491
39724,262629811,262630194,False,1,383
39725,262629811,262632462,True,1,2651
39726,262629811,262643851,True,4,14040
39727,262650300,262650890,True,2,590
39728,262656954,262660249,True,1,3295
39729,262656954,262662645,False,1,5691
39730,262656954,262668230,False,1,11276
39731,262663973,262666093,True,1,2120
39732,262676666,262685211,False,1,8545
39733,262676666,262685211,True,3,8545
39734,262700386,262704802,True,2,4416
39735,262700386,262705950,True,1,5564
39736,262705514,262726295,False,1,20781
39737,262713287,262713743,True,1,456
39738,262713287,262713995,True,2,708
39739,262713956,262714161,True,1,205
39740,262738620,262743466,True,1,4846
39741,262777635,262777946,True,1,311
39742,262777635,262778332,True,1,697
39743,262784592,262786342,True,1,1750
39744,262792200,262792442,True,1,242
39745,262792907,262793004,True,1,97
39746,262796844,262797322,True,1,478
39747,262809803,262810264,False,1,461
39748,262819159,262819256,True,1,97
39749,262876057,262876447,False,2,390
39750,262877527,262877618,True,2,91
39751,262878613,262879702,False,1,1089
39752,262892219,262899380,True,1,7161
39753,262894856,262900811,True,1,5955
39754,262902455,262904999,False,1,2544
39755,262903442,262904955,True,1,1513
39756,262904558,262905700,True,1,1142
39757,262913747,262923248,True,1,9501
39758,262930019,262932381,False,1,2362
39759,262930019,262932381,True,2,2362
39760,262966929,262967076,True,2,147
39761,262973654,262981859,False,1,8205
39762,262985739,262987769,True,1,2030
39763,263017047,263018727,True,1,1680
39764,263017047,263019546,True,5,2499
39765,263026323,263032701,True,1,6378
39766,263026323,263032704,True,1,6381
39767,263026601,263032848,True,1,6247
39768,263027817,263033488,True,1,5671
39769,263027817,263033491,True,1,5674
39770,263057076,263058920,True,6,1844
39771,263080675,263112180,False,1,31505
39772,263099164,263100120,True,3,956
39773,263110832,263116741,True,1,5909
39774,263122734,263130398,True,1,7664
39775,263143054,263145473,True,1,2419
39776,263143054,263173966,True,1,30912
39777,263162242,263163794,True,1,1552
39778,263167041,263167953,True,1,912
39779,263171249,263197633,False,1,26384
39780,263178854,263179672,False,1,818
39781,263179239,263182431,False,1,3192
39782,263186870,263191650,True,3,4780
39783,263190301,263266584,True,1,76283
39784,263191313,263191408,False,2,95
39785,263191313,263191408,True,4,95
39786,263260846,263277996,True,1,17150
39787,263262431,263278969,False,1,16538
39788,263269719,263272002,True,2,2283
39789,263288919,263292682,True,1,3763
39790,263288919,263313824,True,1,24905
39791,263289968,263293072,True,1,3104
39792,263294914,263314848,False,1,19934
39793,263299330,263336869,False,1,37539
39794,263347856,263361308,True,2,13452
39795,263348857,263349191,True,2,334
39796,263367027,263367223,False,1,196
39797,263367120,263367380,True,2,260
39798,263369196,263373876,True,1,4680
39799,263377354,263392604,True,1,15250
39800,263404118,263406752,False,1,2634
39801,263407573,263415189,False,1,7616
39802,263411457,263419254,True,1,7797
39803,263411457,263419468,True,1,8011
39804,263420001,263421437,True,1,1436
39805,263442210,263443734,True,1,1524
39806,263493197,263501977,True,3,8780
39807,263494471,263496013,True,1,1542
39808,263521991,263522101,True,1,110
39809,263523158,263563176,True,2,40018
39810,263523158,263602525,True,1,79367
39811,263523158,263850871,True,2,327713
39812,263541382,263541695,False,1,313
39813,263541382,263541695,True,2,313
39814,263552491,263561368,False,1,8877
39815,263559379,263560955,True,1,1576
39816,263562236,263562783,True,1,547
39817,263562253,263796885,True,3,234632
39818,263585669,263588481,True,2,2812
39819,263594866,263594933,True,1,67
39820,263597882,263601651,False,2,3769
39821,263598547,263601981,True,2,3434
39822,263603425,263603969,False,1,544
39823,263615473,263615910,True,1,437
39824,263623423,263625896,True,2,2473
39825,263637067,263637352,True,2,285
39826,263642730,263643263,True,1,533
39827,263663781,263664061,True,1,280
39828,263664220,263665885,False,1,1665
39829,263686868,263690327,False,1,3459
39830,263686868,263690327,True,2,3459
39831,263714963,263715347,True,2,384
39832,263724808,263725285,False,1,477
39833,263725390,263740924,True,12,15534
39834,263725390,263745743,True,2,20353
39835,263740448,263741132,True,1,684
39836,263746538,263746976,True,1,438
39837,263747502,263756382,True,6,8880
39838,263747660,263756540,True,1,8880
39839,263748036,263756756,True,1,8720
39840,263754736,263754840,True,1,104
39841,263756358,263761131,True,1,4773
39842,263783875,263786684,True,1,2809
39843,263785760,263787589,True,2,1829
39844,263788822,263792144,True,3,3322
39845,263790540,263803952,True,2,13412
39846,263803663,263806457,True,1,2794
39847,263804638,263806930,False,1,2292
39848,263808131,263808656,False,1,525
39849,263815954,263816724,True,1,770
39850,263816863,263818480,True,2,1617
39851,263830713,263832323,True,1,1610
39852,263838997,263839084,True,1,87
39853,263846878,263847525,False,1,647
39854,263869414,263878111,False,1,8697
39855,263869414,263878111,True,2,8697
39856,263899359,263907954,False,1,8595
39857,263899359,263907954,True,1,8595
39858,263916584,263917309,True,1,725
39859,263916976,263917963,False,1,987
39860,263916976,263918123,True,1,1147
39861,263916976,263920967,False,1,3991
39862,263916976,263920967,True,1,3991
39863,263916976,263929539,False,1,12563
39864,263927427,263934739,False,1,7312
39865,263947696,263951627,False,1,3931
39866,263952419,263957090,True,3,4671
39867,263987916,263988972,True,1,1056
39868,264016771,264018839,True,1,2068
39869,264019554,264019826,True,1,272
39870,264019554,264025081,True,1,5527
39871,264060696,264063183,True,5,2487
39872,264072630,264083319,True,3,10689
39873,264073822,264083188,False,1,9366
39874,264138300,264242295,True,1,103995
39875,264166619,264167363,True,1,744
39876,264166752,264167170,True,1,418
39877,264166752,264167173,True,2,421
39878,264174381,264183000,True,1,8619
39879,264185944,264188188,True,2,2244
39880,264186212,264188188,True,3,1976
39881,264258570,264298069,True,1,39499
39882,264273156,264289932,True,2,16776
39883,264316637,264316772,True,1,135
39884,264316652,264316772,True,1,120
39885,264321297,264323257,False,2,1960
39886,264321377,264376786,True,1,55409
39887,264339292,264343569,True,1,4277
39888,264350323,264350421,True,1,98
39889,264365578,264368378,True,1,2800
39890,264391623,264394245,True,3,2622
39891,264395125,264396704,True,3,1579
39892,264395142,264399641,True,1,4499
39893,264404697,264404877,True,1,180
39894,264418800,264418997,True,2,197
39895,264427948,264430100,True,2,2152
39896,264455604,264456228,True,1,624
39897,264467354,264469314,True,1,1960
39898,264483323,264490979,False,1,7656
39899,264483323,264490979,True,1,7656
39900,264491641,264497215,False,1,5574
39901,264501098,264505166,False,2,4068
39902,264501098,264506823,False,1,5725
39903,264501098,264508160,False,1,7062
39904,264501098,264516493,True,1,15395
39905,264502516,264506631,False,1,4115
39906,264502516,264506693,False,1,4177
39907,264502516,264516538,False,1,14022
39908,264525315,264530284,True,1,4969
39909,264530093,264530275,False,1,182
39910,264540016,264540403,True,1,387
39911,264553148,264553398,True,1,250
39912,264554910,264555656,True,1,746
39913,264571199,264572624,False,1,1425
39914,264571199,264572624,True,3,1425
39915,264571325,264572624,True,1,1299
39916,264575061,264589925,True,1,14864
39917,264575061,264590852,True,4,15791
39918,264596041,264619710,True,1,23669
39919,264626138,264635678,True,1,9540
39920,264632260,264635324,True,1,3064
39921,264645472,264645755,True,1,283
39922,264667219,264668499,True,2,1280
39923,264667219,264675126,True,1,7907
39924,264667354,264679790,False,1,12436
39925,264675564,264680015,False,1,4451
39926,264709636,264713272,True,1,3636
39927,264727380,264764396,True,1,37016
39928,264746803,264757954,True,1,11151
39929,264749236,264749887,True,2,651
39930,264757655,264757788,False,1,133
39931,264758681,264763804,True,1,5123
39932,264758935,264759422,True,1,487
39933,264759475,264764248,True,1,4773
39934,264775710,264788331,True,1,12621
39935,264777008,264783361,True,3,6353
39936,264797618,264797732,True,4,114
39937,264797618,264798361,True,1,743
39938,264800386,264800997,True,2,611
39939,264827669,264828194,True,1,525
39940,264827746,264828247,True,1,501
39941,264828153,264828262,True,1,109
39942,264832916,264839775,True,1,6859
39943,264837666,264837937,True,1,271
39944,264856324,264909427,True,1,53103
39945,264869045,264879592,True,3,10547
39946,264872160,264872255,True,2,95
39947,264882408,264886388,False,1,3980
39948,264882408,264887520,False,1,5112
39949,264886253,264886370,False,1,117
39950,264891628,264909366,True,1,17738
39951,264893966,264896708,False,1,2742
39952,264910740,264922475,False,1,11735
39953,264910740,264930911,False,1,20171
39954,264940043,264950823,False,1,10780
39955,264940043,264950823,True,2,10780
39956,264960284,264988267,True,1,27983
39957,265002753,265011546,False,1,8793
39958,265002753,265011546,True,1,8793
39959,265067640,265069774,True,2,2134
39960,265094256,265096221,True,1,1965
39961,265105852,265110996,True,1,5144
39962,265121383,265122189,True,1,806
39963,265131121,265131781,True,1,660
39964,265137771,265138334,True,1,563
39965,265137771,265144219,True,1,6448
39966,265137771,265157367,True,1,19596
39967,265138885,265144416,True,1,5531
39968,265151721,265156017,True,1,4296
39969,265168779,265169839,True,1,1060
39970,265178390,265181656,True,1,3266
39971,265178960,265182226,True,1,3266
39972,265180094,265181045,True,1,951
39973,265180094,265181076,True,1,982
39974,265182288,265182388,True,1,100
39975,265195473,265209785,True,2,14312
39976,265195571,265209785,True,1,14214
39977,265206431,265207653,False,1,1222
39978,265235649,265236117,True,2,468
39979,265244982,265245317,True,1,335
39980,265258142,265258389,True,1,247
39981,265302290,265307580,True,5,5290
39982,265315821,265319788,True,3,3967
39983,265317142,265318285,True,1,1143
39984,265340096,265400241,True,4,60145
39985,265362714,265363251,True,4,537
39986,265514449,265521914,True,2,7465
39987,265560651,265563792,False,1,3141
39988,265560651,265563792,True,2,3141
39989,265632336,265653897,True,4,21561
39990,265648572,265658218,True,1,9646
39991,265652662,265660061,True,1,7399
39992,265687663,265791778,True,2,104115
39993,265704398,265704791,False,1,393
39994,265719034,265719036,True,1,2
39995,265782235,265787221,True,1,4986
39996,265784197,265789233,True,1,5036
39997,265793255,265799094,False,1,5839
39998,265808058,265808409,False,1,351
39999,265810964,265813646,False,2,2682
40000,265832924,265869099,True,1,36175
40001,265869862,265898091,True,1,28229
40002,265875765,265897557,True,3,21792
40003,265876369,265897855,True,1,21486
40004,265877572,265883641,True,1,6069
40005,265925761,265926106,True,1,345
40006,265932728,265937491,False,1,4763
40007,266006457,266007468,False,1,1011
40008,266006457,266007468,True,1,1011
40009,266073489,266077784,True,2,4295
40010,266088118,266088796,False,3,678
40011,266088118,266088796,True,6,678
40012,266089110,266089807,True,1,697
40013,266124753,266129195,False,1,4442
40014,266130638,266135840,True,6,5202
40015,266134603,266151893,True,1,17290
40016,266150017,266151863,True,2,1846
40017,266181981,266182533,False,1,552
40018,266181981,266182533,True,1,552
40019,266187780,266188912,True,1,1132
40020,266238205,266284948,True,1,46743
40021,266271459,266271576,True,1,117
40022,266275347,266277529,True,3,2182
40023,266296682,266312376,False,1,15694
40024,266349617,266576818,True,1,227201
40025,266359725,266360573,False,1,848
40026,266359725,266360573,True,1,848
40027,266390909,266391425,True,1,516
40028,266390909,266391830,True,1,921
40029,266390977,266391425,True,6,448
40030,266401743,266401836,False,1,93
40031,266401743,266401836,True,3,93
40032,266439725,266439800,True,1,75
40033,266462010,266465125,False,1,3115
40034,266522276,266522955,True,1,679
40035,266522730,266576011,True,1,53281
40036,266522989,266576159,True,1,53170
40037,266528569,266531038,True,1,2469
40038,266529370,266531481,False,1,2111
40039,266548088,266548890,True,1,802
40040,266575045,266578834,True,3,3789
40041,266583878,266586380,True,1,2502
40042,266585561,266586314,True,2,753
40043,266586736,266587181,True,1,445
40044,266606282,266606869,True,2,587
40045,266611659,266612420,True,1,761
40046,266616118,266617045,True,4,927
40047,266621171,266621483,True,1,312
40048,266639685,266646825,True,1,7140
40049,266640475,266645750,True,1,5275
40050,266640475,266647080,True,1,6605
40051,266640475,266647702,True,1,7227
40052,266674253,266675973,True,1,1720
40053,266692072,266694381,False,1,2309
40054,266695374,266696235,True,1,861
40055,266702974,266704301,True,1,1327
40056,266721346,266723376,True,1,2030
40057,266742449,266749881,True,1,7432
40058,266806189,266828307,True,3,22118
40059,266818934,266819173,False,1,239
40060,266818934,266826865,False,1,7931
40061,266835119,266836532,False,1,1413
40062,266835119,266836532,True,5,1413
40063,266838635,266838934,True,1,299
40064,266860249,266912569,True,2,52320
40065,266901247,266901411,True,1,164
40066,266902662,266902895,True,3,233
40067,266903021,266925045,True,1,22024
40068,266903126,266925097,True,1,21971
40069,266903323,266925347,True,2,22024
40070,266910110,266911003,False,1,893
40071,266910110,266925827,True,2,15717
40072,266930126,266932053,True,3,1927
40073,266930126,266937236,True,1,7110
40074,266955149,266955564,True,1,415
40075,266958613,266960231,False,1,1618
40076,266971034,266972878,False,1,1844
40077,266985540,266986225,True,1,685
40078,266986367,266988757,True,1,2390
40079,267001766,267007315,True,1,5549
40080,267001766,267007637,True,2,5871
40081,267005864,267027394,True,1,21530
40082,267014838,267018941,True,6,4103
40083,267038317,267040914,False,1,2597
40084,267065682,267066922,True,1,1240
40085,267080243,267081973,True,1,1730
40086,267083126,267179583,True,1,96457
40087,267083434,267179891,False,1,96457
40088,267090775,267096496,True,1,5721
40089,267092879,267098600,True,1,5721
40090,267123710,267124370,True,1,660
40091,267125381,267158346,True,4,32965
40092,267125523,267158488,True,1,32965
40093,267126392,267141150,True,1,14758
40094,267126392,267146559,True,2,20167
40095,267138457,267140034,False,1,1577
40096,267138457,267140034,True,2,1577
40097,267168928,267174853,False,1,5925
40098,267168928,267180139,True,2,11211
40099,267179109,267318716,True,1,139607
40100,267188542,267201561,True,1,13019
40101,267210756,267210924,False,1,168
40102,267219134,267219881,False,1,747
40103,267228008,267231739,True,1,3731
40104,267228008,267231746,True,1,3738
40105,267228119,267231841,True,1,3722
40106,267228967,267232274,True,1,3307
40107,267230687,267237863,True,1,7176
40108,267244181,267259760,True,1,15579
40109,267244181,267260210,True,2,16029
40110,267268515,267269459,True,1,944
40111,267268515,267272393,True,1,3878
40112,267287848,267287954,True,1,106
40113,267305213,267306155,True,1,942
40114,267310228,267312520,True,1,2292
40115,267314694,267314893,True,3,199
40116,267322767,267325092,True,1,2325
40117,267339983,267342300,True,1,2317
40118,267346379,267360605,False,1,14226
40119,267355435,267356148,False,1,713
40120,267357283,267358436,True,1,1153
40121,267366267,267403780,True,1,37513
40122,267368308,267376461,False,1,8153
40123,267395164,267403365,True,1,8201
40124,267400642,267435951,True,1,35309
40125,267400642,267492228,True,1,91586
40126,267414199,267416941,True,1,2742
40127,267414553,267428231,True,1,13678
40128,267414812,267428230,True,2,13418
40129,267421334,267422439,True,1,1105
40130,267421742,267440279,True,1,18537
40131,267445419,267448430,True,3,3011
40132,267476372,267483347,True,1,6975
40133,267496018,267496355,True,1,337
40134,267496018,267501492,True,2,5474
40135,267507234,267507618,True,1,384
40136,267512923,267516679,False,1,3756
40137,267516266,267516524,False,1,258
40138,267516266,267516524,True,9,258
40139,267516272,267516589,True,2,317
40140,267557534,267558443,True,2,909
40141,267557691,267560298,True,1,2607
40142,267563276,267565343,True,1,2067
40143,267567481,267567556,True,1,75
40144,267575494,267577639,True,3,2145
40145,267575494,267577643,True,1,2149
40146,267580198,267596695,False,1,16497
40147,267585088,267587176,True,1,2088
40148,267590454,267590764,True,1,310
40149,267610386,267611111,True,1,725
40150,267614041,267617994,True,1,3953
40151,267624521,267633878,True,1,9357
40152,267628375,267630068,False,1,1693
40153,267632062,267632643,True,1,581
40154,267647207,267650604,False,1,3397
40155,267684829,267686399,False,1,1570
40156,267720185,267731611,True,1,11426
40157,267722778,267732892,True,1,10114
40158,267723073,267732918,True,3,9845
40159,267723773,267733343,True,1,9570
40160,267753085,267754056,True,2,971
40161,267758516,267759562,True,1,1046
40162,267769477,267786173,True,1,16696
40163,267774222,267857825,True,1,83603
40164,267800161,267801665,True,1,1504
40165,267804921,267809571,False,1,4650
40166,267808979,267819444,True,3,10465
40167,267809908,267819444,True,4,9536
40168,267811785,267821321,True,1,9536
40169,267819924,267820305,True,1,381
40170,267836759,267848891,True,1,12132
40171,267860919,267861262,True,1,343
40172,267863390,267867201,True,1,3811
40173,267863390,267872939,False,1,9549
40174,267877873,267948563,True,2,70690
40175,267879594,267880898,True,2,1304
40176,267882575,267882772,True,3,197
40177,267882960,267884437,True,1,1477
40178,267882960,267890021,True,3,7061
40179,267909220,267911979,True,1,2759
40180,267915420,267915828,True,1,408
40181,267943909,267944027,False,1,118
40182,267943909,267944049,True,3,140
40183,267950557,267955275,True,1,4718
40184,267953920,267955230,True,2,1310
40185,267954029,267955654,True,1,1625
40186,267956564,267965171,True,1,8607
40187,267963993,267977315,False,1,13322
40188,267968410,267968962,True,1,552
40189,267969337,267981281,True,3,11944
40190,268001019,268004662,True,1,3643
40191,268002116,268003889,True,3,1773
40192,268032120,268032904,False,1,784
40193,268039807,268041180,True,2,1373
40194,268042650,268043531,False,1,881
40195,268042650,268043531,True,3,881
40196,268044883,268047168,False,1,2285
40197,268044883,268047168,True,1,2285
40198,268044883,268052506,True,1,7623
40199,268045283,268045369,False,2,86
40200,268045283,268045369,True,1,86
40201,268047821,268048656,False,1,835
40202,268061569,268063623,True,1,2054
40203,268075937,268076645,False,1,708
40204,268077778,268077907,True,1,129
40205,268099954,268101213,True,5,1259
40206,268119527,268121494,True,1,1967
40207,268122251,268122968,False,1,717
40208,268122251,268122968,True,1,717
40209,268125426,268127113,False,1,1687
40210,268131379,268133105,True,2,1726
40211,268131379,268138113,True,1,6734
40212,268135189,268140111,True,1,4922
40213,268144395,268145929,True,1,1534
40214,268148651,268150920,True,1,2269
40215,268148651,268153844,True,1,5193
40216,268150794,268151569,True,4,775
40217,268189105,268194052,False,1,4947
40218,268189105,268194052,True,1,4947
40219,268189799,268199349,True,1,9550
40220,268236550,268236873,True,3,323
40221,268236550,268237231,True,2,681
40222,268238010,268238574,True,1,564
40223,268247036,268249873,False,1,2837
40224,268247036,268249873,True,3,2837
40225,268247036,268250413,True,1,3377
40226,268247036,268252333,True,1,5297
40227,268252983,268253421,True,1,438
40228,268254628,268257094,True,1,2466
40229,268256913,268257295,True,1,382
40230,268270201,268272327,True,1,2126
40231,268270201,268284706,True,1,14505
40232,268285157,268301013,True,1,15856
40233,268291373,268292592,False,1,1219
40234,268291373,268292592,True,3,1219
40235,268291780,268292719,True,1,939
40236,268292931,268293492,True,2,561
40237,268295385,268298848,True,1,3463
40238,268297356,268298907,True,1,1551
40239,268301535,268301677,True,1,142
40240,268324123,268325053,True,1,930
40241,268330915,268348388,True,1,17473
40242,268354119,268356535,False,1,2416
40243,268362796,268371955,True,1,9159
40244,268363559,268372243,True,2,8684
40245,268370360,268370907,True,1,547
40246,268394102,268398191,True,3,4089
40247,268403808,268414413,True,1,10605
40248,268406737,268428386,True,3,21649
40249,268406737,268440912,True,1,34175
40250,268406737,268442933,True,1,36196
40251,268409468,268418710,True,2,9242
40252,268409940,268419032,True,1,9092
40253,268410444,268411905,True,1,1461
40254,268419679,268432842,True,1,13163
40255,268419679,268438639,False,1,18960
40256,268421243,268423107,True,2,1864
40257,268421556,268428829,True,2,7273
40258,268425072,268427736,True,1,2664
40259,268433319,268433500,False,1,181
40260,268450638,268464927,False,1,14289
40261,268460165,268461075,False,1,910
40262,268467849,268475334,True,1,7485
40263,268481722,268486832,True,1,5110
40264,268499038,268500213,True,2,1175
40265,268499190,268500731,False,1,1541
40266,268499837,268502447,True,1,2610
40267,268500775,268503677,True,8,2902
40268,268503249,268503354,True,1,105
40269,268506117,268506541,False,1,424
40270,268509148,268511715,True,1,2567
40271,268517495,268517911,True,1,416
40272,268535921,268536806,True,1,885
40273,268539249,268575074,True,1,35825
40274,268547175,268574525,True,1,27350
40275,268548863,268575518,True,1,26655
40276,268564431,268618277,False,1,53846
40277,268581413,268581699,True,1,286
40278,268581888,268582582,True,1,694
40279,268607374,268609222,True,1,1848
40280,268611122,268613478,True,1,2356
40281,268613053,268642607,False,1,29554
40282,268621164,268631851,True,1,10687
40283,268642080,268646253,True,2,4173
40284,268642080,268647799,True,1,5719
40285,268646239,268653509,True,1,7270
40286,268650794,268656725,False,1,5931
40287,268652463,268653817,True,1,1354
40288,268663219,268674628,True,1,11409
40289,268663219,268677727,True,1,14508
40290,268687871,268690490,True,1,2619
40291,268692544,268695067,True,1,2523
40292,268703027,268772769,True,2,69742
40293,268720861,268721804,True,1,943
40294,268728434,268730387,True,1,1953
40295,268733118,268733705,True,1,587
40296,268738199,268757111,True,1,18912
40297,268756748,268757862,True,4,1114
40298,268756748,268759787,True,1,3039
40299,268756748,268760076,True,3,3328
40300,268756988,268757862,True,1,874
40301,268766135,268768699,False,2,2564
40302,268799790,268800496,False,1,706
40303,268799790,268800496,True,4,706
40304,268841500,268844655,True,2,3155
40305,268842878,268880788,True,1,37910
40306,268872272,268873790,True,1,1518
40307,268907190,268907804,True,2,614
40308,268928663,268992796,True,5,64133
40309,268935055,268939168,False,1,4113
40310,268935055,268939168,True,2,4113
40311,268939270,268941206,True,2,1936
40312,268947282,268947391,True,1,109
40313,268947282,268951031,True,5,3749
40314,268955802,268956032,True,1,230
40315,268957455,268959637,True,3,2182
40316,268981956,268982345,True,6,389
40317,268986263,268986449,True,1,186
40318,269028629,269158754,False,1,130125
40319,269028629,269158754,True,2,130125
40320,269080372,269080738,False,1,366
40321,269112522,269113423,False,1,901
40322,269145602,269146764,False,1,1162
40323,269152574,269189653,True,2,37079
40324,269164216,269219458,True,1,55242
40325,269196993,269197101,True,1,108
40326,269210701,269218733,True,1,8032
40327,269212274,269236804,False,1,24530
40328,269227155,269231241,True,1,4086
40329,269236566,269238175,True,1,1609
40330,269244303,269245806,True,1,1503
40331,269289586,269290006,False,1,420
40332,269309582,269309718,True,1,136
40333,269340901,269349018,False,1,8117
40334,269340901,269349018,True,6,8117
40335,269342710,269343882,True,1,1172
40336,269406617,269407620,True,1,1003
40337,269424645,269425057,True,1,412
40338,269471555,269473944,True,2,2389
40339,269485998,269490944,True,1,4946
40340,269499738,269518455,False,1,18717
40341,269499738,269518457,False,2,18719
40342,269501799,269502711,True,1,912
40343,269517872,269544730,False,1,26858
40344,269517872,269544730,True,1,26858
40345,269518560,269528344,True,1,9784
40346,269519186,269532698,False,1,13512
40347,269519186,269545404,False,1,26218
40348,269556450,269609843,False,1,53393
40349,269556450,269630615,True,1,74165
40350,269558448,269563638,False,1,5190
40351,269570196,269572454,True,1,2258
40352,269572074,269574828,False,1,2754
40353,269573132,269611661,True,1,38529
40354,269628175,269703036,True,1,74861
40355,269665787,269681933,True,1,16146
40356,269693136,269698429,False,1,5293
40357,269694607,269699878,True,1,5271
40358,269702154,269703013,True,8,859
40359,269732510,269736169,True,1,3659
40360,269732665,269736169,True,2,3504
40361,269739656,269740311,False,1,655
40362,269739656,269740311,True,2,655
40363,269767213,269770712,True,1,3499
40364,269769086,269769894,True,1,808
40365,269803050,269803618,True,1,568
40366,269813928,269816630,True,1,2702
40367,269833520,269841999,True,1,8479
40368,269857643,269858866,True,1,1223
40369,269891864,269893083,True,3,1219
40370,269897866,269901564,True,1,3698
40371,269926679,269927898,True,1,1219
40372,269948043,269954853,True,1,6810
40373,269951735,269954184,True,1,2449
40374,269951816,269954284,True,1,2468
40375,269951915,269954253,True,1,2338
40376,269961770,269962443,True,1,673
40377,269970583,269972413,True,1,1830
40378,270021200,270021738,True,1,538
40379,270024044,270039784,True,1,15740
40380,270074959,270079067,True,1,4108
40381,270088119,270088246,True,1,127
40382,270091572,270093777,True,3,2205
40383,270094484,270095150,True,2,666
40384,270094484,270125214,True,2,30730
40385,270103066,270104585,True,1,1519
40386,270135218,270135342,True,1,124
40387,270135571,270144528,True,2,8957
40388,270145467,270150489,True,2,5022
40389,270152656,270153109,True,2,453
40390,270152656,270156773,True,1,4117
40391,270171095,270171235,True,1,140
40392,270171474,270171614,False,1,140
40393,270185538,270186908,False,1,1370
40394,270185538,270186908,True,5,1370
40395,270231716,270237557,True,1,5841
40396,270239888,270240359,True,1,471
40397,270245022,270245314,True,2,292
40398,270245860,270246171,True,1,311
40399,270277198,270281614,True,1,4416
40400,270277198,270281826,True,2,4628
40401,270277997,270278228,True,1,231
40402,270321772,270324440,True,2,2668
40403,270327263,270328481,True,1,1218
40404,270337666,270337897,True,1,231
40405,270337734,270338034,True,1,300
40406,270340946,270348467,True,2,7521
40407,270352423,270354146,True,1,1723
40408,270385741,270386241,False,2,500
40409,270385741,270386241,True,3,500
40410,270385741,270387702,False,3,1961
40411,270415456,270416835,True,1,1379
40412,270419437,270421603,True,1,2166
40413,270427676,270428930,False,1,1254
40414,270427676,270428930,True,1,1254
40415,270430581,270431026,True,1,445
40416,270453597,270455250,False,1,1653
40417,270456133,270457641,True,1,1508
40418,270458031,270480924,True,1,22893
40419,270459345,270481622,False,1,22277
40420,270459345,270481622,True,3,22277
40421,270461632,270482800,True,1,21168
40422,270471370,270472148,True,1,778
40423,270478532,270488717,True,2,10185
40424,270478532,270492439,True,2,13907
40425,270485381,270498512,False,1,13131
40426,270485381,270498512,True,1,13131
40427,270502491,270505380,False,1,2889
40428,270502491,270505380,True,2,2889
40429,270503593,270540018,True,1,36425
40430,270503687,270503859,True,1,172
40431,270532174,270536043,False,1,3869
40432,270532174,270536047,True,1,3873
40433,270534999,270537170,False,1,2171
40434,270539798,270540327,True,1,529
40435,270544911,270545374,False,1,463
40436,270556689,270556863,False,1,174
40437,270557934,270567476,True,1,9542
40438,270558347,270567618,False,1,9271
40439,270558347,270567618,True,1,9271
40440,270565785,270569509,True,1,3724
40441,270567944,270568981,True,6,1037
40442,270571463,270643305,True,1,71842
40443,270571463,270659690,True,1,88227
40444,270580021,270580513,True,1,492
40445,270592550,270596933,True,1,4383
40446,270599625,270600528,True,2,903
40447,270603581,270604673,True,1,1092
40448,270681942,270682849,True,1,907
40449,270681942,270685953,True,2,4011
40450,270681942,270686492,True,1,4550
40451,270690867,270691273,True,1,406
40452,270694562,270704719,True,1,10157
40453,270694562,270720870,False,1,26308
40454,270716158,270717703,True,1,1545
40455,270729461,270734033,True,3,4572
40456,270732434,270734856,True,2,2422
40457,270735235,270736256,True,3,1021
40458,270736980,270737200,True,1,220
40459,270746520,270751822,True,1,5302
40460,270762424,270763207,False,1,783
40461,270764727,270764984,True,1,257
40462,270766280,270769411,True,1,3131
40463,270776499,270779105,True,1,2606
40464,270794456,270795538,False,1,1082
40465,270829374,270832737,True,1,3363
40466,270829374,270832768,False,1,3394
40467,270837370,270840148,True,1,2778
40468,270859142,270870162,True,1,11020
40469,270877710,270878026,True,1,316
40470,270916642,270920706,True,1,4064
40471,270930672,270934239,False,1,3567
40472,270937186,270952054,True,2,14868
40473,270937186,270957814,True,1,20628
40474,270940174,270957147,True,2,16973
40475,270962234,270965537,True,1,3303
40476,270975472,270978764,True,1,3292
40477,270980994,271011890,False,1,30896
40478,270980994,271011890,True,6,30896
40479,270980994,271023154,True,1,42160
40480,270988690,270991982,True,1,3292
40481,271005126,271009491,False,19,4365
40482,271005126,271009491,True,11,4365
40483,271014172,271015984,False,1,1812
40484,271018014,271019898,True,1,1884
40485,271026999,271030638,True,1,3639
40486,271034025,271034747,False,1,722
40487,271067218,271067529,True,1,311
40488,271092069,271099089,False,1,7020
40489,271092069,271099089,True,1,7020
40490,271098290,271100884,False,1,2594
40491,271098290,271100884,True,5,2594
40492,271140831,271142414,True,1,1583
40493,271158835,271159018,True,1,183
40494,271159699,271161425,True,1,1726
40495,271192494,271198118,True,1,5624
40496,271192494,271198986,True,1,6492
40497,271202276,271203803,True,3,1527
40498,271211894,271212644,False,1,750
40499,271211894,271216668,True,3,4774
40500,271211894,271226745,True,1,14851
40501,271221131,271222810,False,1,1679
40502,271222697,271223504,True,1,807
40503,271226262,271246847,True,1,20585
40504,271226262,271273277,False,1,47015
40505,271228765,271232463,True,1,3698
40506,271249511,271250714,True,1,1203
40507,271279325,271318839,False,1,39514
40508,271352973,271353769,True,4,796
40509,271369205,271404413,True,1,35208
40510,271369205,271430186,True,1,60981
40511,271418092,271424833,True,1,6741
40512,271443664,271444632,False,2,968
40513,271444758,271460661,True,5,15903
40514,271460898,271462758,True,2,1860
40515,271464980,271470937,False,1,5957
40516,271477371,271479031,True,1,1660
40517,271477371,271479527,True,1,2156
40518,271483619,271487248,True,1,3629
40519,271491613,271505372,False,1,13759
40520,271498039,271499350,True,3,1311
40521,271498060,271505216,True,1,7156
40522,271507572,271513045,True,1,5473
40523,271508690,271513585,True,2,4895
40524,271538875,271539303,True,3,428
40525,271543553,271558363,True,1,14810
40526,271564339,271564803,True,1,464
40527,271571276,271571584,True,1,308
40528,271573343,271574055,True,1,712
40529,271619729,271619832,True,3,103
40530,271638076,271638478,False,3,402
40531,271638076,271658667,True,1,20591
40532,271638076,271782267,False,1,144191
40533,271639196,271782870,False,1,143674
40534,271645088,271649049,False,1,3961
40535,271694665,271695789,False,1,1124
40536,271708121,271715937,True,2,7816
40537,271739339,271780994,True,1,41655
40538,271739339,271781571,True,1,42232
40539,271812612,271823533,True,2,10921
40540,271812612,271825174,True,1,12562
40541,271874819,271877153,True,1,2334
40542,271903928,271905777,True,1,1849
40543,271911753,271911841,True,1,88
40544,271912216,271912848,True,3,632
40545,271915583,271917973,True,3,2390
40546,271915938,271917766,True,1,1828
40547,271938566,271943862,True,3,5296
40548,271947255,271948759,False,1,1504
40549,271947255,271948759,True,7,1504
40550,271948421,271948858,True,1,437
40551,271952187,271952361,True,1,174
40552,271952564,271952899,True,1,335
40553,271983492,271994954,False,1,11462
40554,272053242,272055400,True,1,2158
40555,272057987,272058902,True,3,915
40556,272059263,272059850,True,2,587
40557,272113117,272113208,True,2,91
40558,272161463,272161967,False,1,504
40559,272161463,272161967,True,2,504
40560,272171708,272173732,True,1,2024
40561,272262305,272263356,True,3,1051
40562,272262305,272264047,True,1,1742
40563,272273213,272276332,True,1,3119
40564,272345990,272441433,True,1,95443
40565,272352318,272417503,False,1,65185
40566,272396735,272396933,True,1,198
40567,272416298,272418732,True,1,2434
40568,272418942,272419779,True,1,837
40569,272430169,272430843,True,1,674
40570,272437502,272437579,True,1,77
40571,272446966,272447208,True,1,242
40572,272458974,272460053,True,4,1079
40573,272458974,272461198,True,2,2224
40574,272474141,272476937,True,1,2796
40575,272486714,272489188,False,1,2474
40576,272486714,272489188,True,1,2474
40577,272493130,272546710,False,1,53580
40578,272493130,272546710,True,1,53580
40579,272493130,272549790,False,1,56660
40580,272543381,272544114,True,4,733
40581,272559222,272567677,True,1,8455
40582,272574787,272575338,False,1,551
40583,272574787,272575338,True,7,551
40584,272578285,272649150,True,1,70865
40585,272587644,272588571,False,1,927
40586,272590255,272592741,True,1,2486
40587,272625519,272626005,True,2,486
40588,272641690,272641958,True,2,268
40589,272650395,272653613,False,1,3218
40590,272650395,272653689,True,4,3294
40591,272673513,272674440,True,3,927
40592,272681979,272682676,True,1,697
40593,272687997,272703989,True,2,15992
40594,272718839,272789040,True,1,70201
40595,272731060,272756349,False,1,25289
40596,272759614,272760318,True,1,704
40597,272778634,272778716,True,1,82
40598,272794977,272798968,True,1,3991
40599,272800013,272801657,True,1,1644
40600,272862583,272863792,True,1,1209
40601,272888087,272888787,True,1,700
40602,272939912,273003193,True,2,63281
40603,272998769,273005023,True,1,6254
40604,273003316,273006450,True,1,3134
40605,273022955,273024193,True,1,1238
40606,273041367,273041955,True,1,588
40607,273057819,273060538,True,5,2719
40608,273067542,273070137,True,1,2595
40609,273075916,273111143,True,1,35227
40610,273076065,273111143,True,1,35078
40611,273076330,273111143,True,1,34813
40612,273091528,273092553,True,1,1025
40613,273104693,273106628,True,3,1935
40614,273107137,273107404,True,2,267
40615,273107695,273107837,True,2,142
40616,273107751,273107837,False,1,86
40617,273107751,273107837,True,3,86
40618,273108148,273230915,True,1,122767
40619,273108148,273253548,True,1,145400
40620,273155969,273157003,False,1,1034
40621,273160253,273160401,False,2,148
40622,273160253,273160401,True,5,148
40623,273162210,273227873,True,1,65663
40624,273168083,273170114,False,1,2031
40625,273188436,273213316,True,1,24880
40626,273195716,273199308,True,1,3592
40627,273256246,273260577,True,2,4331
40628,273271122,273272578,True,1,1456
40629,273298255,273299404,True,1,1149
40630,273298752,273313739,True,1,14987
40631,273328794,273330410,True,10,1616
40632,273329230,273332960,True,2,3730
40633,273353749,273375877,False,1,22128
40634,273353749,273376012,True,1,22263
40635,273374028,273374335,True,1,307
40636,273387401,273392529,True,1,5128
40637,273398741,273400307,True,1,1566
40638,273745400,273747015,True,1,1615
40639,273745400,273747532,True,1,2132
40640,273757142,273758122,True,2,980
40641,273767393,273772407,True,1,5014
40642,273781218,273781525,False,1,307
40643,273794272,273795266,True,1,994
40644,273802866,273806307,True,1,3441
40645,273824913,273848066,True,1,23153
40646,273911003,273914628,False,1,3625
40647,273911003,273914628,True,4,3625
40648,273939579,273944365,True,1,4786
40649,273946066,273947622,True,1,1556
40650,273954728,273957485,True,1,2757
40651,273987788,273991421,False,1,3633
40652,273994119,274009631,True,1,15512
40653,274002531,274006149,True,1,3618
40654,274006942,274013468,False,1,6526
40655,274009993,274010736,True,1,743
40656,274044834,274228747,True,1,183913
40657,274150466,274154726,True,2,4260
40658,274274022,274280592,True,1,6570
40659,274287634,274290051,False,1,2417
40660,274287634,274290051,True,1,2417
40661,274407186,274409672,True,3,2486
40662,274418291,274420225,True,1,1934
40663,274436820,274511791,True,1,74971
40664,274450335,274451292,True,5,957
40665,274487406,274488422,True,1,1016
40666,274549678,274551272,True,3,1594
40667,274597765,274598420,True,1,655
40668,274607585,274614484,False,1,6899
40669,274607585,274614492,False,1,6907
40670,274618176,274622523,True,1,4347
40671,274644599,274646863,True,4,2264
40672,274661016,274668556,False,1,7540
40673,274737122,274740361,True,1,3239
40674,274839552,274839765,True,2,213
40675,274839619,274839710,True,1,91
40676,274902313,274905365,True,1,3052
40677,274931866,274933813,True,2,1947
40678,274931866,274941032,True,1,9166
40679,274951313,274951850,True,1,537
40680,274985528,274987814,True,3,2286
40681,274985528,274988328,True,2,2800
40682,274985558,274987844,True,1,2286
40683,274986825,274987485,False,1,660
40684,275007098,275008240,True,1,1142
40685,275029307,275029763,True,2,456
40686,275038396,275040636,True,2,2240
40687,275046371,275162826,False,1,116455
40688,275048173,275048656,True,1,483
40689,275049550,275050150,True,1,600
40690,275067792,275116406,True,2,48614
40691,275083935,275090240,True,1,6305
40692,275125021,275126880,True,2,1859
40693,275138879,275139159,True,1,280
40694,275176814,275177042,True,2,228
40695,275181041,275183443,True,1,2402
40696,275195380,275198137,True,1,2757
40697,275242488,275242667,True,5,179
40698,275276363,275278085,True,1,1722
40699,275309970,275316409,True,1,6439
40700,275309970,275316615,True,1,6645
40701,275309970,275319078,True,1,9108
40702,275323349,275325777,True,1,2428
40703,275346764,275350094,True,1,3330
40704,275347699,275350574,False,1,2875
40705,275347699,275350574,True,1,2875
40706,275347699,275354786,True,1,7087
40707,275374205,275376369,False,2,2164
40708,275374205,275376369,True,1,2164
40709,275376960,275396645,True,1,19685
40710,275416892,275419142,True,1,2250
40711,275423315,275475653,False,1,52338
40712,275428880,275431349,True,7,2469
40713,275435587,275460155,True,1,24568
40714,275444287,275450835,True,1,6548
40715,275458292,275471503,True,2,13211
40716,275482086,275483477,False,1,1391
40717,275496968,275562449,True,1,65481
40718,275522534,275534522,True,3,11988
40719,275545424,275547027,True,1,1603
40720,275545424,275547803,True,1,2379
40721,275549618,275551317,True,2,1699
40722,275549618,275551392,True,2,1774
40723,275553143,275559123,False,1,5980
40724,275562645,275564294,True,1,1649
40725,275575830,275578307,True,1,2477
40726,275588572,275591152,False,1,2580
40727,275602937,275603624,True,1,687
40728,275603321,275604407,True,1,1086
40729,275628789,275666430,True,1,37641
40730,275685857,275686137,False,1,280
40731,275685857,275686137,True,3,280
40732,275686279,275692248,True,1,5969
40733,275694389,275695547,True,1,1158
40734,275761253,275762018,True,3,765
40735,275782373,275782709,True,1,336
40736,275786215,275787270,True,1,1055
40737,275812555,275813355,True,1,800
40738,275812555,275813409,True,3,854
40739,275812555,275834771,True,2,22216
40740,275812555,275846880,True,1,34325
40741,275814668,275848062,True,1,33394
40742,275912534,275914428,True,1,1894
40743,275934736,275935744,True,1,1008
40744,275934736,275949127,True,2,14391
40745,275959801,275961855,True,1,2054
40746,275961706,276002625,False,1,40919
40747,275961706,276002625,True,2,40919
40748,275965406,275968347,True,1,2941
40749,275996186,276008833,True,1,12647
40750,276040599,276042400,True,1,1801
40751,276133656,276158195,True,1,24539
40752,276133656,276182653,True,1,48997
40753,276135116,276159213,True,1,24097
40754,276135116,276183671,True,1,48555
40755,276135565,276183855,True,1,48290
40756,276136190,276159675,True,1,23485
40757,276147484,276149174,False,1,1690
40758,276178305,276206716,True,4,28411
40759,276230232,276233267,False,1,3035
40760,276235329,276236475,True,1,1146
40761,276290520,276331100,False,1,40580
40762,276290735,276334111,True,2,43376
40763,276291856,276334842,True,1,42986
40764,276307381,276324302,False,1,16921
40765,276307381,276324302,True,1,16921
40766,276376955,276380672,True,1,3717
40767,276376979,276380672,True,1,3693
40768,276377003,276380672,True,1,3669
40769,276377596,276381071,True,1,3475
40770,276385008,276391916,True,1,6908
40771,276415323,276415673,True,1,350
40772,276417106,276418773,False,1,1667
40773,276418137,276418915,True,1,778
40774,276422511,276432983,True,1,10472
40775,276427104,276430057,True,4,2953
40776,276437791,276437964,True,1,173
40777,276470411,276470960,True,1,549
40778,276511949,276544918,True,1,32969
40779,276558395,276560189,True,2,1794
40780,276565571,276569267,True,2,3696
40781,276575049,276644334,True,1,69285
40782,276655320,276656985,True,2,1665
40783,276655320,276666092,True,1,10772
40784,276655320,276667788,True,1,12468
40785,276655906,276668165,True,1,12259
40786,276711260,276714496,False,1,3236
40787,276726849,276735527,True,1,8678
40788,276743515,276746174,True,1,2659
40789,276745907,276746521,True,4,614
40790,276774440,276777454,False,1,3014
40791,276774440,276777454,True,1,3014
40792,276774486,276777454,True,1,2968
40793,276782500,276785405,True,3,2905
40794,276785075,276785318,True,5,243
40795,276790665,276791198,False,1,533
40796,276823046,276827130,True,1,4084
40797,276826716,276827174,True,4,458
40798,276876082,276876606,False,1,524
40799,276876082,276876606,True,2,524
40800,276876082,276877006,True,1,924
40801,276882923,276889703,True,5,6780
40802,276907346,276907661,False,1,315
40803,276907346,276907741,True,6,395
40804,276907346,276907807,True,2,461
40805,276933710,276935964,False,2,2254
40806,276965669,276968808,True,1,3139
40807,276965669,276968811,True,1,3142
40808,276966360,276974849,True,1,8489
40809,277032017,277033414,True,1,1397
40810,277038983,277041002,True,2,2019
40811,277039031,277041002,True,2,1971
40812,277110430,277111173,True,2,743
40813,277170914,277171485,True,1,571
40814,277171557,277172148,True,1,591
40815,277188244,277200451,True,2,12207
40816,277188244,277235972,True,1,47728
40817,277219290,277221248,False,2,1958
40818,277219290,277221248,True,4,1958
40819,277225905,277232061,True,2,6156
40820,277255423,277256800,True,1,1377
40821,277258826,277272258,True,1,13432
40822,277259155,277272364,True,1,13209
40823,277259155,277279800,True,2,20645
40824,277291435,277292561,True,1,1126
40825,277297875,277298834,True,1,959
40826,277300069,277300932,True,1,863
40827,277311308,277315254,False,1,3946
40828,277328591,277331152,True,5,2561
40829,277328591,277333802,True,3,5211
40830,277332381,277334435,True,1,2054
40831,277333302,277334805,True,1,1503
40832,277355187,277376964,True,1,21777
40833,277356438,277377579,True,1,21141
40834,277357225,277377576,True,1,20351
40835,277403789,277407273,True,3,3484
40836,277406204,277410558,True,2,4354
40837,277421757,277421903,True,1,146
40838,277444005,277446472,True,1,2467
40839,277444005,277449540,True,2,5535
40840,277446866,277446964,True,4,98
40841,277451069,277451615,True,1,546
40842,277460864,277466460,True,1,5596
40843,277464898,277464982,True,1,84
40844,277465073,277465183,True,1,110
40845,277474703,277474791,True,1,88
40846,277489133,277494026,True,2,4893
40847,277490967,277494706,True,2,3739
40848,277495852,277501631,True,2,5779
40849,277536256,277562367,True,1,26111
40850,277556177,277557376,False,1,1199
40851,277568841,277569009,True,1,168
40852,277619625,277622312,False,1,2687
40853,277619625,277622312,True,1,2687
40854,277619625,277628392,True,1,8767
40855,277619625,277628577,True,1,8952
40856,277637095,277637888,True,9,793
40857,277648289,277651078,False,1,2789
40858,277650175,277654880,True,1,4705
40859,277711151,277712024,True,1,873
40860,277802252,277803425,True,2,1173
40861,277832928,277837979,True,1,5051
40862,277882150,277882577,True,1,427
40863,277882150,277920705,True,1,38555
40864,277886604,277887244,True,1,640
40865,277897617,277898321,False,1,704
40866,278013230,278013734,False,1,504
40867,278015296,278016342,True,1,1046
40868,278015296,278016755,True,1,1459
40869,278020627,278022153,False,1,1526
40870,278025909,278028332,False,1,2423
40871,278026350,278030689,True,2,4339
40872,278027360,278031338,False,1,3978
40873,278050367,278081235,True,1,30868
40874,278052145,278056122,True,2,3977
40875,278056730,278088247,True,1,31517
40876,278057111,278088464,True,1,31353
40877,278076781,278078104,True,1,1323
40878,278089659,278103736,True,1,14077
40879,278089659,278105397,True,1,15738
40880,278094977,278117610,True,1,22633
40881,278120320,278142761,True,2,22441
40882,278125837,278128515,True,1,2678
40883,278125837,278128518,False,1,2681
40884,278153232,278153472,True,3,240
40885,278177684,278178591,True,3,907
40886,278178418,278185616,True,1,7198
40887,278186511,278187389,True,1,878
40888,278189695,278191870,True,1,2175
40889,278199302,278201289,True,1,1987
40890,278201143,278207254,True,1,6111
40891,278204649,278210237,False,1,5588
40892,278234576,278251220,True,1,16644
40893,278234576,278251554,True,1,16978
40894,278271367,278295114,True,1,23747
40895,278276540,278276942,True,1,402
40896,278276540,278305717,True,1,29177
40897,278287306,278291653,False,1,4347
40898,278287306,278291653,True,2,4347
40899,278310454,278313302,True,2,2848
40900,278343733,278345294,True,1,1561
40901,278350965,278364379,True,1,13414
40902,278417536,278429691,True,1,12155
40903,278444150,278450833,True,2,6683
40904,278451888,278454249,True,5,2361
40905,278454645,278457550,True,5,2905
40906,278461865,278513312,False,1,51447
40907,278472797,278473536,True,1,739
40908,278489370,278501787,False,1,12417
40909,278489370,278502247,True,1,12877
40910,278491430,278502867,True,1,11437
40911,278495115,278497648,True,1,2533
40912,278498725,278499391,True,1,666
40913,278500279,278500773,True,1,494
40914,278504458,278506187,True,2,1729
40915,278512983,278513790,False,1,807
40916,278512983,278513790,True,1,807
40917,278516293,278516373,True,1,80
40918,278517021,278517410,True,1,389
40919,278517021,278517998,True,1,977
40920,278519038,278567074,True,1,48036
40921,278523977,278525897,True,1,1920
40922,278530642,278530819,True,1,177
40923,278540280,278540827,True,1,547
40924,278559256,278571460,False,1,12204
40925,278559256,278571460,True,2,12204
40926,278559256,278625478,True,1,66222
40927,278593712,278594878,True,3,1166
40928,278610306,278611562,False,1,1256
40929,278610306,278611562,True,4,1256
40930,278622184,278622985,True,1,801
40931,278627053,278629777,True,1,2724
40932,278647325,278647793,True,2,468
40933,278670822,278672820,False,1,1998
40934,278670822,278672820,True,10,1998
40935,278699830,278705108,True,1,5278
40936,278699830,278705112,True,1,5282
40937,278740636,278745888,True,1,5252
40938,278780905,278782244,True,1,1339
40939,278794670,278796011,True,1,1341
40940,278855961,278964485,True,1,108524
40941,278913052,278943667,True,1,30615
40942,278956316,278958583,True,1,2267
40943,278956316,278960509,True,1,4193
40944,278966257,278967676,False,3,1419
40945,278970395,278970927,False,1,532
40946,279058229,279100983,True,4,42754
40947,279058229,279139973,True,1,81744
40948,279058388,279101142,True,1,42754
40949,279086578,279097832,False,1,11254
40950,279088599,279088801,False,1,202
40951,279107389,279112449,True,1,5060
40952,279109522,279128681,True,1,19159
40953,279109522,279177540,False,1,68018
40954,279114938,279115236,True,1,298
40955,279114938,279116520,True,1,1582
40956,279114938,279116523,True,1,1585
40957,279120492,279122914,True,1,2422
40958,279125649,279126928,True,1,1279
40959,279130592,279131502,True,1,910
40960,279135973,279136779,True,2,806
40961,279202160,279204142,True,2,1982
40962,279214203,279219050,True,1,4847
40963,279231816,279231911,True,1,95
40964,279233380,279234164,False,1,784
40965,279238436,279238550,False,1,114
40966,279238607,279239806,False,2,1199
40967,279241221,279242014,False,1,793
40968,279250276,279285666,True,1,35390
40969,279266623,279267018,False,3,395
40970,279266623,279267018,True,3,395
40971,279277062,279277257,True,1,195
40972,279277661,279278088,True,1,427
40973,279281265,279282140,False,1,875
40974,279297800,279298424,False,1,624
40975,279297800,279298424,True,1,624
40976,279301203,279301647,True,1,444
40977,279308320,279310322,True,1,2002
40978,279308351,279548817,True,2,240466
40979,279371652,279371937,True,2,285
40980,279381708,279384341,True,1,2633
40981,279388480,279388658,True,1,178
40982,279388480,279388790,True,1,310
40983,279388480,279388939,True,1,459
40984,279398414,279398878,False,1,464
40985,279404969,279420166,False,1,15197
40986,279404969,279420166,True,4,15197
40987,279426292,279426668,False,1,376
40988,279426292,279426668,True,1,376
40989,279432288,279433755,False,1,1467
40990,279438928,279439332,True,1,404
40991,279448233,279449543,False,1,1310
40992,279448233,279449543,True,1,1310
40993,279461736,279461934,True,1,198
40994,279479837,279480109,True,1,272
40995,279479837,279480181,True,4,344
40996,279487297,279487718,True,2,421
40997,279493732,279494370,True,2,638
40998,279513367,279513926,True,1,559
40999,279513858,279514266,True,1,408
41000,279514683,279514970,True,1,287
41001,279552869,279553501,True,1,632
41002,279561957,279574127,True,4,12170
41003,279563256,279597085,True,6,33829
41004,279575533,279576147,False,1,614
41005,279575533,279576147,True,1,614
41006,279581728,279583793,False,1,2065
41007,279583893,279585707,True,1,1814
41008,279670507,279670585,False,1,78
41009,279670507,279670585,True,3,78
41010,279677688,279682998,True,2,5310
41011,279679607,279679781,True,1,174
41012,279688122,279689727,True,1,1605
41013,279693664,279694113,True,2,449
41014,279730490,279731714,True,1,1224
41015,279739251,279739390,False,1,139
41016,279743144,279744443,True,1,1299
41017,279755604,279756384,True,1,780
41018,279773883,279773959,True,1,76
41019,279778350,279778439,True,1,89
41020,279778618,279778823,True,1,205
41021,279779369,279782014,True,1,2645
41022,279804101,279804551,True,5,450
41023,279805454,279805561,True,1,107
41024,279811608,279812091,True,1,483
41025,279813544,279813651,False,1,107
41026,279817149,279822713,True,1,5564
41027,279825432,279825798,True,1,366
41028,279828836,279829033,True,1,197
41029,279844278,279848363,True,1,4085
41030,279850802,279851054,True,1,252
41031,279854675,279855739,True,1,1064
41032,279860147,279860295,True,4,148
41033,279868224,279868329,True,2,105
41034,279874267,279901168,True,2,26901
41035,279876258,279877748,False,2,1490
41036,279876258,279877748,True,7,1490
41037,279879986,279880498,True,1,512
41038,279885862,279885941,True,4,79
41039,279886133,279886213,True,1,80
41040,279888862,279889875,True,1,1013
41041,279890031,279890623,True,1,592
41042,279915817,279915891,True,1,74
41043,279944225,279944452,True,1,227
41044,279945721,279946018,True,1,297
41045,279959631,279960346,True,6,715
41046,279963048,279963903,False,1,855
41047,279963048,279963903,True,4,855
41048,279976106,279980200,True,1,4094
41049,279996580,279996852,True,1,272
41050,280010226,280010321,True,1,95
41051,280015760,280016127,True,1,367
41052,280023877,280023964,True,4,87
41053,280038208,280038333,True,3,125
41054,280038230,280038359,True,1,129
41055,280042255,280042343,True,1,88
41056,280044290,280044524,True,1,234
41057,280050210,280051786,True,1,1576
41058,280050257,280051786,True,1,1529
41059,280054892,280055437,True,2,545
41060,280063404,280064232,True,1,828
41061,280067804,280070071,True,7,2267
41062,280068855,280070633,True,3,1778
41063,280089071,280092200,True,1,3129
41064,280091438,280094092,False,1,2654
41065,280096572,280096670,True,1,98
41066,280101715,280102408,True,1,693
41067,280102841,280102932,True,2,91
41068,280107402,280107751,True,7,349
41069,280109319,280110838,True,1,1519
41070,280126848,280126932,True,1,84
41071,280138841,280138922,True,2,81
41072,280142358,280144091,True,2,1733
41073,280142358,280144191,True,1,1833
41074,280142358,280144535,True,1,2177
41075,280142358,280146338,True,1,3980
41076,280150310,280150413,True,1,103
41077,280160094,280160433,True,1,339
41078,280163679,280163990,True,1,311
41079,280166283,280166569,True,1,286
41080,280169703,280170349,True,1,646
41081,280172694,280172777,True,1,83
41082,280172885,280172969,True,1,84
41083,280184469,280270108,False,1,85639
41084,280193713,280194359,True,1,646
41085,280200482,280200800,True,4,318
41086,280202757,280204118,False,1,1361
41087,280207859,280211264,True,1,3405
41088,280215025,280219050,True,1,4025
41089,280237261,280238052,False,1,791
41090,280239328,280239707,True,1,379
41091,280244330,280244619,True,1,289
41092,280247960,280249513,True,1,1553
41093,280250598,280251319,True,1,721
41094,280250598,280251322,True,1,724
41095,280250915,280251498,True,1,583
41096,280271579,280271881,True,2,302
41097,280276276,280276657,True,1,381
41098,280290489,280291511,False,1,1022
41099,280291560,280291900,False,2,340
41100,280291560,280291900,True,4,340
41101,280299821,280300115,True,1,294
41102,280307368,280307732,True,3,364
41103,280312648,280314787,True,2,2139
41104,280333352,280524407,True,1,191055
41105,280334144,280524407,True,1,190263
41106,280344638,280345382,True,1,744
41107,280351380,280359086,True,1,7706
41108,280351380,280532975,True,1,181595
41109,280363958,280539314,True,1,175356
41110,280375511,280377140,True,1,1629
41111,280375828,280545203,True,2,169375
41112,280403062,280403405,True,1,343
41113,280403062,280405404,True,1,2342
41114,280405072,280559892,True,2,154820
41115,280416927,280566181,True,1,149254
41116,280417719,280566181,True,1,148462
41117,280422316,280424752,True,7,2436
41118,280430291,280572500,True,1,142209
41119,280436757,280437649,False,1,892
41120,280436757,280437649,True,3,892
41121,280444206,280579438,True,1,135232
41122,280445660,280478001,True,1,32341
41123,280457830,280585888,True,1,128058
41124,280472865,280594165,True,1,121300
41125,280473654,280594165,True,1,120511
41126,280475559,280477791,False,1,2232
41127,280487943,280489974,True,1,2031
41128,280494309,280495860,True,1,1551
41129,280498909,280606362,True,1,107453
41130,280512354,280613462,True,1,101108
41131,280521409,280521539,True,2,130
41132,280526100,280620385,True,2,94285
41133,280573940,280576006,False,1,2066
41134,280595035,280686038,False,1,91003
41135,280615211,280664833,True,1,49622
41136,280636004,280638544,True,3,2540
41137,280658372,280658469,True,2,97
41138,280662737,280663393,True,1,656
41139,280671466,280672112,True,1,646
41140,280671466,281008322,False,1,336856
41141,280685965,280686071,False,1,106
41142,280685965,280686071,True,8,106
41143,280694662,280704278,True,1,9616
41144,280709332,280709488,True,5,156
41145,280747015,280747361,True,2,346
41146,280750558,280768798,True,1,18240
41147,280791755,280791848,False,1,93
41148,280793122,280794353,False,1,1231
41149,280793122,280799144,True,1,6022
41150,280794277,280798167,True,1,3890
41151,280860188,280866228,True,1,6040
41152,280868382,280873422,True,1,5040
41153,280892738,280892832,True,1,94
41154,280899460,280908244,True,3,8784
41155,280902394,280909962,True,1,7568
41156,280908252,280921804,True,1,13552
41157,280918544,280927596,True,1,9052
41158,280937491,280937861,False,1,370
41159,280940779,280940919,False,1,140
41160,280948742,280949169,True,1,427
41161,280953668,280953963,True,1,295
41162,280960167,280961551,False,1,1384
41163,281000382,281007441,True,2,7059
41164,281015923,281016006,True,1,83
41165,281020434,281022167,True,1,1733
41166,281026944,281118860,True,2,91916
41167,281026944,281124519,True,1,97575
41168,281134924,281134925,True,1,1
41169,281174152,281186616,True,3,12464
41170,281174152,281203270,True,1,29118
41171,281176934,281177681,True,1,747
41172,281182090,281193607,False,1,11517
41173,281226925,281236659,False,1,9734
41174,281248496,281254078,True,1,5582
41175,281261590,281345199,True,1,83609
41176,281266284,281270874,False,1,4590
41177,281279022,281284448,True,2,5426
41178,281321598,281336028,True,5,14430
41179,281343876,281344522,True,1,646
41180,281355800,281356446,True,1,646
41181,281412295,281416177,True,2,3882
41182,281420301,281421676,True,1,1375
41183,281422923,281584623,True,1,161700
41184,281428366,281428554,True,1,188
41185,281439315,281592725,True,1,153410
41186,281449624,281597972,True,1,148348
41187,281462063,281604199,True,1,142136
41188,281471955,281609139,True,1,137184
41189,281481825,281614074,True,1,132249
41190,281486056,281486805,True,2,749
41191,281490215,281618269,True,1,128054
41192,281502337,281624333,True,1,121996
41193,281509724,281628022,True,1,118298
41194,281525065,281532289,False,1,7224
41195,281527356,281636838,True,1,109482
41196,281537299,281641823,True,1,104524
41197,281541576,281555534,True,1,13958
41198,281544909,281545744,True,2,835
41199,281545054,281545889,True,2,835
41200,281546286,281645854,True,1,99568
41201,281548523,281686420,True,1,137897
41202,281557785,281652066,True,1,94281
41203,281567462,281656891,True,1,89429
41204,281570433,281635822,True,1,65389
41205,281571410,281572056,True,1,646
41206,281577956,281662141,True,1,84185
41207,281587920,281667114,True,1,79194
41208,281597100,281671631,True,1,74531
41209,281603208,281674908,True,1,71700
41210,281603763,281674908,True,1,71145
41211,281622907,281684529,True,1,61622
41212,281702501,281703270,True,1,769
41213,281711281,281729940,True,1,18659
41214,281713681,281729940,True,1,16259
41215,281731922,281739112,True,1,7190
41216,281740074,281743179,True,1,3105
41217,281791162,281793096,True,1,1934
41218,281791162,281798295,True,4,7133
41219,281814403,281815157,True,1,754
41220,281835728,281836870,True,1,1142
41221,281844934,281921322,True,2,76388
41222,281852325,281879356,True,1,27031
41223,281875931,281879244,False,1,3313
41224,281901434,281903737,True,1,2303
41225,281901434,281929644,True,2,28210
41226,281940632,281942834,False,1,2202
41227,281940632,281942834,True,1,2202
41228,281963020,281978637,True,1,15617
41229,281965051,281965504,True,1,453
41230,281968030,281968337,True,1,307
41231,281979890,281981348,True,1,1458
41232,281983405,281984142,True,1,737
41233,281985102,281985256,True,1,154
41234,282001546,282005215,True,2,3669
41235,282017612,282017988,True,1,376
41236,282017612,282024852,False,1,7240
41237,282033824,282034251,True,1,427
41238,282034492,282034876,True,1,384
41239,282039998,282040135,False,1,137
41240,282039998,282040135,True,2,137
41241,282066969,282067894,True,3,925
41242,282066969,282068153,True,1,1184
41243,282086352,282130515,True,1,44163
41244,282089324,282113060,True,1,23736
41245,282098409,282103371,True,1,4962
41246,282103536,282103785,True,1,249
41247,282213217,282229255,True,2,16038
41248,282213427,282214108,True,1,681
41249,282243653,282244426,True,1,773
41250,282289964,282306186,True,1,16222
41251,282357003,282443212,True,1,86209
41252,282411301,282417421,True,1,6120
41253,282411983,282436928,True,3,24945
41254,282466673,282469487,True,1,2814
41255,282470442,282483717,True,1,13275
41256,282487208,282490348,True,2,3140
41257,282502311,282506328,False,2,4017
41258,282502311,282506328,True,1,4017
41259,282529219,282529369,True,2,150
41260,282529476,282564887,True,2,35411
41261,282564098,282572432,False,1,8334
41262,282581966,282582273,True,1,307
41263,282589534,282594936,True,3,5402
41264,282606921,282607528,True,2,607
41265,282620064,282621386,True,2,1322
41266,282649899,282653524,True,1,3625
41267,282692870,282696668,True,1,3798
41268,282692870,282699547,True,1,6677
41269,282697182,282698717,True,4,1535
41270,282697182,282701596,True,1,4414
41271,282697510,282698978,True,1,1468
41272,282719178,282720497,True,1,1319
41273,282729126,282737090,True,1,7964
41274,282761927,282762884,True,4,957
41275,282809694,282818124,False,3,8430
41276,282809694,282827851,False,1,18157
41277,282809694,282827851,True,1,18157
41278,282817052,282822159,True,1,5107
41279,282876330,282877042,True,3,712
41280,282876423,282877042,True,1,619
41281,282876495,282877042,True,1,547
41282,282876513,282877042,True,1,529
41283,282877204,282877328,True,1,124
41284,282890745,282891883,True,1,1138
41285,282914401,282918534,False,1,4133
41286,282914401,282919399,True,1,4998
41287,282914408,282918534,False,1,4126
41288,282914408,282919399,True,1,4991
41289,282914408,282921049,True,1,6641
41290,282962213,282964394,True,2,2181
41291,282976925,282999694,True,2,22769
41292,282994780,282996256,True,1,1476
41293,283043141,283045862,True,1,2721
41294,283043141,283046619,False,1,3478
41295,283044204,283046546,False,1,2342
41296,283072412,283072987,True,4,575
41297,283083514,283083776,True,3,262
41298,283086006,283087203,True,1,1197
41299,283191221,283216445,False,1,25224
41300,283191221,283217929,True,1,26708
41301,283215568,283216889,True,1,1321
41302,283257174,283258674,False,1,1500
41303,283257174,283258674,True,3,1500
41304,283257174,283258678,True,1,1504
41305,283334807,283335020,True,6,213
41306,283338257,283343494,True,11,5237
41307,283384711,283389298,True,1,4587
41308,283384711,283394398,True,1,9687
41309,283391408,283401005,True,1,9597
41310,283427844,283438142,False,1,10298
41311,283576257,283619020,True,2,42763
41312,283623155,283628220,True,1,5065
41313,283664735,283679356,True,1,14621
41314,283742209,283742865,False,1,656
41315,283760980,283765533,True,2,4553
41316,283765077,283766891,False,1,1814
41317,283806059,283843047,True,1,36988
41318,283835418,283840700,False,1,5282
41319,283881245,283882676,False,1,1431
41320,283904147,283904247,True,2,100
41321,283937804,283939065,False,1,1261
41322,283946788,283952007,True,3,5219
41323,283946788,283965264,True,1,18476
41324,283946791,283952007,True,9,5216
41325,283946791,283965264,True,2,18473
41326,284001644,284001731,True,1,87
41327,284016822,284016937,True,1,115
41328,284026090,284026199,True,1,109
41329,284041650,284041776,True,2,126
41330,284056103,284056886,True,4,783
41331,284056422,284056510,False,1,88
41332,284064092,284064233,True,1,141
41333,284090664,284090773,True,1,109
41334,284190526,284194012,True,1,3486
41335,284199211,284199347,True,1,136
41336,284199211,284219730,True,1,20519
41337,284208538,284208626,False,1,88
41338,284227581,284235512,True,1,7931
41339,284239951,284240090,True,1,139
41340,284263120,284263242,True,1,122
41341,284274134,284274338,True,2,204
41342,284277627,284285325,True,1,7698
41343,284277627,284285374,True,2,7747
41344,284278642,284278778,False,1,136
41345,284278852,284278997,True,1,145
41346,284284310,284285566,True,2,1256
41347,284287599,284287687,False,1,88
41348,284293546,284294775,True,1,1229
41349,284298152,284298273,True,1,121
41350,284300771,284403254,True,3,102483
41351,284324159,284324247,True,1,88
41352,284324159,284413021,True,1,88862
41353,284335879,284340923,True,1,5044
41354,284336520,284340044,True,1,3524
41355,284337054,284337175,True,1,121
41356,284340154,284344523,True,1,4369
41357,284361325,284361416,True,1,91
41358,284361325,284431603,True,1,70278
41359,284389963,284393669,True,1,3706
41360,284395438,284395529,False,1,91
41361,284397692,284398828,True,1,1136
41362,284413318,284413423,True,1,105
41363,284439928,284443129,True,1,3201
41364,284442665,284443163,True,1,498
41365,284442665,284443170,True,1,505
41366,284447941,284448041,True,1,100
41367,284463444,284463549,True,1,105
41368,284478476,284478734,False,1,258
41369,284479368,284479499,True,1,131
41370,284484817,284486856,False,1,2039
41371,284494515,284494624,True,1,109
41372,284501702,284501792,True,1,90
41373,284630579,284698270,True,1,67691
41374,284652994,284653125,True,1,131
41375,284668456,284668790,True,1,334
41376,284668456,284668793,True,1,337
41377,284684669,284725307,True,1,40638
41378,284688889,284689001,False,1,112
41379,284688889,284689159,False,1,270
41380,284701418,284703085,False,1,1667
41381,284707857,284782182,False,1,74325
41382,284707858,284848697,False,1,140839
41383,284707864,284847951,False,1,140087
41384,284707864,284849058,False,1,141194
41385,284728481,284728612,True,1,131
41386,284729280,284859102,False,1,129822
41387,284734633,284743885,True,1,9252
41388,284751760,284758780,True,1,7020
41389,284757265,284757388,True,1,123
41390,284793930,284796434,True,1,2504
41391,284804304,284833606,False,1,29302
41392,284846446,284846574,True,1,128
41393,284847327,284847468,False,1,141
41394,284857038,284857174,True,1,136
41395,284857666,284923220,True,1,65554
41396,284864451,284867152,True,3,2701
41397,284886838,284898484,True,2,11646
41398,284888086,284888577,False,2,491
41399,284888086,284888577,True,1,491
41400,284896241,284896527,True,1,286
41401,284914693,284915722,True,1,1029
41402,284914693,284915796,True,1,1103
41403,284918838,284919240,True,1,402
41404,284924374,284956430,False,1,32056
41405,284936945,284955772,True,1,18827
41406,284936945,284959094,True,1,22149
41407,284957635,284958663,True,1,1028
41408,284959976,284961036,False,1,1060
41409,284988143,284992768,False,1,4625
41410,284988539,284992968,False,1,4429
41411,284989100,284993244,False,1,4144
41412,284989111,284993255,False,1,4144
41413,284989414,284993406,False,1,3992
41414,284989646,284993519,False,1,3873
41415,284989658,284993531,False,1,3873
41416,284989897,284993645,False,1,3748
41417,284990326,284993863,False,1,3537
41418,285019860,285030869,True,1,11009
41419,285020834,285021200,True,1,366
41420,285074008,285076419,True,1,2411
41421,285105938,285111599,False,1,5661
41422,285105938,285111599,True,3,5661
41423,285115649,285135085,True,2,19436
41424,285116125,285135085,True,1,18960
41425,285119665,285120286,True,1,621
41426,285121104,285121400,True,1,296
41427,285131151,285131281,True,1,130
41428,285138701,285139082,True,3,381
41429,285193554,285201703,True,1,8149
41430,285211621,285212301,True,1,680
41431,285237777,285737857,False,1,500080
41432,285244725,285247070,True,1,2345
41433,285246523,285253734,True,5,7211
41434,285273453,285274039,True,1,586
41435,285276700,285277719,True,1,1019
41436,285291254,285297561,False,1,6307
41437,285316471,285319626,True,1,3155
41438,285319101,285319626,True,8,525
41439,285323440,285336173,True,1,12733
41440,285324422,285337207,True,1,12785
41441,285337423,285339636,False,1,2213
41442,285348597,285351673,True,1,3076
41443,285395293,285396637,False,1,1344
41444,285429568,285432736,True,1,3168
41445,285429568,285433286,True,1,3718
41446,285429568,285434146,True,1,4578
41447,285440886,285450026,True,2,9140
41448,285440895,285450035,False,1,9140
41449,285440895,285450035,True,2,9140
41450,285476751,285479201,True,1,2450
41451,285490718,285491803,True,1,1085
41452,285559637,285561385,True,1,1748
41453,285559637,285562769,True,1,3132
41454,285590653,285598737,True,1,8084
41455,285607092,285609772,True,1,2680
41456,285607832,285608315,False,1,483
41457,285610259,285615156,False,1,4897
41458,285658477,285661458,True,1,2981
41459,285678000,285678101,True,1,101
41460,285697111,285713533,False,1,16422
41461,285697111,285765026,False,1,67915
41462,285899248,285952363,False,1,53115
41463,285899248,285952363,True,2,53115
41464,285921199,285921698,True,4,499
41465,285964106,285964475,True,1,369
41466,285964106,285964478,True,1,372
41467,285964106,285965071,True,1,965
41468,285964106,285965554,True,1,1448
41469,285964130,285964478,True,2,348
41470,285969834,285971778,True,1,1944
41471,285970929,285973938,True,3,3009
41472,285973429,285975311,True,1,1882
41473,285994107,285994258,True,1,151
41474,286006521,286010478,False,1,3957
41475,286006521,286010478,True,1,3957
41476,286026703,286030064,True,2,3361
41477,286037043,286037263,False,3,220
41478,286089012,286090183,True,1,1171
41479,286104607,286104863,True,5,256
41480,286117676,286138148,True,1,20472
41481,286122213,286123277,False,1,1064
41482,286147671,286153510,True,1,5839
41483,286156861,286157007,True,1,146
41484,286156861,286157010,True,1,149
41485,286157524,286157991,True,1,467
41486,286158286,286158441,True,1,155
41487,286176832,286176915,True,1,83
41488,286209884,286217064,True,1,7180
41489,286238179,286280941,False,1,42762
41490,286383594,286391768,True,1,8174
41491,286559533,286567760,False,1,8227
41492,286576136,286630359,False,1,54223
41493,286587114,286604272,True,3,17158
41494,286594991,286668521,True,1,73530
41495,286636157,286638897,True,2,2740
41496,286636157,286658999,False,1,22842
41497,286636157,286718116,True,1,81959
41498,286636157,286734818,True,1,98661
41499,286637137,286639394,True,2,2257
41500,286637137,286718613,True,1,81476
41501,286642345,286827935,True,1,185590
41502,286667620,286840825,False,1,173205
41503,286673448,286676162,False,1,2714
41504,286679418,286680326,True,3,908
41505,286696263,286697957,False,1,1694
41506,286704897,286707985,True,1,3088
41507,286761046,286762581,True,1,1535
41508,286764225,286839992,True,3,75767
41509,286764286,286868300,True,1,104014
41510,286826031,286829712,True,1,3681
41511,286834542,286835147,True,1,605
41512,286839316,286877625,False,1,38309
41513,286850412,286889710,False,1,39298
41514,287019932,287039398,True,2,19466
41515,287077845,287079502,True,3,1657
41516,287091719,287102209,True,1,10490
41517,287099695,287102625,True,1,2930
41518,287099695,287102651,True,2,2956
41519,287101009,287104304,True,1,3295
41520,287170443,287170789,True,1,346
41521,287270499,287274106,True,1,3607
41522,287270499,287278110,True,2,7611
41523,287295668,287301598,False,1,5930
41524,287312357,287313195,False,1,838
41525,287374438,287392138,False,2,17700
41526,287382470,287395022,True,1,12552
41527,287384570,287396549,True,1,11979
41528,287385622,287385871,True,1,249
41529,287435859,287437332,False,1,1473
41530,287437380,287437575,False,1,195
41531,287439071,287463437,False,1,24366
41532,287478371,287479109,False,1,738
41533,287479229,287484766,True,1,5537
41534,287484965,287484966,True,1,1
41535,287493611,287493715,True,1,104
41536,287503711,287514468,True,1,10757
41537,287510085,287514692,False,1,4607
41538,287523854,287524616,True,1,762
41539,287544169,287552137,True,2,7968
41540,287563576,287564544,True,3,968
41541,287572666,287573400,False,1,734
41542,287617785,287625409,True,1,7624
41543,287617897,287625362,True,1,7465
41544,287632932,287634472,True,1,1540
41545,287635247,287639680,True,1,4433
41546,287645055,287645580,True,1,525
41547,287663527,287664094,True,1,567
41548,287691914,287692207,True,2,293
41549,287709395,287709623,True,3,228
41550,287733169,287733300,True,1,131
41551,287751833,287754600,False,2,2767
41552,287768663,287775804,True,1,7141
41553,287773933,287799942,True,2,26009
41554,287794092,287802461,True,1,8369
41555,287794092,287806527,True,1,12435
41556,287832055,287929646,True,1,97591
41557,287832500,287838046,True,1,5546
41558,287858775,287962467,True,2,103692
41559,287896032,287896716,False,1,684
41560,287896032,287898854,True,1,2822
41561,287898345,287899384,False,1,1039
41562,287909674,287910143,True,3,469
41563,287909674,287910420,True,2,746
41564,287912813,287925624,False,1,12811
41565,287941736,287942359,False,1,623
41566,287983302,287984943,True,1,1641
41567,287985483,287985918,True,1,435
41568,287990666,287991350,False,1,684
41569,287998447,288032252,True,2,33805
41570,288105082,288112237,True,2,7155
41571,288127365,288163022,True,1,35657
41572,288128642,288132446,True,1,3804
41573,288179805,288183081,False,1,3276
41574,288188966,288189705,True,1,739
41575,288199904,288202199,False,1,2295
41576,288199904,288202199,True,1,2295
41577,288199904,288202204,True,1,2300
41578,288213354,288215046,False,1,1692
41579,288213354,288215046,True,2,1692
41580,288241664,288245051,False,1,3387
41581,288241664,288245051,True,1,3387
41582,288241664,288245271,False,1,3607
41583,288293831,288295598,True,3,1767
41584,288297681,288298514,True,1,833
41585,288299789,288377188,False,1,77399
41586,288299789,288394615,False,1,94826
41587,288299789,288394615,True,3,94826
41588,288302035,288302498,True,1,463
41589,288303242,288304529,True,1,1287
41590,288320997,288321705,True,1,708
41591,288324173,288324886,False,1,713
41592,288324173,288324886,True,1,713
41593,288325883,288326512,False,1,629
41594,288329124,288330128,True,1,1004
41595,288342976,288343689,False,1,713
41596,288352901,288353609,True,1,708
41597,288356235,288358652,True,1,2417
41598,288357020,288357326,True,1,306
41599,288359119,288359827,True,1,708
41600,288364009,288364644,False,1,635
41601,288367226,288367837,True,1,611
41602,288368675,288369383,True,1,708
41603,288371276,288388406,False,1,17130
41604,288371276,288391011,True,1,19735
41605,288371827,288377294,True,1,5467
41606,288378195,288378903,True,1,708
41607,288381335,288382048,True,1,713
41608,288381335,288386810,True,1,5475
41609,288386430,288387642,True,1,1212
41610,288392569,288393204,False,2,635
41611,288419289,288419997,False,1,708
41612,288437105,288437732,True,1,627
41613,288479232,288479548,True,4,316
41614,288516395,288594610,True,2,78215
41615,288525236,288530556,True,15,5320
41616,288525236,288543040,True,8,17804
41617,288525236,288547358,True,1,22122
41618,288552410,288553188,False,1,778
41619,288590261,288590762,True,1,501
41620,288601266,288601699,False,2,433
41621,288602047,288641035,False,1,38988
41622,288606283,288639728,True,1,33445
41623,288648666,288649505,False,1,839
41624,288658287,288666295,True,1,8008
41625,288658409,288660955,True,1,2546
41626,288658909,288660848,False,1,1939
41627,288658909,288660848,True,1,1939
41628,288679180,288680086,False,1,906
41629,288699260,288701134,True,1,1874
41630,288747495,288748698,True,1,1203
41631,288783209,288783732,True,3,523
41632,288783942,288789450,True,1,5508
41633,288800443,288803556,True,1,3113
41634,288852520,288866801,False,1,14281
41635,288869869,288873121,True,1,3252
41636,288870002,288870220,False,1,218
41637,288902241,288908745,True,1,6504
41638,288912928,288913706,False,1,778
41639,288943493,288979411,True,1,35918
41640,288961729,288962162,False,2,433
41641,288961925,288969865,True,1,7940
41642,288962509,289001516,False,1,39007
41643,288997565,289005555,True,1,7990
41644,289040081,289042033,True,1,1952
41645,289187660,289192205,False,1,4545
41646,289188886,289190236,True,1,1350
41647,289192783,289194820,False,1,2037
41648,289215196,289220360,True,1,5164
41649,289225915,289337129,True,1,111214
41650,289229837,289229933,True,2,96
41651,289229951,289230052,False,1,101
41652,289230202,289230205,True,1,3
41653,289230398,289233175,True,1,2777
41654,289271486,289272783,True,1,1297
41655,289280273,289280628,True,1,355
41656,289281097,289281976,True,3,879
41657,289297997,289298141,True,1,144
41658,289301610,289302330,True,1,720
41659,289314024,289314108,True,2,84
41660,289314219,289314315,True,1,96
41661,289314469,289314545,True,1,76
41662,289323866,289324046,True,10,180
41663,289353485,289353673,False,1,188
41664,289353485,289353673,True,5,188
41665,289374134,289374312,False,1,178
41666,289374134,289374312,True,2,178
41667,289389922,289390151,True,2,229
41668,289393892,289395081,True,1,1189
41669,289408282,289413127,True,8,4845
41670,289436497,289450248,True,1,13751
41671,289436916,289450397,True,1,13481
41672,289528419,289662764,True,1,134345
41673,289533333,289535706,True,1,2373
41674,289533333,289536783,True,1,3450
41675,289533333,289537993,True,1,4660
41676,289533333,289538846,True,1,5513
41677,289533333,289539862,True,1,6529
41678,289533333,289542460,False,1,9127
41679,289559095,289559391,False,1,296
41680,289578602,289578697,True,1,95
41681,289585423,289589915,True,1,4492
41682,289593129,289594364,True,1,1235
41683,289597119,289598368,True,1,1249
41684,289613428,289613435,True,1,7
41685,289622821,289623632,True,1,811
41686,289623903,289625686,True,1,1783
41687,289632698,289634327,True,1,1629
41688,289667085,289667174,False,1,89
41689,289703866,289705586,True,1,1720
41690,289703922,289705586,True,3,1664
41691,289727031,289728515,True,1,1484
41692,289746567,289746646,True,3,79
41693,289782809,289783089,True,2,280
41694,289783179,289793665,True,1,10486
41695,289790411,289804988,True,1,14577
41696,289797502,289797591,True,8,89
41697,289798394,289798578,True,1,184
41698,289798890,289801336,True,4,2446
41699,289806267,289806386,True,3,119
41700,289806267,289806764,True,1,497
41701,289833654,289833742,True,4,88
41702,289833654,289833889,True,1,235
41703,289833814,289833904,True,1,90
41704,289834266,289835125,True,1,859
41705,289834713,289835947,False,6,1234
41706,289834713,289835947,True,2,1234
41707,289834713,289837818,False,2,3105
41708,289834713,289837818,True,1,3105
41709,289837408,289839259,False,1,1851
41710,289904136,289904324,True,4,188
41711,289985883,289985990,True,8,107
41712,290027546,290030104,False,1,2558
41713,290063018,290066295,False,4,3277
41714,290063018,290066295,True,6,3277
41715,290063018,290068460,True,2,5442
41716,290071761,290073846,True,1,2085
41717,290103317,290103392,False,1,75
41718,290103317,290103392,True,3,75
41719,290104323,290109172,True,1,4849
41720,290118207,290118289,False,1,82
41721,290118207,290118289,True,1,82
41722,290128592,290129591,True,1,999
41723,290128704,290129591,True,1,887
41724,290130940,290131028,True,1,88
41725,290149905,290150473,True,1,568
41726,290173475,290181389,True,2,7914
41727,290193027,290200312,True,1,7285
41728,290212539,290212794,True,1,255
41729,290216407,290217573,True,1,1166
41730,290225137,290225222,True,1,85
41731,290267323,290268365,True,1,1042
41732,290275230,290275548,True,2,318
41733,290275230,290275813,True,1,583
41734,290278669,290283073,True,3,4404
41735,290289536,290295918,True,3,6382
41736,290292031,290304346,True,1,12315
41737,290300090,290300693,True,1,603
41738,290300873,290300966,True,1,93
41739,290307226,290307302,False,1,76
41740,290307226,290307302,True,1,76
41741,290313704,290314631,True,1,927
41742,290319065,290319845,True,1,780
41743,290325393,290325588,False,1,195
41744,290329174,290329252,True,1,78
41745,290336155,290336249,True,1,94
41746,290350747,290372092,True,1,21345
41747,290371974,290459224,True,1,87250
41748,290385627,290385897,True,1,270
41749,290386002,290386079,True,1,77
41750,290405897,290418789,True,3,12892
41751,290405897,290421590,True,2,15693
41752,290407162,290422219,True,1,15057
41753,290418546,290457921,True,3,39375
41754,290418546,290457929,False,1,39383
41755,290418546,290457929,True,1,39383
41756,290439653,290441480,False,1,1827
41757,290449298,290451635,True,1,2337
41758,290453778,290461229,False,1,7451
41759,290478773,290485357,True,1,6584
41760,290540315,290543794,False,2,3479
41761,290540315,290543794,True,1,3479
41762,290554421,290554704,False,1,283
41763,290586812,290594950,True,1,8138
41764,290586950,290588791,True,2,1841
41765,290588019,290588161,True,1,142
41766,290605521,290606561,True,1,1040
41767,290607891,290608354,True,1,463
41768,290623743,290624461,True,2,718
41769,290623743,290629189,True,1,5446
41770,290626839,290627547,True,1,708
41771,290632382,290633509,True,1,1127
41772,290634225,290634302,True,1,77
41773,290635254,290697004,True,1,61750
41774,290636279,290636987,True,1,708
41775,290643599,290644521,True,1,922
41776,290645715,290685748,False,1,40033
41777,290648867,290673197,True,1,24330
41778,290721281,290722001,False,1,720
41779,290826616,290827881,True,1,1265
41780,290826616,290828467,True,2,1851
41781,290826616,290829501,True,1,2885
41782,290851208,290951196,False,2,99988
41783,290859322,290865174,True,2,5852
41784,290871337,290874970,True,1,3633
41785,290876043,290876313,True,1,270
41786,290876418,290876495,True,1,77
41787,290877513,290878052,True,1,539
41788,290879011,290879122,True,1,111
41789,290879138,290881338,True,1,2200
41790,290912958,290913224,True,1,266
41791,290926202,290926344,True,1,142
41792,290928010,290928897,False,2,887
41793,290928010,290928897,True,1,887
41794,290941413,290942058,True,1,645
41795,290948489,290952934,True,1,4445
41796,290954534,290964386,True,1,9852
41797,290972328,290972405,True,1,77
41798,290981771,290982693,True,1,922
41799,290986462,290992520,True,5,6058
41800,291015289,291015570,True,2,281
41801,291020029,291020477,True,1,448
41802,291028928,291029360,True,1,432
41803,291030825,291047859,False,1,17034
41804,291030825,291047859,True,1,17034
41805,291032616,291033435,True,1,819
41806,291032620,291033435,True,1,815
41807,291032620,291033445,True,1,825
41808,291033216,291033830,True,1,614
41809,291033731,291033868,True,1,137
41810,291050106,291052600,True,3,2494
41811,291050106,291055254,True,1,5148
41812,291055964,291056179,True,1,215
41813,291078618,291078760,True,1,142
41814,291098563,291104898,True,2,6335
41815,291112231,291114168,True,1,1937
41816,291128953,291130924,False,1,1971
41817,291135253,291140902,True,2,5649
41818,291150693,291153349,True,1,2656
41819,291152089,291154047,True,1,1958
41820,291154072,291154321,True,3,249
41821,291158425,291158713,True,4,288
41822,291161658,291161805,True,1,147
41823,291164486,291165058,True,1,572
41824,291164558,291165086,True,1,528
41825,291164718,291165117,True,1,399
41826,291164784,291165066,True,1,282
41827,291164965,291165082,True,1,117
41828,291166549,291181708,True,2,15159
41829,291173183,291173294,True,1,111
41830,291185375,291186641,True,2,1266
41831,291185375,291189506,True,1,4131
41832,291195526,291200804,True,1,5278
41833,291222376,291257148,True,1,34772
41834,291234316,291234384,True,1,68
41835,291237025,291237110,True,1,85
41836,291240709,291240790,False,1,81
41837,291250428,291250550,True,1,122
41838,291250856,291250939,True,1,83
41839,291251627,291251803,True,1,176
41840,291261025,291264734,False,1,3709
41841,291275847,291275938,False,1,91
41842,291275847,291275938,True,3,91
41843,291298304,291298421,True,1,117
41844,291298514,291298595,True,1,81
41845,291308881,291309947,True,1,1066
41846,291321373,291322682,False,1,1309
41847,291351467,291353054,True,1,1587
41848,291379194,291379389,True,3,195
41849,291383638,291383878,True,1,240
41850,291392397,291394748,True,1,2351
41851,291395022,291402616,True,1,7594
41852,291398042,291405636,False,1,7594
41853,291399553,291399652,True,1,99
41854,291431011,291437258,True,1,6247
41855,291437381,291437695,True,1,314
41856,291444544,291445281,True,1,737
41857,291444679,291445994,True,1,1315
41858,291455414,291470926,True,1,15512
41859,291455414,291474705,True,2,19291
41860,291459313,291459449,True,3,136
41861,291469949,291470292,True,1,343
41862,291473604,291473728,True,1,124
41863,291486773,291487479,True,1,706
41864,291486773,291488345,True,1,1572
41865,291496553,291497252,True,1,699
41866,291504773,291505008,True,1,235
41867,291505058,291505745,True,1,687
41868,291510562,291510646,True,3,84
41869,291529819,291529961,False,1,142
41870,291529819,291529961,True,6,142
41871,291530576,291534548,True,1,3972
41872,291545567,291565975,False,1,20408
41873,291561068,291651167,False,1,90099
41874,291561578,291689774,True,1,128196
41875,291575886,291576054,True,4,168
41876,291590036,291591226,True,1,1190
41877,291627517,292284813,True,1,657296
41878,291653843,291661489,True,3,7646
41879,291767865,291768720,True,1,855
41880,291782742,291782931,True,1,189
41881,291791540,291791729,True,1,189
41882,291796260,291796725,False,1,465
41883,291822365,291823032,True,5,667
41884,291832481,291836133,True,2,3652
41885,291832481,291901448,True,5,68967
41886,291832481,291918536,False,1,86055
41887,291832481,291918536,True,1,86055
41888,291849267,291850507,False,1,1240
41889,291849267,291850507,True,1,1240
41890,291893299,291895061,True,1,1762
41891,291895060,291925359,True,1,30299
41892,291895268,291902818,True,3,7550
41893,291895268,291953695,True,1,58427
41894,291938855,291941598,True,10,2743
41895,291998490,292001341,True,2,2851
41896,291998490,292001921,True,1,3431
41897,292030500,292030891,True,2,391
41898,292038726,292044691,False,1,5965
41899,292038726,292044691,True,1,5965
41900,292038726,292044694,True,1,5968
41901,292048582,292052513,False,1,3931
41902,292048582,292052513,True,2,3931
41903,292056586,292057278,True,1,692
41904,292056586,292057762,True,1,1176
41905,292066949,292067578,False,3,629
41906,292066949,292067578,True,3,629
41907,292070185,292070898,True,1,713
41908,292105896,292107328,True,4,1432
41909,292112060,292205499,False,1,93439
41910,292114603,292115902,True,1,1299
41911,292122009,292125855,True,1,3846
41912,292132956,292141759,False,1,8803
41913,292152330,292153772,True,1,1442
41914,292152330,292153926,True,1,1596
41915,292152330,292154305,True,1,1975
41916,292152712,292154687,True,1,1975
41917,292161075,292164078,True,1,3003
41918,292210556,292214558,True,3,4002
41919,292230306,292241300,True,1,10994
41920,292240716,292244777,True,1,4061
41921,292272578,292285506,False,2,12928
41922,292302378,292310617,True,3,8239
41923,292313719,292327138,True,2,13419
41924,292402913,292418837,True,1,15924
41925,292402913,292423961,True,1,21048
41926,292413520,292415098,True,1,1578
41927,292413867,292415098,True,1,1231
41928,292432041,292432754,False,1,713
41929,292456163,292459003,True,1,2840
41930,292466854,292467757,False,1,903
41931,292466854,292467757,True,2,903
41932,292477619,292478733,True,1,1114
41933,292480179,292481853,True,1,1674
41934,292492350,292496987,True,1,4637
41935,292512341,292512454,True,1,113
41936,292555706,292555793,True,1,87
41937,292556511,292556635,False,1,124
41938,292587766,292591153,False,1,3387
41939,292588906,292598209,True,1,9303
41940,292607353,292607439,True,1,86
41941,292668399,292712789,True,1,44390
41942,292680645,292681445,False,1,800
41943,292697709,292699110,True,3,1401
41944,292697881,292699249,True,1,1368
41945,292701686,292830815,True,2,129129
41946,292748180,292752456,True,1,4276
41947,292790822,292798959,True,1,8137
41948,292806140,292838538,True,1,32398
41949,292807976,292839544,True,1,31568
41950,292808290,292839550,True,1,31260
41951,292809391,292816722,True,1,7331
41952,292837447,292842255,False,1,4808
41953,292871754,292896543,True,1,24789
41954,292982147,292984162,True,1,2015
41955,293081098,293100764,True,1,19666
41956,293120956,293123739,False,1,2783
41957,293142542,293144101,False,1,1559
41958,293202943,293219064,True,1,16121
41959,293229340,293233678,True,4,4338
41960,293257905,293259973,True,3,2068
41961,293266451,293267109,True,1,658
41962,293312092,293317637,True,1,5545
41963,293316661,293319591,True,2,2930
41964,293360630,293363976,True,1,3346
41965,293364637,293366127,True,3,1490
41966,293364637,293368025,True,1,3388
41967,293428770,293438566,False,2,9796
41968,293428770,293438566,True,4,9796
41969,293428770,293445779,True,1,17009
41970,293428770,293451879,True,1,23109
41971,293472281,293473627,True,2,1346
41972,293544056,293545490,True,2,1434
41973,293710498,293840069,False,1,129571
41974,293730084,293735425,True,1,5341
41975,293840385,293876644,True,2,36259
41976,293879256,293913477,True,1,34221
41977,293936252,293946305,True,3,10053
41978,293936252,293956870,True,1,20618
41979,293982703,294090171,False,1,107468
41980,293983461,293983745,False,1,284
41981,293983461,293984106,False,1,645
41982,293984696,293994395,True,1,9699
41983,293987216,293996917,False,2,9701
41984,293987216,293996917,True,7,9701
41985,294019512,294020652,True,1,1140
41986,294023409,294025588,True,1,2179
41987,294026625,294089749,True,1,63124
41988,294061624,294063067,False,2,1443
41989,294076223,294076688,False,1,465
41990,294115360,294119226,True,1,3866
41991,294126047,294147567,True,1,21520
41992,294167064,294168056,True,1,992
41993,294193797,294200896,True,1,7099
41994,294194469,294200942,False,1,6473
41995,294210480,294212550,False,3,2070
41996,294210480,294212550,True,5,2070
41997,294238535,294239213,True,1,678
41998,294246395,294248252,True,1,1857
41999,294256061,294257483,True,1,1422
42000,294326469,294327977,False,2,1508
42001,294330097,294336208,False,1,6111
42002,294352808,294353112,True,1,304
42003,294352808,294354978,False,1,2170
42004,294352808,294354978,True,2,2170
42005,294366096,294368459,False,1,2363
42006,294408411,294411725,True,1,3314
42007,294459710,294460936,True,1,1226
42008,294459710,294473685,True,1,13975
42009,294516694,294519280,True,1,2586
42010,294539365,294546123,True,1,6758
42011,294544772,294548815,True,1,4043
42012,294562435,294567092,True,1,4657
42013,294726792,294787818,True,1,61026
42014,294749932,294755015,True,1,5083
42015,294801196,294805213,True,1,4017
42016,294801196,294809244,True,4,8048
42017,294802319,294809867,True,1,7548
42018,294851263,294852118,True,1,855
42019,294871356,294873241,False,1,1885
42020,294881784,294882686,True,1,902
42021,294887196,294888442,False,1,1246
42022,294887196,294888442,True,5,1246
42023,294932679,294933919,False,1,1240
42024,295051311,295052598,True,2,1287
42025,295054310,295083490,True,1,29180
42026,295096238,295097330,True,1,1092
42027,295098585,295099714,True,1,1129
42028,295120624,295121061,True,1,437
42029,295150511,295151140,False,3,629
42030,295150511,295151140,True,6,629
42031,295153747,295154460,True,1,713
42032,295164802,295315656,True,6,150854
42033,295164812,295164938,True,1,126
42034,295165073,295167953,True,1,2880
42035,295256518,295256813,False,1,295
42036,295256518,295256813,True,2,295
42037,295257336,295353243,True,1,95907
42038,295292314,295294353,True,1,2039
42039,295296436,295317682,False,1,21246
42040,295296732,295297882,False,1,1150
42041,295296732,295297882,True,1,1150
42042,295315694,295316135,True,1,441
42043,295361301,295369583,False,1,8282
42044,295384096,295384924,True,1,828
42045,295417675,295418999,False,1,1324
42046,295430352,295431104,True,1,752
42047,295503034,295511179,False,1,8145
42048,295503050,295511182,False,1,8132
42049,295527099,295537772,True,2,10673
42050,295548743,295552836,True,1,4093
42051,295601369,295692012,True,1,90643
42052,295602610,295602772,False,1,162
42053,295660350,295715355,True,1,55005
42054,295661429,295672028,False,1,10599
42055,295661429,295676005,True,1,14576
42056,295661429,295719611,True,1,58182
42057,295670644,295676587,False,1,5943
42058,295712506,295745215,True,1,32709
42059,295722224,295750049,True,1,27825
42060,295723970,295724935,True,1,965
42061,295723970,295731275,False,1,7305
42062,295723970,295750131,True,1,26161
42063,295749472,295767172,False,1,17700
42064,295778466,295791633,True,1,13167
42065,295810877,295812350,False,1,1473
42066,295812398,295812593,False,1,195
42067,295814089,295838469,False,1,24380
42068,295814561,295838819,False,1,24258
42069,295859524,295946249,False,1,86725
42070,295861576,295862482,False,1,906
42071,296008432,296009042,True,3,610
42072,296010913,296011626,False,1,713
42073,296010913,296011626,True,2,713
42074,296017984,296024563,False,1,6579
42075,296020276,296020994,True,1,718
42076,296020276,296025735,True,1,5459
42077,296023467,296024180,True,3,713
42078,296035166,296039076,False,1,3910
42079,296073277,296117291,True,1,44014
42080,296502366,296502976,True,5,610
42081,296502366,296507740,False,1,5374
42082,296502366,296507740,True,1,5374
42083,296502366,296517264,True,1,14898
42084,296502366,296574505,True,1,72139
42085,296505567,296506280,True,3,713
42086,296505567,296511044,True,1,5477
42087,296515095,296515808,True,3,713
42088,296534143,296534856,False,1,713
42089,296534143,296534856,True,1,713
42090,296543691,296544404,True,2,713
42091,296553219,296553932,False,1,713
42092,296553219,296553932,True,1,713
42093,296559601,296560314,False,1,713
42094,296559601,296560314,True,2,713
42095,296565987,296566700,False,2,713
42096,296565987,296566700,True,3,713
42097,296575877,296598788,True,1,22911
42098,296610513,296611226,True,2,713
42099,296629585,296630298,True,1,713
42100,296746177,296748154,False,1,1977
42101,296746177,296748154,True,4,1977
42102,296790375,296822057,True,1,31682
42103,296792053,296822984,True,1,30931
42104,296804596,296808830,False,1,4234
42105,296804596,296808830,True,2,4234
42106,296804596,296843069,True,1,38473
42107,296813457,296813578,True,2,121
42108,296814016,296860419,True,1,46403
42109,296831571,296841386,True,2,9815
42110,296831571,296863622,True,1,32051
42111,296831571,296874431,True,1,42860
42112,296850779,296854930,True,1,4151
42113,296854407,296878119,True,1,23712
42114,296886302,296886693,False,1,391
42115,296895990,296905551,True,1,9561
42116,296960715,296960825,True,1,110
42117,297009261,297010624,True,6,1363
42118,297028984,297030461,True,1,1477
42119,297030177,297031036,False,1,859
42120,297042270,297042623,True,1,353
42121,297042847,297084189,True,3,41342
42122,297043242,297084584,True,4,41342
42123,297077768,297083521,True,1,5753
42124,297091268,297091374,True,1,106
42125,297116473,297119032,True,1,2559
42126,297119431,297119642,True,3,211
42127,297121961,297127694,True,1,5733
42128,297125043,297128748,True,5,3705
42129,297125043,297132137,True,1,7094
42130,297137505,297140504,False,1,2999
42131,297137505,297140504,True,1,2999
42132,297166204,297166300,True,1,96
42133,297169214,297169880,True,1,666
42134,297186233,297200342,False,1,14109
42135,297204360,297204726,True,1,366
42136,297204360,297256016,True,1,51656
42137,297205345,297256437,True,1,51092
42138,297219028,297220033,False,1,1005
42139,297230869,297234608,True,1,3739
42140,297231070,297232868,False,1,1798
42141,297235230,297236648,False,1,1418
42142,297245355,297246080,True,1,725
42143,297245406,297246080,True,2,674
42144,297252495,297252977,True,1,482
42145,297302947,297330470,True,3,27523
42146,297307058,297397328,True,2,90270
42147,297328087,297374996,True,1,46909
42148,297328208,297328282,True,1,74
42149,297349130,297349305,False,1,175
42150,297349130,297349966,True,1,836
42151,297358130,297359431,True,3,1301
42152,297371110,297375686,True,1,4576
42153,297381232,297383678,True,7,2446
42154,297390679,297390914,True,1,235
42155,297391791,297392536,True,1,745
42156,297401454,297402384,True,1,930
42157,297418628,297421121,True,4,2493
42158,297450155,297452809,True,2,2654
42159,297475288,297479767,True,1,4479
42160,297475368,297479831,True,2,4463
42161,297479038,297479139,True,1,101
42162,297479470,297481249,True,1,1779
42163,297484208,297485399,True,1,1191
42164,297485388,297487118,True,1,1730
42165,297497053,297497889,True,1,836
42166,297498062,297500606,True,2,2544
42167,297500146,297502690,True,1,2544
42168,297507992,297510126,True,1,2134
42169,297536297,297538208,True,3,1911
42170,297539856,297540398,True,1,542
42171,297539856,297540470,True,1,614
42172,297557194,297557794,True,1,600
42173,297573080,297586481,False,1,13401
42174,297573080,297587481,False,1,14401
42175,297574245,297576248,False,1,2003
42176,297587506,297588485,True,1,979
42177,297602535,297609104,True,1,6569
42178,297606071,297630775,True,1,24704
42179,297608383,297621404,False,1,13021
42180,297647254,297649420,True,1,2166
42181,297659912,297665357,True,1,5445
42182,297689417,297695594,True,1,6177
42183,297691112,297693801,True,1,2689
42184,297692049,297694135,True,1,2086
42185,297695097,297705159,True,1,10062
42186,297695097,297706172,True,1,11075
42187,297695664,297705213,True,1,9549
42188,297701300,297701924,True,1,624
42189,297712628,297712854,False,1,226
42190,297712628,297713464,True,1,836
42191,297727250,297731009,True,1,3759
42192,297735244,297743854,True,1,8610
42193,297751879,297760457,True,1,8578
42194,297751879,297760464,True,3,8585
42195,297751879,297760500,True,2,8621
42196,297752129,297752327,False,1,198
42197,297755898,297757765,False,1,1867
42198,297756652,297758372,False,1,1720
42199,297760858,297763927,False,1,3069
42200,297781806,297784312,True,1,2506
42201,297781806,297784324,True,2,2518
42202,297785422,297787999,True,2,2577
42203,297791268,297799210,True,2,7942
42204,297791337,297791771,True,1,434
42205,297808371,297809689,True,1,1318
42206,297856670,297861069,False,2,4399
42207,297860981,297863188,False,1,2207
42208,297873634,297883989,True,1,10355
42209,297888961,297912438,True,1,23477
42210,297918709,297922685,False,1,3976
42211,297918709,297922685,True,1,3976
42212,297922321,297938454,True,1,16133
42213,297964958,297967025,False,1,2067
42214,297964958,297967025,True,1,2067
42215,298002564,298035167,False,1,32603
42216,298002564,298035167,True,2,32603
42217,298015358,298015626,False,1,268
42218,298020025,298021783,True,1,1758
42219,298020025,298022534,True,1,2509
42220,298020025,298022785,True,1,2760
42221,298075563,298076325,True,2,762
42222,298137083,298276390,True,1,139307
42223,298174471,298176276,True,1,1805
42224,298176463,298180037,True,1,3574
42225,298196021,298198527,True,1,2506
42226,298201399,298202252,True,1,853
42227,298211348,298212008,False,1,660
42228,298213769,298215640,False,2,1871
42229,298219797,298309808,True,3,90011
42230,298229415,298230372,False,1,957
42231,298231981,298232110,False,1,129
42232,298258476,298262117,True,1,3641
42233,298303204,298351496,True,1,48292
42234,298342454,298343894,True,1,1440
42235,298342457,298343894,True,1,1437
42236,298385205,298385975,True,1,770
42237,298394667,298397320,True,2,2653
42238,298432211,298435920,False,1,3709
42239,298461488,298462253,False,1,765
42240,298473797,298478819,True,4,5022
42241,298478052,298480198,True,2,2146
42242,298482677,298484282,True,1,1605
42243,298486203,298489637,True,1,3434
42244,298489111,298490526,False,1,1415
42245,298490709,298492201,False,2,1492
42246,298552685,298555508,False,1,2823
42247,298576346,298578652,False,1,2306
42248,298680841,298697488,True,1,16647
42249,298738667,298739061,False,2,394
42250,298741403,298745542,False,1,4139
42251,298748677,298752174,True,1,3497
42252,298748677,298752720,True,1,4043
42253,298749915,298750231,False,1,316
42254,298752491,298753159,False,1,668
42255,298760910,298764580,True,1,3670
42256,298805298,298850340,True,1,45042
42257,298824258,298828736,False,1,4478
42258,298824587,298828769,True,1,4182
42259,298834316,298835022,False,1,706
42260,298841804,298842565,True,1,761
42261,298866640,298866736,False,1,96
42262,298866640,298866736,True,3,96
42263,298900152,298906855,True,1,6703
42264,298913464,298914139,True,1,675
42265,298915761,298924719,True,1,8958
42266,298923037,298927447,True,1,4410
42267,298924780,298927629,True,1,2849
42268,298946310,298946563,True,1,253
42269,298947051,298949302,True,1,2251
42270,298958289,298963831,True,2,5542
42271,298988910,298990580,True,2,1670
42272,298994382,299004706,True,1,10324
42273,299024817,299025463,True,1,646
42274,299038236,299038549,False,1,313
42275,299038236,299039389,False,1,1153
42276,299038236,299039761,False,1,1525
42277,299038522,299041599,False,1,3077
42278,299059801,299060917,True,1,1116
42279,299061614,299062184,True,1,570
42280,299061614,299094270,True,1,32656
42281,299063347,299145268,True,1,81921
42282,299071232,299077220,True,1,5988
42283,299078281,299078818,False,1,537
42284,299079670,299238910,True,1,159240
42285,299093227,299108672,True,1,15445
42286,299131729,299132111,False,1,382
42287,299131729,299133511,False,1,1782
42288,299139442,299143808,True,1,4366
42289,299141314,299142741,False,2,1427
42290,299141314,299142741,True,3,1427
42291,299152961,299153867,False,1,906
42292,299152961,299192024,False,2,39063
42293,299152961,299246468,False,2,93507
42294,299152961,299248031,False,1,95070
42295,299179756,299203073,True,1,23317
42296,299201329,299201603,True,2,274
42297,299227597,299244755,True,1,17158
42298,299227597,299251734,True,1,24137
42299,299236162,299237116,True,1,954
42300,299254826,299259762,False,2,4936
42301,299260623,299261561,True,1,938
42302,299266103,299312495,True,1,46392
42303,299277778,299309558,True,1,31780
42304,299278213,299330105,True,1,51892
42305,299278960,299296128,True,1,17168
42306,299278960,299303254,True,1,24294
42307,299327789,299354863,False,1,27074
42308,299354083,299357532,True,1,3449
42309,299365833,299366664,True,1,831
42310,299366741,299368833,True,1,2092
42311,299367063,299368833,True,1,1770
42312,299474060,299476932,False,1,2872
42313,299474158,299498111,False,1,23953
42314,299474158,299498111,True,4,23953
42315,299474618,299477918,True,6,3300
42316,299508579,299508973,True,1,394
42317,299509060,299537744,True,1,28684
42318,299510018,299510183,True,1,165
42319,299511315,299515422,False,1,4107
42320,299530663,299548520,True,1,17857
42321,299541380,299542515,True,1,1135
42322,299555812,299560741,True,1,4929
42323,299563012,299563323,True,3,311
42324,299608887,299610764,False,1,1877
42325,299608919,299609940,False,1,1021
42326,299609661,299609930,False,1,269
42327,299647707,299648961,True,3,1254
42328,299652470,299658919,True,1,6449
42329,299661996,299662265,False,1,269
42330,299661996,299663017,False,1,1021
42331,299670939,299673302,True,1,2363
42332,299674877,299678485,True,1,3608
42333,299713486,299713682,True,1,196
42334,299722976,299729100,True,1,6124
42335,299724017,299729534,False,1,5517
42336,299724017,299729534,True,3,5517
42337,299742379,299742715,True,1,336
42338,299751620,299752301,True,2,681
42339,299754614,299755223,True,1,609
42340,299754880,299777767,True,1,22887
42341,299774268,299782781,False,1,8513
42342,299775197,299780946,True,1,5749
42343,299775197,299787483,True,1,12286
42344,299775461,299788101,True,1,12640
42345,299790295,299882375,True,2,92080
42346,299790829,299790939,True,1,110
42347,299795371,299795703,True,1,332
42348,299801335,299801587,True,1,252
42349,299801751,299802055,True,1,304
42350,299801758,299807793,True,1,6035
42351,299805113,299806090,True,1,977
42352,299805540,299805833,True,1,293
42353,299814443,299815236,False,1,793
42354,299829195,299831381,True,1,2186
42355,299832380,299834207,True,2,1827
42356,299832380,299834651,True,1,2271
42357,299837408,299837989,True,1,581
42358,299868145,299909650,True,1,41505
42359,299869140,299870566,True,1,1426
42360,299872382,299873583,False,1,1201
42361,299872382,299873583,True,5,1201
42362,299888958,299890335,True,2,1377
42363,299961391,299978304,True,1,16913
42364,299962662,299976682,True,2,14020
42365,299994241,299994428,True,1,187
42366,299994452,299994868,True,1,416
42367,300009782,300020262,True,1,10480
42368,300009942,300020422,True,1,10480
42369,300013618,300029557,True,1,15939
42370,300040622,300047710,True,2,7088
42371,300040944,300043223,True,1,2279
42372,300040944,300054100,True,1,13156
42373,300070934,300071108,True,1,174
42374,300079062,300080084,True,2,1022
42375,300079348,300080006,True,1,658
42376,300079348,300080026,False,1,678
42377,300079348,300080026,True,2,678
42378,300081043,300082903,True,1,1860
42379,300081391,300082903,True,1,1512
42380,300091284,300092147,False,1,863
42381,300093790,300098203,True,1,4413
42382,300095798,300100211,True,1,4413
42383,300099123,300102688,True,1,3565
42384,300130767,300132118,True,1,1351
42385,300131908,300132636,True,2,728
42386,300131908,300134193,True,1,2285
42387,300141794,300142806,True,2,1012
42388,300141922,300163126,True,5,21204
42389,300141922,300165102,True,1,23180
42390,300152886,300161913,True,1,9027
42391,300179232,300183433,True,3,4201
42392,300195849,300205035,False,1,9186
42393,300204781,300207046,False,1,2265
42394,300205831,300207509,False,1,1678
42395,300220494,300220796,False,1,302
42396,300222028,300223905,True,1,1877
42397,300243742,300244866,True,1,1124
42398,300244646,300245269,True,1,623
42399,300255486,300256189,True,1,703
42400,300255882,300267621,False,1,11739
42401,300255882,300267621,True,1,11739
42402,300255882,300301648,True,1,45766
42403,300261658,300270376,False,2,8718
42404,300281732,300287291,True,1,5559
42405,300294305,300304029,True,1,9724
42406,300296224,300311718,True,1,15494
42407,300303611,300305828,True,2,2217
42408,300303956,300305958,True,1,2002
42409,300316041,300332497,True,1,16456
42410,300370151,300424954,False,1,54803
42411,300373214,300480648,True,1,107434
42412,300374264,300481178,False,1,106914
42413,300374264,300481178,True,1,106914
42414,300383779,300386226,True,3,2447
42415,300383779,300389654,False,1,5875
42416,300383782,300386232,True,1,2450
42417,300398066,300401843,True,1,3777
42418,300410150,300414992,True,1,4842
42419,300419403,300420082,False,1,679
42420,300419403,300420082,True,2,679
42421,300420990,300421250,True,1,260
42422,300422538,300428505,False,1,5967
42423,300423977,300428964,True,1,4987
42424,300448595,300448715,False,1,120
42425,300449160,300451523,True,1,2363
42426,300452866,300453353,True,1,487
42427,300460795,300462761,True,1,1966
42428,300476223,300477321,False,1,1098
42429,300476223,300477321,True,1,1098
42430,300476392,300476729,True,2,337
42431,300476854,300477271,True,3,417
42432,300489588,300489972,True,1,384
42433,300490448,300491670,True,2,1222
42434,300509980,300510568,True,1,588
42435,300509980,300510822,True,1,842
42436,300511271,300511441,True,1,170
42437,300511577,300512264,False,1,687
42438,300522064,300523267,False,1,1203
42439,300522064,300523267,True,1,1203
42440,300526428,300529578,True,2,3150
42441,300528982,300531431,True,3,2449
42442,300529190,300534714,True,5,5524
42443,300532586,300533021,True,1,435
42444,300533137,300546748,True,1,13611
42445,300540354,300546315,True,1,5961
42446,300550488,300551575,True,3,1087
42447,300569459,300605295,False,1,35836
42448,300570412,300574883,True,1,4471
42449,300587968,300591278,False,1,3310
42450,300587968,300591278,True,3,3310
42451,300587968,300591341,True,1,3373
42452,300611119,300612853,False,1,1734
42453,300621853,300631775,True,1,9922
42454,300621870,300631796,False,1,9926
42455,300621870,300631796,True,1,9926
42456,300639174,300640354,False,1,1180
42457,300642351,300661235,True,1,18884
42458,300647839,300649607,True,1,1768
42459,300648063,300649607,True,1,1544
42460,300648273,300649607,True,1,1334
42461,300650136,300652161,True,1,2025
42462,300674384,300727059,True,3,52675
42463,300682640,300683304,True,1,664
42464,300690435,300693296,True,2,2861
42465,300702265,300705630,False,1,3365
42466,300755616,300762246,True,2,6630
42467,300765666,300766931,True,1,1265
42468,300767827,300769059,True,1,1232
42469,300771569,300772252,True,1,683
42470,300773342,300773566,True,1,224
42471,300800300,300804897,True,1,4597
42472,300819737,300821349,False,1,1612
42473,300819737,300821349,True,3,1612
42474,300819737,300824064,True,1,4327
42475,300819811,300821349,False,1,1538
42476,300819811,300821349,True,8,1538
42477,300819811,300824064,True,1,4253
42478,300827422,300829772,True,2,2350
42479,300852828,300853743,True,1,915
42480,300869231,300872400,True,1,3169
42481,300886481,300909817,False,1,23336
42482,300919394,300939127,True,1,19733
42483,300919831,300920171,True,6,340
42484,300928821,301000065,True,1,71244
42485,300950468,300952064,False,1,1596
42486,300961241,300962420,False,1,1179
42487,300961241,300962491,True,6,1250
42488,300961334,300963395,True,3,2061
42489,300976770,300978479,False,1,1709
42490,300977086,300977517,True,4,431
42491,300995769,300996475,True,1,706
42492,301043872,301044193,True,2,321
42493,301044668,301046976,True,2,2308
42494,301056262,301075269,True,1,19007
42495,301061045,301061151,True,1,106
42496,301096993,301097744,True,3,751
42497,301096993,301098343,True,1,1350
42498,301099210,301103105,True,2,3895
42499,301123787,301124515,True,4,728
42500,301131489,301137757,True,1,6268
42501,301140663,301350981,False,1,210318
42502,301189933,301192714,True,4,2781
42503,301194037,301194706,True,1,669
42504,301194037,301195625,True,1,1588
42505,301194037,301195694,True,2,1657
42506,301196401,301197989,True,1,1588
42507,301199589,301201409,True,1,1820
42508,301201628,301202268,False,1,640
42509,301203045,301204639,True,1,1594
42510,301239924,301252988,True,2,13064
42511,301265470,301271926,True,2,6456
42512,301278792,301285605,True,1,6813
42513,301284645,301286006,True,3,1361
42514,301288608,301289799,True,1,1191
42515,301290341,301302619,True,1,12278
42516,301290341,301303720,True,2,13379
42517,301294023,301294522,True,2,499
42518,301313147,301316498,True,3,3351
42519,301320766,301321945,False,1,1179
42520,301320766,301323654,False,1,2888
42521,301320766,301350581,True,1,29815
42522,301341744,301343120,True,3,1376
42523,301376531,301378982,True,1,2451
42524,301376531,301380432,True,1,3901
42525,301380372,301400513,False,1,20141
42526,301380372,301400513,True,4,20141
42527,301381344,301470892,False,1,89548
42528,301381889,301383129,True,3,1240
42529,301391187,301396143,False,1,4956
42530,301391187,301396143,True,2,4956
42531,301403221,301406290,True,1,3069
42532,301408292,301422922,True,2,14630
42533,301419792,301420112,False,1,320
42534,301419792,301420112,True,1,320
42535,301436878,301440620,True,1,3742
42536,301451206,301451395,True,1,189
42537,301451206,301453835,True,1,2629
42538,301451206,301455438,True,1,4232
42539,301451206,301456199,True,2,4993
42540,301451206,301456867,True,2,5661
42541,301464317,301502003,True,1,37686
42542,301491884,301492569,True,3,685
42543,301502080,301502195,False,1,115
42544,301502080,301502195,True,2,115
42545,301511573,301514308,True,1,2735
42546,301513505,301515666,True,1,2161
42547,301519383,301520920,True,1,1537
42548,301520014,301521025,True,1,1011
42549,301538057,301540325,True,1,2268
42550,301544351,301544909,True,1,558
42551,301547626,301547705,True,4,79
42552,301548891,301550297,True,1,1406
42553,301556828,301556912,False,1,84
42554,301557158,301557431,True,3,273
42555,301566049,301596831,True,1,30782
42556,301566766,301567826,True,6,1060
42557,301567984,301597703,True,3,29719
42558,301580901,301589412,True,1,8511
42559,301591490,301594686,True,1,3196
42560,301607173,301608033,True,1,860
42561,301608992,301638303,True,2,29311
42562,301609396,301638707,True,2,29311
42563,301624492,301625642,True,1,1150
42564,301633292,301654899,True,1,21607
42565,301654536,301665509,True,2,10973
42566,301663141,301668550,True,1,5409
42567,301675793,301675902,True,1,109
42568,301691904,301709771,True,1,17867
42569,301727476,301730983,True,1,3507
42570,301733915,301734032,True,1,117
42571,301745837,301745981,True,3,144
42572,301769204,301770249,True,1,1045
42573,301769310,301770365,True,2,1055
42574,301781141,301781905,False,1,764
42575,301797753,301798992,True,1,1239
42576,301797807,301798992,True,3,1185
42577,301797976,301799134,True,1,1158
42578,301806632,301810145,True,1,3513
42579,301810115,301816064,True,1,5949
42580,301820852,301821538,True,2,686
42581,301832844,301834312,True,1,1468
42582,301842151,301892860,True,1,50709
42583,301842151,301975716,True,1,133565
42584,301859474,301860744,True,1,1270
42585,301860944,301861716,True,1,772
42586,301862032,301867225,True,2,5193
42587,301871783,301878704,True,1,6921
42588,301872300,301872538,True,3,238
42589,301876249,301876471,True,1,222
42590,301876412,301876598,True,3,186
42591,301877407,301877564,True,1,157
42592,301909353,301909459,True,1,106
42593,301939143,301939398,True,6,255
42594,301962119,301971258,True,4,9139
42595,301994357,301995075,True,1,718
42596,302000025,302023053,False,1,23028
42597,302000025,302023053,True,2,23028
42598,302009787,302059528,True,1,49741
42599,302018270,302018817,True,1,547
42600,302018270,302019069,True,1,799
42601,302022773,302026701,False,1,3928
42602,302024874,302029728,True,1,4854
42603,302041586,302043170,True,1,1584
42604,302049249,302050151,True,2,902
42605,302063825,302065432,False,1,1607
42606,302065179,302071843,True,1,6664
42607,302077778,302081278,True,3,3500
42608,302083816,302084302,True,2,486
42609,302084404,302096786,True,1,12382
42610,302084985,302088590,False,1,3605
42611,302086489,302103743,True,2,17254
42612,302090890,302091362,True,1,472
42613,302099865,302107122,False,1,7257
42614,302111282,302111573,True,1,291
42615,302112022,302113757,True,2,1735
42616,302113116,302115287,False,1,2171
42617,302131529,302135993,True,1,4464
42618,302147510,302148682,True,1,1172
42619,302157038,302157168,True,4,130
42620,302162009,302172918,True,1,10909
42621,302162801,302173283,True,1,10482
42622,302169500,302176631,True,1,7131
42623,302170870,302177319,True,2,6449
42624,302173587,302178682,True,1,5095
42625,302210155,302210596,True,2,441
42626,302210155,302211037,True,1,882
42627,302212789,302214633,True,1,1844
42628,302212789,302215075,True,1,2286
42629,302218882,302219517,False,1,635
42630,302244902,302248220,True,1,3318
42631,302245151,302245433,False,1,282
42632,302245151,302245433,True,1,282
42633,302249187,302250341,False,1,1154
42634,302254321,302260319,False,1,5998
42635,302254321,302260319,True,1,5998
42636,302254321,302261978,True,1,7657
42637,302258302,302260244,True,1,1942
42638,302258302,302268049,True,1,9747
42639,302258635,302262528,False,1,3893
42640,302265719,302266433,True,2,714
42641,302277176,302277442,False,1,266
42642,302277176,302277442,True,2,266
42643,302277225,302277442,True,1,217
42644,302285041,302285455,False,1,414
42645,302285041,302285455,True,3,414
42646,302298148,302299385,True,1,1237
42647,302298282,302299250,True,1,968
42648,302298315,302299250,True,1,935
42649,302299686,302300226,True,1,540
42650,302300448,302306618,True,1,6170
42651,302303072,302317606,True,4,14534
42652,302303072,302317637,True,1,14565
42653,302310162,302312138,True,1,1976
42654,302310162,302312291,True,1,2129
42655,302310162,302314547,True,1,4385
42656,302327394,302330752,True,1,3358
42657,302342577,302367739,True,3,25162
42658,302342577,302367742,True,2,25165
42659,302350175,302351825,True,1,1650
42660,302372774,302384813,True,6,12039
42661,302373999,302384038,False,1,10039
42662,302373999,302384038,True,3,10039
42663,302374991,302384692,True,1,9701
42664,302376348,302384854,True,1,8506
42665,302393688,302395146,True,1,1458
42666,302404597,302410553,True,2,5956
42667,302404621,302410553,True,1,5932
42668,302413644,302415704,True,1,2060
42669,302454480,302461831,True,1,7351
42670,302505233,302506516,False,1,1283
42671,302507518,302510808,True,4,3290
42672,302508648,302512842,True,1,4194
42673,302509661,302512470,True,1,2809
42674,302509661,302513539,True,1,3878
42675,302510912,302514371,True,1,3459
42676,302519632,302519752,True,1,120
42677,302529781,302530764,True,5,983
42678,302531707,302533034,False,1,1327
42679,302566597,302566671,True,2,74
42680,302605939,302606013,True,3,74
42681,302628769,302628931,True,3,162
42682,302651458,302652845,True,2,1387
42683,302652326,302657178,True,1,4852
42684,302658355,302659664,False,1,1309
42685,302672668,302693833,True,1,21165
42686,302673958,302674177,True,4,219
42687,302694674,302889689,False,1,195015
42688,302744243,302744495,True,2,252
42689,302744747,302850260,True,1,105513
42690,302754139,302754280,True,7,141
42691,302799195,302799275,True,1,80
42692,302903664,302910135,True,1,6471
42693,302903664,302913582,True,1,9918
42694,302967852,302974841,True,1,6989
42695,302976642,302981724,False,1,5082
42696,303000747,303000994,True,1,247
42697,303007941,303008275,True,1,334
42698,303025682,303046972,True,1,21290
42699,303025682,303047345,True,1,21663
42700,303025682,303047839,True,1,22157
42701,303025682,303047847,True,1,22165
42702,303036306,303036459,False,1,153
42703,303063948,303067012,True,1,3064
42704,303122327,303122650,True,1,323
42705,303123367,303188388,True,1,65021
42706,303148351,303149046,False,1,695
42707,303169397,303195902,True,1,26505
42708,303169649,303196023,True,1,26374
42709,303182924,303189068,True,1,6144
42710,303222926,303242040,True,1,19114
42711,303222958,303242072,True,1,19114
42712,303293685,303316509,True,1,22824
42713,303293685,303323525,False,1,29840
42714,303307157,303308329,True,1,1172
42715,303307157,303317754,True,2,10597
42716,303325741,303332664,True,1,6923
42717,303328870,303332320,False,2,3450
42718,303348457,303350038,True,6,1581
42719,303360106,303360248,True,1,142
42720,303363026,303363167,True,1,141
42721,303366758,303367220,False,1,462
42722,303373276,303379847,True,1,6571
42723,303388108,303388572,True,1,464
42724,303445746,303514050,True,1,68304
42725,303445746,303520658,True,1,74912
42726,303452298,303452749,True,3,451
42727,303464779,303465412,False,1,633
42728,303464779,303465412,True,1,633
42729,303469244,303469732,True,1,488
42730,303470327,303470506,True,1,179
42731,303471087,303475081,True,1,3994
42732,303478494,303478767,True,1,273
42733,303485620,303489469,True,1,3849
42734,303488502,303490927,True,1,2425
42735,303492934,303493138,True,4,204
42736,303493277,303493461,True,1,184
42737,303515058,303523810,True,1,8752
42738,303515243,303523995,True,1,8752
42739,303527038,303529606,False,1,2568
42740,303542870,303543475,True,1,605
42741,303543163,303546119,True,1,2956
42742,303544335,303548440,True,1,4105
42743,303547142,303549102,True,1,1960
42744,303547142,303552882,True,1,5740
42745,303547957,303550468,True,1,2511
42746,303558655,303562345,True,4,3690
42747,303582268,303582373,False,1,105
42748,303609706,303611945,True,1,2239
42749,303613441,303615473,True,1,2032
42750,303622034,303623015,True,1,981
42751,303622157,303622444,False,1,287
42752,303628504,303631747,True,1,3243
42753,303630494,303672625,True,1,42131
42754,303639466,303639788,True,1,322
42755,303666018,303667888,True,3,1870
42756,303667998,303668278,True,1,280
42757,303690746,303692817,False,1,2071
42758,303690746,303692817,True,1,2071
42759,303734551,303736278,True,1,1727
42760,303734551,303736342,True,1,1791
42761,303753864,303754021,False,1,157
42762,303753864,303754021,True,1,157
42763,303753864,303754057,False,1,193
42764,303753864,303754072,False,1,208
42765,303753864,303754072,True,1,208
42766,303766289,303766452,True,1,163
42767,303766289,303766684,True,1,395
42768,303766289,303767562,True,2,1273
42769,303766289,303768647,True,1,2358
42770,303766464,303767562,True,1,1098
42771,303792326,303792535,False,1,209
42772,303800167,303800999,True,2,832
42773,303800167,303802394,True,1,2227
42774,303806522,303806952,True,2,430
42775,303806522,303807684,False,1,1162
42776,303806522,303807684,True,1,1162
42777,303838339,303838418,True,5,79
42778,303844949,303846121,False,1,1172
42779,303847416,303851099,False,2,3683
42780,303855882,303856090,True,1,208
42781,303855933,303856090,True,1,157
42782,303869993,303870332,True,1,339
42783,303869993,303870603,True,1,610
42784,303870882,303870961,True,1,79
42785,303911185,303913958,True,1,2773
42786,303934088,303938188,False,1,4100
42787,303955727,303960662,True,1,4935
42788,303955727,303965352,False,1,9625
42789,303955727,303965352,True,1,9625
42790,303955727,304000837,False,1,45110
42791,303955727,304000837,True,1,45110
42792,303955727,304106805,True,1,151078
42793,303955727,304141559,False,1,185832
42794,303967265,303967619,False,1,354
42795,303967265,303967630,True,1,365
42796,303972709,304003020,True,2,30311
42797,303972709,304038726,True,1,66017
42798,303992344,303992949,True,1,605
42799,303998866,304001313,False,1,2447
42800,303998866,304062743,False,1,63877
42801,303999171,303999686,True,1,515
42802,303999171,304014334,True,1,15163
42803,304010280,304011103,True,1,823
42804,304023429,304034638,False,1,11209
42805,304023429,304034638,True,2,11209
42806,304033813,304033962,False,1,149
42807,304035349,304149921,True,5,114572
42808,304041590,304042359,True,3,769
42809,304084791,304090200,True,5,5409
42810,304116638,304117099,True,1,461
42811,304164346,304165209,True,2,863
42812,304166052,304166237,True,6,185
42813,304173106,304173933,True,1,827
42814,304175151,304176396,True,1,1245
42815,304177826,304178123,True,1,297
42816,304212905,304213994,True,1,1089
42817,304220588,304224023,True,1,3435
42818,304253762,304255783,True,3,2021
42819,304254370,304255119,True,1,749
42820,304255506,304256296,True,1,790
42821,304257097,304257429,True,1,332
42822,304258312,304292543,True,1,34231
42823,304258312,304330601,True,1,72289
42824,304258312,304510937,True,1,252625
42825,304264445,304267407,True,1,2962
42826,304265629,304283233,True,1,17604
42827,304268092,304273357,False,1,5265
42828,304269272,304273148,True,1,3876
42829,304317632,304317811,True,3,179
42830,304317632,304317825,True,1,193
42831,304327653,304365519,False,3,37866
42832,304327653,304365519,True,2,37866
42833,304327653,304579249,True,1,251596
42834,304327771,304579423,True,1,251652
42835,304378517,304380141,True,1,1624
42836,304390254,304423648,False,1,33394
42837,304396700,304399270,True,1,2570
42838,304396700,304402591,True,1,5891
42839,304403695,304467095,True,1,63400
42840,304428379,304434560,True,1,6181
42841,304449760,304450070,True,1,310
42842,304454183,304454697,False,1,514
42843,304481715,304482042,True,1,327
42844,304489474,304489801,True,1,327
42845,304530950,304598096,True,1,67146
42846,304530950,304647431,True,1,116481
42847,304532852,304533325,False,1,473
42848,304532852,304533325,True,1,473
42849,304532943,304533322,True,2,379
42850,304532943,304534168,True,1,1225
42851,304533644,304534375,True,1,731
42852,304561873,304562443,True,1,570
42853,304572448,304573032,False,1,584
42854,304642031,304643909,False,1,1878
42855,304651335,304652433,True,1,1098
42856,304661014,304706248,True,1,45234
42857,304684299,304688335,True,11,4036
42858,304690034,304701370,True,1,11336
42859,304708677,304711714,True,1,3037
42860,304765137,304766288,True,1,1151
42861,304886629,304894671,True,3,8042
42862,304886629,304896073,True,3,9444
42863,304913844,304937103,True,3,23259
42864,304913844,304954447,True,1,40603
42865,304964596,304964670,True,1,74
42866,304966793,304967307,True,1,514
42867,304974005,304974813,True,1,808
42868,305076879,305077386,True,1,507
42869,305093070,305094107,True,1,1037
42870,305104292,305104802,True,1,510
42871,305184262,305185567,False,1,1305
42872,305184262,305185720,True,1,1458
42873,305198051,305201576,True,1,3525
42874,305199355,305201702,True,1,2347
42875,305221312,305222508,True,1,1196
42876,305222056,305223252,True,1,1196
42877,305249377,305250665,True,1,1288
42878,305261854,305262231,True,2,377
42879,305271791,305272445,True,1,654
42880,305274477,305275570,True,4,1093
42881,305291352,305291855,False,1,503
42882,305295594,305296259,True,1,665
42883,305314564,305316786,True,1,2222
42884,305317230,305317896,True,1,666
42885,305317317,305320812,True,3,3495
42886,305341709,305342195,True,1,486
42887,305367593,305367909,True,1,316
42888,305376648,305378236,True,1,1588
42889,305385178,305387700,True,3,2522
42890,305385178,305399245,True,1,14067
42891,305395246,305399338,True,1,4092
42892,305421099,305421232,True,1,133
42893,305421099,305421642,True,1,543
42894,305421099,305423381,False,2,2282
42895,305421130,305421642,True,1,512
42896,305426489,305432972,False,1,6483
42897,305426489,305432972,True,1,6483
42898,305426572,305433055,True,1,6483
42899,305434558,305444267,True,1,9709
42900,305443544,305443671,False,1,127
42901,305449425,305449654,True,1,229
42902,305461040,305462540,True,1,1500
42903,305497689,305498076,True,1,387
42904,305513761,305518788,True,1,5027
42905,305517535,305518504,True,1,969
42906,305520917,305530423,True,1,9506
42907,305538473,305539473,True,1,1000
42908,305549405,305551109,True,2,1704
42909,305555130,305555219,True,1,89
42910,305555284,305556385,True,1,1101
42911,305567689,305568150,True,1,461
42912,305598815,305603268,True,1,4453
42913,305603492,305608394,True,2,4902
42914,305630816,305631303,True,1,487
42915,305652478,305653724,True,1,1246
42916,305655292,305657969,True,1,2677
42917,305701719,305707674,True,1,5955
42918,305707234,305711344,True,1,4110
42919,305707294,305711344,True,1,4050
42920,305738571,305742660,True,1,4089
42921,305740613,305743569,True,4,2956
42922,305740613,305896569,False,1,155956
42923,305741748,305744342,True,1,2594
42924,305743601,305745217,True,2,1616
42925,305754550,305765288,False,1,10738
42926,305762103,305763291,True,1,1188
42927,305815961,305821267,True,1,5306
42928,305825535,305826027,True,1,492
42929,305870772,305871090,True,3,318
42930,305873691,305873897,True,2,206
42931,305874187,305874551,True,1,364
42932,305886297,305887472,True,1,1175
42933,305908042,305909579,True,2,1537
42934,305910019,305910793,True,1,774
42935,305911774,305912570,True,1,796
42936,305913164,305914235,True,1,1071
42937,305913164,305914249,True,1,1085
42938,305916309,305916395,False,1,86
42939,305932376,305933406,True,4,1030
42940,305948491,305949299,True,1,808
42941,305948491,305949698,True,2,1207
42942,305950630,305953592,True,1,2962
42943,305965410,305971143,True,1,5733
42944,305977077,305978080,True,1,1003
42945,305981943,305985007,True,1,3064
42946,306007401,306008479,True,1,1078
42947,306025041,306025752,True,1,711
42948,306038262,306061904,True,1,23642
42949,306044339,306044603,False,1,264
42950,306057825,306058540,True,1,715
42951,306057825,306142496,False,1,84671
42952,306059409,306060574,True,5,1165
42953,306079900,306080033,False,1,133
42954,306083724,306084150,True,1,426
42955,306086048,306086756,True,1,708
42956,306093055,306093124,True,3,69
42957,306093055,306093191,True,1,136
42958,306102648,306102885,True,1,237
42959,306102686,306102887,True,1,201
42960,306102947,306103028,True,1,81
42961,306103125,306103475,True,1,350
42962,306119418,306119756,True,1,338
42963,306119943,306120030,False,1,87
42964,306119943,306120030,True,1,87
42965,306120227,306121905,True,1,1678
42966,306131856,306132568,True,1,712
42967,306137977,306138172,True,5,195
42968,306144025,306145232,True,3,1207
42969,306169840,306170560,True,1,720
42970,306205901,306206377,False,1,476
42971,306225797,306226494,False,1,697
42972,306244664,306245383,True,1,719
42973,306255317,306255789,True,2,472
42974,306255317,306255898,True,2,581
42975,306267622,306267723,True,1,101
42976,306272659,306272754,True,1,95
42977,306336330,306338410,True,1,2080
42978,306341051,306341411,True,2,360
42979,306346245,306347351,False,1,1106
42980,306346245,306347351,True,3,1106
42981,306351912,306353066,True,1,1154
42982,306380154,306380658,True,1,504
42983,306383984,306570205,True,1,186221
42984,306390955,306391493,True,3,538
42985,306394623,306394729,True,1,106
42986,306401578,306401661,True,1,83
42987,306404760,306406085,True,1,1325
42988,306414036,306415235,True,1,1199
42989,306427844,306428009,True,1,165
42990,306464387,306465579,True,1,1192
42991,306476301,306485289,True,1,8988
42992,306486710,306487743,True,6,1033
42993,306540947,306541924,True,1,977
42994,306553324,306553934,True,3,610
42995,306559221,306560973,True,1,1752
42996,306584164,306584919,True,2,755
42997,306584206,306585062,True,2,856
42998,306606017,306612251,True,2,6234
42999,306619629,306620717,True,3,1088
43000,306619629,306622389,True,2,2760
43001,306660686,306661072,True,1,386
43002,306664928,306677426,True,1,12498
43003,306665335,306665941,True,1,606
43004,306665478,306666084,True,3,606
43005,306665478,306788545,True,1,123067
43006,306665478,306788731,True,1,123253
43007,306692626,306693112,True,1,486
43008,306725226,306725376,True,1,150
43009,306743938,306745745,True,5,1807
43010,306778038,306779539,True,1,1501
43011,306819168,306820133,True,1,965
43012,306819593,306825850,True,1,6257
43013,306837089,306847633,True,1,10544
43014,306837089,306850996,True,1,13907
43015,306837386,306847633,True,1,10247
43016,306850020,306850638,True,1,618
43017,306860665,306861566,True,1,901
43018,306896362,306901341,True,1,4979
43019,306924280,306924898,True,1,618
43020,306952254,306955071,True,1,2817
43021,306952254,306957972,True,1,5718
43022,306970598,306975577,True,1,4979
43023,306998365,306998983,True,2,618
43024,307014381,307014751,True,1,370
43025,307019534,307022150,True,1,2616
43026,307021018,307022507,True,2,1489
43027,307028936,307029862,True,1,926
43028,307032493,307033222,True,2,729
43029,307032796,307034118,True,1,1322
43030,307036614,307039124,False,1,2510
43031,307040130,307040627,True,1,497
43032,307048372,307057680,True,2,9308
43033,307048372,307057698,True,1,9326
43034,307058109,307058462,True,2,353
43035,307066211,307066881,True,1,670
43036,307067181,307071103,True,1,3922
43037,307067651,307069792,True,1,2141
43038,307096978,307109343,True,1,12365
43039,307140879,307244668,False,1,103789
43040,307140879,307244668,True,2,103789
43041,307148915,307151451,False,1,2536
43042,307149944,307151451,True,1,1507
43043,307153648,307168054,True,1,14406
43044,307154303,307154627,True,3,324
43045,307159534,307159839,False,1,305
43046,307159534,307159839,True,1,305
43047,307169237,307727715,True,1,558478
43048,307174229,307174440,True,1,211
43049,307182789,307190069,True,6,7280
43050,307201844,307203855,False,1,2011
43051,307201844,307203855,True,1,2011
43052,307213276,307215503,True,5,2227
43053,307215522,307215644,True,1,122
43054,307219971,307223767,True,1,3796
43055,307253305,307253406,True,3,101
43056,307253600,307254394,True,1,794
43057,307255415,307255504,False,1,89
43058,307256425,307256946,True,1,521
43059,307260760,307260859,True,5,99
43060,307262477,307263051,False,1,574
43061,307262491,307262741,True,1,250
43062,307262491,307263051,False,1,560
43063,307269295,307269442,True,2,147
43064,307275872,307277697,True,1,1825
43065,307280165,307280297,False,1,132
43066,307280165,307280297,True,4,132
43067,307280523,307280601,True,1,78
43068,307280523,307281722,True,1,1199
43069,307303468,307304138,True,1,670
43070,307305695,307309199,False,1,3504
43071,307305805,307306283,True,1,478
43072,307314176,307314369,False,1,193
43073,307314176,307314369,True,1,193
43074,307314710,307317364,True,1,2654
43075,307314999,307315719,True,1,720
43076,307330903,307332125,True,2,1222
43077,307341030,307341147,True,1,117
43078,307345165,307346451,True,1,1286
43079,307355139,307386630,True,1,31491
43080,307373390,307375117,True,1,1727
43081,307383199,307391137,True,1,7938
43082,307401235,307401575,True,1,340
43083,307401826,307413691,True,3,11865
43084,307402354,307451886,True,3,49532
43085,307402489,307451886,True,2,49397
43086,307411637,307411860,True,1,223
43087,307426043,307426163,True,1,120
43088,307432484,307432570,True,1,86
43089,307433070,307434293,True,2,1223
43090,307447044,307448082,True,1,1038
43091,307447285,307448323,True,1,1038
43092,307460286,307464091,True,1,3805
43093,307468563,307468858,True,5,295
43094,307479253,307480317,True,2,1064
43095,307486620,307490253,False,1,3633
43096,307496407,307496759,False,1,352
43097,307496407,307496759,True,1,352
43098,307499924,307893073,True,2,393149
43099,307505679,307507185,False,1,1506
43100,307519910,307520006,True,2,96
43101,307541125,307550659,True,1,9534
43102,307541902,307592248,False,1,50346
43103,307551521,307555762,True,3,4241
43104,307552365,307556262,True,1,3897
43105,307559988,307561407,True,1,1419
43106,307560606,307564580,True,2,3974
43107,307560606,307571225,True,1,10619
43108,307627156,307627826,True,1,670
43109,307651881,307656165,False,1,4284
43110,307651881,307656165,True,1,4284
43111,307651881,307658476,True,1,6595
43112,307651881,307658491,True,1,6610
43113,307677815,307678520,True,1,705
43114,307678456,307678877,True,2,421
43115,307692019,307692257,True,1,238
43116,307710001,307711555,True,1,1554
43117,307712269,307713466,False,1,1197
43118,307728841,307738783,True,1,9942
43119,307736644,307736941,True,1,297
43120,307760786,307761014,True,1,228
43121,307761150,307761764,True,1,614
43122,307804894,307804989,True,1,95
43123,307810097,307811933,True,3,1836
43124,307810097,307827716,True,1,17619
43125,307840952,307841079,False,1,127
43126,307840952,307841079,True,2,127
43127,307864804,307866268,True,6,1464
43128,307864804,307866577,True,1,1773
43129,307880954,307881310,True,4,356
43130,307880974,307881310,True,1,336
43131,307881460,307881670,True,3,210
43132,307887372,307901730,True,1,14358
43133,307894055,307895044,True,1,989
43134,307908744,307908957,True,3,213
43135,307910186,307911324,True,1,1138
43136,307926516,307926827,True,1,311
43137,307930578,307930656,True,3,78
43138,307982286,307984202,True,2,1916
43139,307987601,307987990,True,3,389
43140,308004982,308145643,True,3,140661
43141,308014586,308016470,True,4,1884
43142,308026376,308027421,True,1,1045
43143,308103679,308109430,True,1,5751
43144,308111520,308194286,True,1,82766
43145,308130090,308152768,True,2,22678
43146,308148691,308265757,True,1,117066
43147,308185151,308262344,True,1,77193
43148,308248858,308256530,True,1,7672
43149,308251309,308317082,True,1,65773
43150,308257976,308269558,True,1,11582
43151,308257976,308270653,True,8,12677
43152,308259303,308270653,True,2,11350
43153,308270144,308270573,True,1,429
43154,308270887,308305017,True,1,34130
43155,308273612,308306645,True,1,33033
43156,308274704,308276067,True,1,1363
43157,308319651,308323393,False,1,3742
43158,308343565,308344494,True,1,929
43159,308357313,308370039,True,1,12726
43160,308359306,308363976,True,3,4670
43161,308359306,308364114,True,1,4808
43162,308368790,308368868,True,1,78
43163,308385374,308390212,True,1,4838
43164,308386775,308390882,True,3,4107
43165,308386959,308391001,True,1,4042
43166,308387685,308391371,True,1,3686
43167,308398083,308398869,True,2,786
43168,308402291,308408155,True,1,5864
43169,308442633,308446456,True,1,3823
43170,308455429,308455784,True,1,355
43171,308459272,308459358,True,1,86
43172,308475893,308476005,True,1,112
43173,308475893,308488027,True,1,12134
43174,308476179,308476273,True,1,94
43175,308476426,308480863,True,1,4437
43176,308476426,308482848,True,3,6422
43177,308476526,308480963,True,1,4437
43178,308476574,308480963,True,2,4389
43179,308490290,308490848,True,3,558
43180,308490290,308490992,True,1,702
43181,308510409,308516739,True,1,6330
43182,308531692,308537014,False,1,5322
43183,308531692,308537014,True,2,5322
43184,308534912,308535854,True,2,942
43185,308580165,308582138,True,1,1973
43186,308585982,308586067,True,1,85
43187,308587327,308587998,True,1,671
43188,308596213,308598614,True,1,2401
43189,308599619,308600294,True,4,675
43190,308600612,308600854,True,1,242
43191,308602825,308604144,True,1,1319
43192,308641330,308641407,True,2,77
43193,308663329,308742594,True,1,79265
43194,308663783,308691924,True,1,28141
43195,308663783,308692174,True,1,28391
43196,308663783,308742589,True,1,78806
43197,308721411,308771401,True,10,49990
43198,308721411,308800258,True,1,78847
43199,308721514,308771504,False,3,49990
43200,308721514,308772630,False,1,51116
43201,308755858,308779338,True,3,23480
43202,308775170,308775858,True,2,688
43203,308816580,308818600,True,1,2020
43204,308822209,308822981,True,1,772
43205,308889552,308893158,True,1,3606
43206,308889552,308893162,True,1,3610
43207,308908764,308910370,False,1,1606
43208,308908764,308910370,True,1,1606
43209,308950199,308954045,True,2,3846
43210,308954000,308955054,True,1,1054
43211,308956792,308964670,True,5,7878
43212,308978039,308980882,True,1,2843
43213,308987753,309008296,True,1,20543
43214,309012060,309012585,True,1,525
43215,309012852,309013935,True,1,1083
43216,309017056,309017686,True,1,630
43217,309041975,309054703,True,2,12728
43218,309043995,309044462,True,1,467
43219,309080840,309082192,True,1,1352
43220,309112052,309112224,True,5,172
43221,309148618,309151994,True,1,3376
43222,309149403,309149538,False,1,135
43223,309149403,309149538,True,1,135
43224,309154129,309157621,False,1,3492
43225,309210952,309214492,False,2,3540
43226,309210952,309214507,True,2,3555
43227,309210952,309214526,False,1,3574
43228,309218252,309233095,True,1,14843
43229,309262952,309264936,True,1,1984
43230,309271048,309275568,True,1,4520
43231,309350689,309355879,True,4,5190
43232,309392710,309400398,False,1,7688
43233,309395981,309414188,True,1,18207
43234,309404648,309408755,True,1,4107
43235,309439999,309440688,True,1,689
43236,309440703,309440890,False,2,187
43237,309444556,309458752,True,1,14196
43238,309454218,309457907,True,1,3689
43239,309457241,309485872,True,1,28631
43240,309471271,309473472,True,1,2201
43241,309471732,309473931,True,1,2199
43242,309476209,309476294,True,2,85
43243,309484025,309543857,True,1,59832
43244,309488858,309538552,True,1,49694
43245,309518649,309519140,True,1,491
43246,309594980,309599380,True,2,4400
43247,309595494,309599649,True,1,4155
43248,309596036,309599897,True,1,3861
43249,309596333,309600023,True,1,3690
43250,309602058,309797754,True,1,195696
43251,309716060,309717757,True,1,1697
43252,309716060,309718003,True,1,1943
43253,309719733,309720762,True,1,1029
43254,309719733,309721520,True,1,1787
43255,309725383,309737896,True,1,12513
43256,309794948,309796035,True,1,1087
43257,309834151,309834604,True,3,453
43258,309847580,309847652,False,1,72
43259,309861823,309862952,True,1,1129
43260,309871180,309872790,True,4,1610
43261,309873031,309873194,True,1,163
43262,309894397,309897578,True,1,3181
43263,309894505,309897578,False,1,3073
43264,309911642,309912085,True,3,443
43265,309912311,309916348,True,2,4037
43266,309918147,309919421,False,1,1274
43267,309921857,309923165,True,1,1308
43268,309932385,309932465,True,1,80
43269,309950250,309950422,True,1,172
43270,309950267,309950422,True,2,155
43271,309950524,309957837,True,1,7313
43272,309950524,309962234,True,1,11710
43273,309975213,309975617,True,1,404
43274,309982238,309986593,False,1,4355
43275,309982238,309986593,True,1,4355
43276,309993867,310089406,True,1,95539
43277,309995248,310000876,True,1,5628
43278,310012611,310012727,True,3,116
43279,310016655,310016747,False,1,92
43280,310035996,310036101,False,1,105
43281,310035996,310036101,True,1,105
43282,310047688,310048752,True,1,1064
43283,310047688,310048841,True,1,1153
43284,310047688,310048862,True,1,1174
43285,310047688,310048892,False,4,1204
43286,310047688,310048892,True,7,1204
43287,310048674,310049312,True,1,638
43288,310072624,310075416,True,3,2792
43289,310072624,310093777,True,1,21153
43290,310102892,310108912,True,2,6020
43291,310109148,310109438,True,1,290
43292,310109148,310109490,True,2,342
43293,310109575,310149632,True,1,40057
43294,310110044,310118068,True,1,8024
43295,310179154,310179452,True,3,298
43296,310200893,310204161,True,2,3268
43297,310204819,310217856,True,1,13037
43298,310216754,310217060,True,3,306
43299,310222053,310230061,True,6,8008
43300,310225087,310225331,True,1,244
43301,310270180,310432414,True,1,162234
43302,310283919,310284148,True,1,229
43303,310288980,310289088,True,1,108
43304,310291132,310291255,False,1,123
43305,310292767,310293337,True,1,570
43306,310292767,310294122,False,2,1355
43307,310292767,310294122,True,2,1355
43308,310292767,310294624,True,1,1857
43309,310292777,310294122,True,1,1345
43310,310294186,310294929,True,1,743
43311,310294193,310294936,True,1,743
43312,310294542,310295089,True,1,547
43313,310294673,310294889,False,1,216
43314,310308373,310335700,True,1,27327
43315,310313837,310315846,True,1,2009
43316,310316984,310317503,False,3,519
43317,310316984,310317503,True,2,519
43318,310316984,310317998,False,7,1014
43319,310316984,310317998,True,56,1014
43320,310316984,310320271,True,1,3287
43321,310319950,310320567,True,1,617
43322,310323754,310324228,True,1,474
43323,310323760,310324261,True,1,501
43324,310331068,310331154,True,5,86
43325,310335389,310335501,False,1,112
43326,310340642,310340927,False,1,285
43327,310349108,310349209,True,1,101
43328,310349780,310362509,False,1,12729
43329,310357612,310358624,True,2,1012
43330,310367879,310367972,True,3,93
43331,310369693,310413523,False,1,43830
43332,310373467,310394953,False,1,21486
43333,310398510,310398806,True,1,296
43334,310398510,310400813,True,2,2303
43335,310407521,310407612,True,1,91
43336,310409129,310409222,True,6,93
43337,310414500,310415054,True,1,554
43338,310434741,310434834,False,1,93
43339,310434741,310434834,True,4,93
43340,310446062,310446187,True,1,125
43341,310451979,310452232,True,2,253
43342,310454697,310458238,True,1,3541
43343,310454697,310458316,True,1,3619
43344,310454697,310459814,True,1,5117
43345,310465849,310466397,True,4,548
43346,310488286,310493048,True,1,4762
43347,310494876,310499417,True,2,4541
43348,310500779,310501310,True,1,531
43349,310502580,310505887,True,1,3307
43350,310504102,310504340,True,1,238
43351,310511824,310512321,False,1,497
43352,310519552,310520628,True,2,1076
43353,310530586,310530681,True,1,95
43354,310557294,310558116,True,1,822
43355,310557294,310558370,True,1,1076
43356,310557294,310558391,True,1,1097
43357,310557294,310560582,True,1,3288
43358,310557571,310558282,True,1,711
43359,310574449,310574707,False,1,258
43360,310581421,310582116,True,2,695
43361,310581736,310584117,True,1,2381
43362,310586726,310594682,True,1,7956
43363,310586887,310587918,True,1,1031
43364,310588062,310588361,True,1,299
43365,310588105,310588361,True,4,256
43366,310588785,310589076,False,1,291
43367,310588785,310589076,True,1,291
43368,310588919,310589076,True,1,157
43369,310589752,310593665,True,1,3913
43370,310612593,310612929,True,2,336
43371,310815266,310818048,True,1,2782
43372,310822935,310860044,True,1,37109
43373,310874815,310895069,True,2,20254
43374,310899916,310938565,True,1,38649
43375,310914044,310914584,True,2,540
43376,310917056,310924048,True,1,6992
43377,310923592,310923680,True,1,88
43378,310938711,310954790,True,1,16079
43379,310940645,310955832,True,2,15187
43380,310962107,310965696,True,2,3589
43381,310968415,310970467,False,1,2052
43382,310968415,310971089,True,2,2674
43383,310987104,310993018,True,1,5914
43384,311010264,311010967,True,1,703
43385,311013275,311015156,True,1,1881
43386,311014498,311015090,True,1,592
43387,311050791,311051332,True,1,541
43388,311051945,311053582,True,1,1637
43389,311063940,311064902,True,1,962
43390,311076320,311099758,True,1,23438
43391,311078638,311095783,True,1,17145
43392,311088908,311090269,True,1,1361
43393,311090466,311091775,True,1,1309
43394,311096397,311105575,False,1,9178
43395,311111081,311121205,True,2,10124
43396,311111081,311266329,True,1,155248
43397,311149171,311149668,False,1,497
43398,311156479,311158668,True,1,2189
43399,311157844,311192527,False,1,34683
43400,311160083,311160174,True,8,91
43401,311160311,311160788,True,1,477
43402,311161162,311161238,True,1,76
43403,311170568,311181894,True,1,11326
43404,311177010,311199629,True,1,22619
43405,311177010,311209974,True,1,32964
43406,311185674,311185885,False,1,211
43407,311185674,311191723,True,1,6049
43408,311191977,311194545,True,2,2568
43409,311194063,311201104,False,1,7041
43410,311259936,311260328,True,17,392
43411,311259956,311260328,True,1,372
43412,311261999,311269201,True,1,7202
43413,311276985,311280766,True,1,3781
43414,311317846,311337703,True,1,19857
43415,311317846,311338443,True,3,20597
43416,311317918,311338446,True,1,20528
43417,311330536,311330638,True,1,102
43418,311331169,311335285,True,1,4116
43419,311405011,311420315,True,2,15304
43420,311405480,311420548,True,1,15068
43421,311431261,311431352,False,2,91
43422,311431261,311431352,True,2,91
43423,311433209,311434442,True,1,1233
43424,311433248,311433504,True,1,256
43425,311440033,311441065,False,1,1032
43426,311440033,311441065,True,4,1032
43427,311448285,311450753,True,1,2468
43428,311471075,311471789,True,3,714
43429,311489078,311490298,True,1,1220
43430,311489078,311491525,True,1,2447
43431,311508008,311510308,True,2,2300
43432,311508008,311525263,True,1,17255
43433,311509349,311519023,True,1,9674
43434,311658845,311667013,True,1,8168
43435,311658845,311679548,True,1,20703
43436,311677011,311977739,True,2,300728
43437,311721959,312000153,True,1,278194
43438,311738007,311741698,True,3,3691
43439,311766946,311768497,True,1,1551
43440,311768590,311769249,True,1,659
43441,311772943,311773703,False,1,760
43442,311782493,311782825,True,1,332
43443,311790467,311791726,True,1,1259
43444,311792726,311792989,True,1,263
43445,311834435,311836687,True,1,2252
43446,311834435,311836717,True,4,2282
43447,311863151,311863345,True,2,194
43448,311866875,311868071,False,1,1196
43449,311958279,311960437,False,1,2158
43450,311958279,311960437,True,1,2158
43451,311964884,311968083,True,1,3199
43452,312012012,312016365,True,2,4353
43453,312018692,312148178,True,2,129486
43454,312049264,312049568,True,2,304
43455,312062199,312066665,True,1,4466
43456,312089276,312093137,True,1,3861
43457,312104822,312105105,True,1,283
43458,312169525,312184866,True,3,15341
43459,312169568,312184909,True,1,15341
43460,312191964,312192475,True,1,511
43461,312191964,312196356,True,1,4392
43462,312192787,312195961,True,1,3174
43463,312210006,312210593,True,1,587
43464,312211435,312211526,True,1,91
43465,312239618,312244073,True,1,4455
43466,312246867,312247660,True,1,793
43467,312246876,312247660,True,1,784
43468,312246876,312249524,True,1,2648
43469,312248669,312250364,True,1,1695
43470,312260001,312264822,True,1,4821
43471,312260234,312265059,True,1,4825
43472,312318162,312322766,False,1,4604
43473,312327767,312333353,True,3,5586
43474,312327767,312341404,False,1,13637
43475,312327767,312343758,True,1,15991
43476,312350173,312350266,True,1,93
43477,312365745,312373244,False,1,7499
43478,312365745,312378124,True,1,12379
43479,312365745,312384887,True,5,19142
43480,312365745,312386195,True,1,20450
43481,312365745,312388855,True,1,23110
43482,312424036,312424292,True,1,256
43483,312427305,312427590,True,2,285
43484,312427305,312427661,True,13,356
43485,312439475,312439661,True,1,186
43486,312462171,312464404,False,1,2233
43487,312505559,312507676,True,2,2117
43488,312508266,312509042,True,1,776
43489,312518986,312520023,True,2,1037
43490,312520032,312522556,False,1,2524
43491,312525477,312525586,True,4,109
43492,312525477,312526284,True,1,807
43493,312532868,312537557,True,2,4689
43494,312547627,312547809,False,1,182
43495,312548822,312550551,True,1,1729
43496,312557845,312559098,True,5,1253
43497,312579278,312583603,True,1,4325
43498,312614444,312616527,True,1,2083
43499,312616728,312617755,True,1,1027
43500,312616728,312617856,True,1,1128
43501,312678206,312679950,True,1,1744
43502,312678206,312683375,False,1,5169
43503,312678206,312683375,True,2,5169
43504,312678206,312686069,True,1,7863
43505,312678206,312690115,True,1,11909
43506,312692844,312693765,True,3,921
43507,312748447,312750924,True,1,2477
43508,312748447,312751686,False,1,3239
43509,312748447,312758498,False,1,10051
43510,312748447,312770642,False,1,22195
43511,312765714,312766068,False,1,354
43512,312784789,312787648,True,1,2859
43513,312785894,312788158,True,1,2264
43514,312788935,312789896,True,1,961
43515,312791889,312792017,False,1,128
43516,312864764,312865350,False,1,586
43517,312866857,312869845,True,1,2988
43518,312867138,312869933,True,1,2795
43519,312867138,312869936,False,1,2798
43520,312867221,312870065,True,1,2844
43521,312870960,312871295,False,1,335
43522,312870960,312871295,True,3,335
43523,312871451,312872163,True,1,712
43524,312871610,312872089,True,1,479
43525,312873069,312873674,True,1,605
43526,312873080,312873685,False,1,605
43527,312873083,312873688,True,1,605
43528,312913382,312916393,True,3,3011
43529,312913382,312920786,True,1,7404
43530,312928603,312933867,True,1,5264
43531,312933334,312934013,False,1,679
43532,312950426,312954291,True,3,3865
43533,312950426,312990373,True,2,39947
43534,312959036,312961581,True,1,2545
43535,312991587,312992938,True,1,1351
43536,313027147,313028792,True,1,1645
43537,313043156,313043260,True,1,104
43538,313067129,313069091,True,1,1962
43539,313088260,313091168,False,1,2908
43540,313088260,313091168,True,1,2908
43541,313089045,313091220,True,1,2175
43542,313099068,313100669,True,1,1601
43543,313123335,313123448,True,4,113
43544,313123335,313123452,True,1,117
43545,313129740,313129970,True,2,230
43546,313131909,313134860,True,1,2951
43547,313131909,313135279,True,1,3370
43548,313175978,313176357,True,4,379
43549,313176465,313176610,True,1,145
43550,313176520,313176644,True,3,124
43551,313177060,313206395,False,1,29335
43552,313177898,313206720,True,1,28822
43553,313178412,313178893,True,1,481
43554,313178412,313178934,True,1,522
43555,313179740,313183047,True,1,3307
43556,313180012,313181915,True,1,1903
43557,313216032,313243804,True,1,27772
43558,313223806,313227576,True,2,3770
43559,313281552,313281799,True,1,247
43560,313339267,313339731,True,2,464
43561,313360420,313360631,True,1,211
43562,313360420,313361062,True,4,642
43563,313360420,313376243,True,1,15823
43564,313361200,313361444,True,1,244
43565,313385666,313386350,True,2,684
43566,313386295,313405437,True,3,19142
43567,313386780,313405533,True,1,18753
43568,313392954,313408708,True,1,15754
43569,313397269,313400043,True,2,2774
43570,313414419,313414529,True,2,110
43571,313425145,313425340,True,6,195
43572,313447462,313451401,True,1,3939
43573,313447462,313458447,True,1,10985
43574,313475304,313489345,True,1,14041
43575,313485834,313487582,True,1,1748
43576,313502078,313503854,True,1,1776
43577,313539157,313541153,True,1,1996
43578,313552399,313552999,True,4,600
43579,313553985,313555841,True,1,1856
43580,313571171,313597412,True,2,26241
43581,313573619,313588434,True,1,14815
43582,313573619,313589096,True,1,15477
43583,313596113,313596717,False,1,604
43584,313596113,313596717,True,2,604
43585,313596113,313599236,True,1,3123
43586,313600519,313619177,False,1,18658
43587,313607551,313612131,False,1,4580
43588,313615580,313624939,False,1,9359
43589,313621560,313621848,True,1,288
43590,313642269,313642479,True,1,210
43591,313642373,313642471,True,1,98
43592,313645228,313647708,True,1,2480
43593,313649789,313650012,True,1,223
43594,313661608,313664814,True,3,3206
43595,313692491,313694755,True,1,2264
43596,313727151,313737230,True,1,10079
43597,313728692,313731370,True,1,2678
43598,313731963,313732659,False,2,696
43599,313731963,313732659,True,2,696
43600,313734021,313734119,True,1,98
43601,313752227,313752494,True,2,267
43602,313755457,313756228,False,1,771
43603,313774391,313777126,True,2,2735
43604,313774923,313777436,True,1,2513
43605,313781178,313781815,True,1,637
43606,313781178,313784162,True,1,2984
43607,313809054,313813108,True,1,4054
43608,313810481,313811237,True,3,756
43609,313812321,313813108,True,1,787
43610,313817392,313823712,True,1,6320
43611,313836400,313839473,True,1,3073
43612,313863686,313888156,True,2,24470
43613,313863686,313894650,True,1,30964
43614,313956690,313960844,True,3,4154
43615,314029406,314031460,True,1,2054
43616,314106415,314117922,True,2,11507
43617,314106415,314126329,True,1,19914
43618,314124753,314129492,True,1,4739
43619,314190229,314198360,True,1,8131
43620,314197394,314200658,True,1,3264
43621,314199668,314249422,True,3,49754
43622,314206994,314208236,True,1,1242
43623,314259520,314280985,True,1,21465
43624,314259547,314280948,True,5,21401
43625,314309431,314309879,True,1,448
43626,314316961,314318196,True,2,1235
43627,314341960,314349150,True,1,7190
43628,314355124,314355377,True,1,253
43629,314355553,314365510,True,2,9957
43630,314363455,314363603,True,4,148
43631,314365405,314365914,True,1,509
43632,314412137,314412622,False,1,485
43633,314427750,314429119,True,5,1369
43634,314513309,314614566,True,1,101257
43635,314522430,314532149,True,5,9719
43636,314584280,314624572,True,2,40292
43637,314585924,314625507,True,1,39583
43638,314665228,314673387,True,5,8159
43639,314734739,314736037,False,1,1298
43640,314968720,314968796,True,2,76
43641,314987951,314991009,True,2,3058
43642,315006435,315010627,True,1,4192
43643,315008124,315008389,True,1,265
43644,315088938,315089025,False,1,87
43645,315088938,315089025,True,1,87
43646,315292828,315294653,False,4,1825
43647,315292828,315294801,True,1,1973
43648,315294843,315295893,False,1,1050
43649,315296623,315296707,True,2,84
43650,315297178,315297262,True,1,84
43651,315367120,315371685,False,1,4565
43652,315367120,315371685,True,3,4565
43653,315424084,315449865,True,1,25781
43654,315432086,315432181,True,3,95
43655,315432086,315434960,True,1,2874
43656,315479079,315479336,True,1,257
43657,315530153,315531082,False,2,929
43658,315530153,315531082,True,3,929
43659,315602461,315603683,True,1,1222
43660,315605854,315766171,True,2,160317
43661,315629872,315631446,True,1,1574
43662,315629908,315631446,True,2,1538
43663,315655826,315667730,True,1,11904
43664,315655840,315667730,True,2,11890
43665,315655852,315667730,True,1,11878
43666,315791597,315795082,False,1,3485
43667,315926580,316008963,True,1,82383
43668,315926580,316017272,True,1,90692
43669,315927393,315977634,True,1,50241
43670,315994725,315996422,True,2,1697
43671,315995264,315996700,True,1,1436
43672,316091954,316093681,True,1,1727
43673,316112921,316113928,True,1,1007
43674,316133639,316134074,True,1,435
43675,316204279,316204736,False,1,457
43676,316230387,316237625,False,1,7238
43677,316230387,316255131,True,1,24744
43678,316249072,316257907,True,4,8835
43679,316282812,316284111,True,1,1299
43680,316283696,316284636,True,1,940
43681,316284017,316284552,True,3,535
43682,316285087,316285210,False,1,123
43683,316299688,316300343,True,1,655
43684,316301524,316301962,True,1,438
43685,316301560,316301851,True,2,291
43686,316338795,316342751,False,1,3956
43687,316353427,316356304,True,4,2877
43688,316448443,316448798,True,1,355
43689,316453429,316453847,False,1,418
43690,316488771,316532870,True,1,44099
43691,316519477,316520484,True,1,1007
43692,316525049,316525628,False,1,579
43693,316526374,316534657,False,1,8283
43694,316543785,316546163,True,2,2378
43695,316562342,316562906,False,2,564
43696,316562342,316563207,False,1,865
43697,316562342,316563207,True,1,865
43698,316562342,316563735,True,1,1393
43699,316562342,316564996,True,1,2654
43700,316578088,316589395,True,1,11307
43701,316578088,316599173,True,1,21085
43702,316578132,316595591,True,3,17459
43703,316578132,316599173,True,2,21041
43704,316595786,316596448,True,2,662
43705,316601167,316601466,True,1,299
43706,316646569,316647418,True,1,849
43707,316647321,316647650,True,7,329
43708,316647321,316648573,True,2,1252
43709,316647321,316649100,True,6,1779
43710,316651407,316651902,False,1,495
43711,316651511,316652168,True,1,657
43712,316724820,316725732,True,2,912
43713,316728039,316728483,True,1,444
43714,316768735,316769001,True,1,266
43715,316773698,316773997,True,1,299
43716,316773833,316778361,True,4,4528
43717,316806007,316841121,False,1,35114
43718,316806007,316841121,True,2,35114
43719,316830512,316830591,True,1,79
43720,316844545,316844750,False,1,205
43721,316845155,316850964,True,1,5809
43722,316848411,316860981,False,1,12570
43723,316848411,316860981,True,4,12570
43724,316866733,316869466,True,2,2733
43725,316876401,316887865,True,1,11464
43726,316877323,316888282,True,2,10959
43727,316888701,316893937,False,1,5236
43728,316916460,316918022,True,1,1562
43729,316960389,316963026,True,1,2637
43730,316982697,316983791,True,1,1094
43731,316987368,316987465,False,1,97
43732,317039818,317041820,False,1,2002
43733,317039818,317041820,True,2,2002
43734,317039818,317041824,True,1,2006
43735,317050631,317050799,False,1,168
43736,317050631,317050799,True,3,168
43737,317055535,317066554,False,1,11019
43738,317063069,317065014,True,2,1945
43739,317068800,317070431,True,1,1631
43740,317081855,317083222,True,1,1367
43741,317134896,317136846,True,1,1950
43742,317161674,317163100,True,1,1426
43743,317170459,317172688,True,5,2229
43744,317178805,317180878,True,1,2073
43745,317187134,317187907,True,3,773
43746,317191943,317192565,True,1,622
43747,317298709,317311812,True,1,13103
43748,317345054,317349627,False,1,4573
43749,317354564,317356964,True,1,2400
43750,317380456,317385964,True,1,5508
43751,317468991,317567786,True,3,98795
43752,317484898,317485481,True,1,583
43753,317517573,317518313,False,1,740
43754,317574270,317750670,True,5,176400
43755,317602514,317613089,True,1,10575
43756,317603173,317610191,False,1,7018
43757,317619485,317622322,False,1,2837
43758,317644345,317645048,False,1,703
43759,317644345,317645382,True,1,1037
43760,317654557,317655648,False,1,1091
43761,317703461,317724001,True,1,20540
43762,317752027,317755151,False,1,3124
43763,317802902,317808015,True,5,5113
43764,317915364,317951917,True,1,36553
43765,317915364,317959437,True,1,44073
43766,317917018,317920990,True,1,3972
43767,317939942,317949548,True,1,9606
43768,317959632,317964130,True,2,4498
43769,317969185,317970110,True,1,925
43770,317982647,317985500,True,2,2853
43771,317982707,318473265,True,2,490558
43772,317982707,318574985,True,1,592278
43773,317986386,317987336,True,1,950
43774,318046396,318056272,False,1,9876
43775,318056639,318060899,True,3,4260
43776,318064782,318065548,True,1,766
43777,318094497,318097667,True,3,3170
43778,318115435,318115664,True,1,229
43779,318142155,318143828,True,4,1673
43780,318168191,318170198,True,1,2007
43781,318182256,318183523,True,1,1267
43782,318186971,318194214,False,1,7243
43783,318195656,318198269,False,1,2613
43784,318263138,318264003,False,1,865
43785,318263138,318264003,True,1,865
43786,318283019,318300935,True,2,17916
43787,318283019,318303100,True,2,20081
43788,318290447,318311042,True,3,20595
43789,318333785,318335348,False,1,1563
43790,318348572,318349051,True,1,479
43791,318374882,318375063,True,4,181
43792,318384244,318384748,False,1,504
43793,318390523,318390604,True,1,81
43794,318478147,318480512,False,1,2365
43795,318519048,318531599,True,1,12551
43796,318525328,318540441,True,1,15113
43797,318619341,318625869,True,1,6528
43798,318627205,318703165,True,5,75960
43799,318628785,318703656,True,1,74871
43800,318632437,318647520,False,1,15083
43801,318688600,318742623,True,1,54023
43802,318779519,318823472,True,1,43953
43803,318797145,318797555,True,2,410
43804,318867677,318893362,True,1,25685
43805,318872379,318873684,True,1,1305
43806,318886042,318907733,True,1,21691
43807,318886042,318936713,True,11,50671
43808,318886042,318957416,True,1,71374
43809,318914182,318915170,True,3,988
43810,318920284,318921696,True,1,1412
43811,318963942,318964159,True,1,217
43812,319008066,319010547,True,1,2481
43813,319008066,319022997,True,1,14931
43814,319033110,319037206,False,1,4096
43815,319038353,319038535,True,1,182
43816,319039418,319064156,True,1,24738
43817,319052108,319055868,True,1,3760
43818,319115390,319115504,True,1,114
43819,319115652,319141599,True,1,25947
43820,319178742,319180973,False,1,2231
43821,319178746,319180592,True,1,1846
43822,319178746,319180973,False,1,2227
43823,319181165,319208889,True,1,27724
43824,319186918,319193716,False,1,6798
43825,319186918,319194893,True,1,7975
43826,319186918,319196621,True,1,9703
43827,319186918,319217849,True,1,30931
43828,319206850,319209016,True,1,2166
43829,319206922,319209088,True,1,2166
43830,319228834,319240427,True,1,11593
43831,319237119,319239488,True,1,2369
43832,319249775,319255324,False,1,5549
43833,319252211,319266788,True,1,14577
43834,319261254,319262056,True,1,802
43835,319263451,319338070,False,1,74619
43836,319303770,319312620,True,6,8850
43837,319313067,319315539,True,1,2472
43838,319359475,319359804,False,1,329
43839,319359475,319361224,True,2,1749
43840,319362477,319363689,True,1,1212
43841,319364439,319365372,True,1,933
43842,319364666,319365373,False,1,707
43843,319366006,319366291,True,1,285
43844,319380652,319437247,True,2,56595
43845,319413583,319414574,True,1,991
43846,319501541,319501645,True,1,104
43847,319501548,319501645,True,1,97
43848,319501964,319502748,True,1,784
43849,319540703,319542508,True,1,1805
43850,319540703,319546684,True,1,5981
43851,319544417,319548556,True,1,4139
43852,319544454,319548593,True,2,4139
43853,319551562,319556547,True,1,4985
43854,319593206,319596132,True,1,2926
43855,319610208,319611968,True,1,1760
43856,319629552,319651003,False,1,21451
43857,319629552,319651003,True,1,21451
43858,319642700,319644601,True,1,1901
43859,319642700,319646798,True,1,4098
43860,319648921,319649776,True,1,855
43861,319650439,319682735,True,3,32296
43862,319659118,319660092,True,1,974
43863,319682804,319683455,True,2,651
43864,319684506,319684885,False,2,379
43865,319684506,319684885,True,2,379
43866,319692924,319693482,True,1,558
43867,319697762,319698171,True,1,409
43868,319698624,319698928,True,1,304
43869,319776627,319776958,True,3,331
43870,319779781,319784692,True,1,4911
43871,319790691,319807548,False,1,16857
43872,319794144,319794376,True,3,232
43873,319842937,319843331,True,1,394
43874,319842937,319844378,True,1,1441
43875,319842937,319844514,True,1,1577
43876,319844890,319876554,True,1,31664
43877,319862208,319877445,False,1,15237
43878,319890749,319921493,False,1,30744
43879,319951196,319960972,True,4,9776
43880,319952677,319962453,True,1,9776
43881,319983033,319986627,True,2,3594
43882,319985513,319998355,True,1,12842
43883,320016973,320017185,False,1,212
43884,320019578,320047066,True,1,27488
43885,320079177,320082088,True,1,2911
43886,320102846,320103946,False,1,1100
43887,320102846,320104275,False,1,1429
43888,320102846,320105064,True,1,2218
43889,320111049,320129491,True,1,18442
43890,320121874,320123448,True,3,1574
43891,320122526,320122724,True,2,198
43892,320122556,320122731,True,1,175
43893,320171182,320176213,True,2,5031
43894,320185004,320197184,True,4,12180
43895,320187578,320187816,True,1,238
43896,320194951,320195781,True,1,830
43897,320196825,320196953,True,1,128
43898,320200478,320203652,True,2,3174
43899,320206424,320208638,True,2,2214
43900,320206424,320211910,True,1,5486
43901,320225921,320226201,True,1,280
43902,320234966,320235843,True,1,877
43903,320234966,320236037,False,1,1071
43904,320234966,320236037,True,3,1071
43905,320237099,320238047,True,2,948
43906,320243328,320244304,False,1,976
43907,320243328,320244304,True,1,976
43908,320264115,320265847,True,1,1732
43909,320272833,320273073,True,1,240
43910,320294654,320298672,True,1,4018
43911,320296394,320305317,True,3,8923
43912,320296402,320296481,True,1,79
43913,320297266,320305819,True,3,8553
43914,320310264,320319802,True,1,9538
43915,320321104,320322874,True,1,1770
43916,320344294,320346847,False,1,2553
43917,320346879,320348291,True,1,1412
43918,320350436,320352045,True,1,1609
43919,320350436,320356455,True,1,6019
43920,320352418,320356809,True,2,4391
43921,320363958,320364314,False,1,356
43922,320366162,320366937,True,1,775
43923,320367321,320367459,True,1,138
43924,320373002,320373616,True,5,614
43925,320378364,320414489,True,1,36125
43926,320393621,320394649,True,1,1028
43927,320399822,320400186,True,2,364
43928,320419171,320422759,True,2,3588
43929,320419802,320419903,False,1,101
43930,320422113,320422719,False,1,606
43931,320423162,320423461,True,1,299
43932,320427573,320444822,False,1,17249
43933,320432772,320435526,True,1,2754
43934,320442695,320442983,True,1,288
43935,320442695,320443082,True,1,387
43936,320495970,320496187,True,1,217
43937,320496022,320496187,True,3,165
43938,320510744,320512447,True,1,1703
43939,320518382,320518656,True,2,274
43940,320522321,320522431,True,1,110
43941,320550583,320550698,True,1,115
43942,320579141,320584079,True,1,4938
43943,320589639,320597207,True,1,7568
43944,320589796,320590108,True,1,312
43945,320590019,320590331,True,1,312
43946,320626333,320626554,False,1,221
43947,320626333,320627326,True,1,993
43948,320626333,320627572,True,2,1239
43949,320639934,320641378,True,1,1444
43950,320673987,320677205,True,1,3218
43951,320719599,320721780,False,1,2181
43952,320740472,320740791,True,1,319
43953,320741022,320755799,True,1,14777
43954,320780557,320802344,True,1,21787
43955,320848741,320850303,False,1,1562
43956,320911363,320911711,True,4,348
43957,320918903,320919240,True,1,337
43958,320921608,320926279,True,1,4671
43959,320948490,321153517,True,1,205027
43960,321028994,321030588,True,5,1594
43961,321045983,321046379,True,1,396
43962,321047474,321058730,True,1,11256
43963,321086240,321093996,True,2,7756
43964,321101637,321116932,False,1,15295
43965,321120080,321217442,True,1,97362
43966,321120080,321239522,True,1,119442
43967,321138126,321140075,True,1,1949
43968,321138126,321154527,True,2,16401
43969,321160478,321162166,False,3,1688
43970,321160478,321162166,True,1,1688
43971,321176819,321188408,False,1,11589
43972,321181037,321190014,True,1,8977
43973,321209729,321213226,False,1,3497
43974,321212859,321222198,True,1,9339
43975,321253702,321259585,True,5,5883
43976,321276323,321283528,True,1,7205
43977,321297456,321299525,True,1,2069
43978,321301469,321304886,True,1,3417
43979,321308301,321334792,True,1,26491
43980,321321600,321323349,True,1,1749
43981,321341931,321347841,True,1,5910
43982,321418222,321427058,True,4,8836
43983,321418222,321428685,True,4,10463
43984,321436870,321468808,True,1,31938
43985,321436870,321473323,True,3,36453
43986,321457433,321460282,True,1,2849
43987,321514574,321518197,True,1,3623
43988,321518991,321519973,False,1,982
43989,321531964,321535404,True,5,3440
43990,321539284,321588413,False,1,49129
43991,321539284,321588413,True,1,49129
43992,321539414,321552966,True,1,13552
43993,321568760,321570591,True,1,1831
43994,321595762,321595895,True,2,133
43995,321601166,321602256,False,1,1090
43996,321601166,321602256,True,3,1090
43997,321605753,321606253,True,1,500
43998,321606246,321609400,True,2,3154
43999,321606246,321620595,True,3,14349
44000,321606246,321622883,True,1,16637
44001,321606439,321607158,True,1,719
44002,321617478,321619637,False,1,2159
44003,321692935,321695428,True,1,2493
44004,321772990,321858371,True,1,85381
44005,321775635,321785745,False,1,10110
44006,321776968,321786376,False,1,9408
44007,321829897,321832532,True,3,2635
44008,321878295,321878878,True,2,583
44009,321879603,321882474,True,1,2871
44010,321905436,321906075,True,1,639
44011,321905909,321908808,True,1,2899
44012,321916577,321922420,True,4,5843
44013,321933696,321933831,True,4,135
44014,321997074,322024213,False,1,27139
44015,322015037,322015122,True,2,85
44016,322015286,322015760,True,1,474
44017,322018839,322019030,True,3,191
44018,322034876,322035508,True,1,632
44019,322035855,322035943,True,3,88
44020,322037902,322037990,True,1,88
44021,322083455,322083793,True,1,338
44022,322083455,322084288,True,2,833
44023,322126722,322140167,True,1,13445
44024,322136344,322136604,True,2,260
44025,322137032,322137314,True,2,282
44026,322140994,322142181,True,1,1187
44027,322175829,322176435,True,2,606
44028,322175922,322176481,True,1,559
44029,322176247,322176828,True,1,581
44030,322183081,322183541,True,1,460
44031,322183081,322183631,True,4,550
44032,322225690,322225891,True,1,201
44033,322233899,322235485,True,1,1586
44034,322246609,322250661,True,2,4052
44035,322247443,322250271,True,1,2828
44036,322258721,322259407,True,1,686
44037,322258721,322259661,True,1,940
44038,322259936,322260800,True,5,864
44039,322269356,322269483,False,1,127
44040,322272581,322272808,True,2,227
44041,322272642,322272808,True,3,166
44042,322279203,322279328,True,1,125
44043,322282954,322283115,False,1,161
44044,322282978,322283114,True,3,136
44045,322287233,322288175,True,1,942
44046,322289659,322291345,False,1,1686
44047,322320891,322321390,True,1,499
44048,322332438,322333551,True,1,1113
44049,322338417,322341039,True,1,2622
44050,322344206,322345127,True,1,921
44051,322344206,322345161,True,1,955
44052,322344206,322348131,True,1,3925
44053,322346559,322349421,True,1,2862
44054,322370246,322372860,True,2,2614
44055,322384394,322384788,True,1,394
44056,322384394,322385220,False,1,826
44057,322391758,322391975,False,2,217
44058,322391758,322391975,True,3,217
44059,322392487,322392769,True,1,282
44060,322399017,322400056,True,11,1039
44061,322399171,322400056,True,15,885
44062,322400842,322401039,True,1,197
44063,322401984,322403315,True,1,1331
44064,322429554,322431552,True,1,1998
44065,322457289,322481972,True,1,24683
44066,322548613,322549391,True,1,778
44067,322549476,322549879,True,1,403
44068,322550291,322550420,True,1,129
44069,322550367,322552739,True,1,2372
44070,322551159,322553341,True,1,2182
44071,322555592,322558864,True,1,3272
44072,322568380,322577567,False,1,9187
44073,322568380,322577567,True,4,9187
44074,322568380,322594547,True,1,26167
44075,322669460,322669834,True,1,374
44076,322825936,322868110,False,1,42174
44077,322825936,322868110,True,4,42174
44078,322950546,322950979,True,4,433
44079,322989759,323005152,True,1,15393
44080,322989759,323015479,True,3,25720
44081,323024539,323026039,True,5,1500
44082,323024982,323025450,True,1,468
44083,323045088,323045793,True,1,705
44084,323102467,323109338,False,4,6871
44085,323108722,323111508,True,3,2786
44086,323140523,323144612,False,1,4089
44087,323149719,323161655,True,2,11936
44088,323149719,323227443,True,1,77724
44089,323187416,323188920,True,4,1504
44090,323187416,323192553,True,1,5137
44091,323266047,323272944,True,5,6897
44092,323266047,323274084,True,1,8037
44093,323353894,323357024,True,2,3130
44094,323353894,323357309,True,3,3415
44095,323353894,323358483,True,1,4589
44096,323353894,323359634,True,1,5740
44097,323360780,323361074,True,1,294
44098,323382784,323382876,True,1,92
44099,323384120,323384487,True,1,367
44100,323384935,323385219,True,3,284
44101,323384935,323385597,True,2,662
44102,323392484,323392736,True,1,252
44103,323439515,323441036,True,1,1521
44104,323472265,323484065,True,2,11800
44105,323539832,323549707,False,2,9875
44106,323539832,323549707,True,11,9875
44107,323539832,323576413,False,1,36581
44108,323539832,323576413,True,1,36581
44109,323907047,323907573,True,3,526
44110,323932612,323936027,True,1,3415
44111,323987039,324029588,True,2,42549
44112,324033935,324053061,True,1,19126
44113,324079652,324163773,False,1,84121
44114,324079652,324163773,True,3,84121
44115,324202655,324204633,False,1,1978
44116,324329900,324337731,True,1,7831
44117,324546232,324546804,True,1,572
44118,324549003,324549115,True,1,112
44119,324612644,324681197,True,3,68553
44120,324668131,324669612,True,1,1481
44121,324687920,324688592,True,1,672
44122,324697516,324700374,True,1,2858
44123,324703527,324704489,True,1,962
44124,324732160,324733766,True,1,1606
44125,324732160,324737582,True,1,5422
44126,324885226,324886067,False,1,841
44127,324934049,324936706,True,1,2657
44128,324935652,324937337,True,2,1685
44129,324961920,325046046,True,2,84126
44130,324961920,325108325,False,1,146405
44131,324961920,325108325,True,2,146405
44132,325062862,325067095,True,1,4233
44133,325204648,325227226,True,2,22578
44134,325521120,325522942,False,1,1822
44135,325521120,325522942,True,1,1822
44136,325589218,325619667,False,1,30449
44137,325649235,325649506,True,2,271
44138,325698648,325700223,True,2,1575
44139,325729386,325730837,False,1,1451
44140,325729386,325730837,True,1,1451
44141,325729386,325732658,True,2,3272
44142,325761641,325764518,True,1,2877
44143,325775260,325778376,True,3,3116
44144,325775260,325784161,True,1,8901
44145,325789743,325790268,False,2,525
44146,325790919,325795647,False,1,4728
44147,325819887,325825864,False,1,5977
44148,325860499,325869075,True,1,8576
44149,325865288,325871539,True,2,6251
44150,325887945,325897612,False,1,9667
44151,325889142,325889659,True,1,517
44152,325999258,325999913,True,1,655
44153,326054789,326056518,True,3,1729
44154,326077177,326077435,True,1,258
44155,326078081,326080946,True,1,2865
44156,326078359,326081224,True,1,2865
44157,326083627,326083877,True,1,250
44158,326132635,326136575,True,1,3940
44159,326229381,326234414,True,1,5033
44160,326229381,326234426,True,3,5045
44161,326247477,326247575,True,1,98
44162,326296474,326297353,True,2,879
44163,326298424,326384178,True,1,85754
44164,326334099,326341019,True,1,6920
44165,326401367,326404668,True,1,3301
44166,326456521,326457894,True,1,1373
44167,326549098,326550016,False,1,918
44168,326559801,326571462,True,1,11661
44169,326583578,326587542,True,1,3964
44170,326583724,326587542,True,1,3818
44171,326928212,326931625,False,1,3413
44172,327173739,327198383,True,1,24644
44173,327208223,327209489,False,1,1266
44174,327250946,327253887,False,1,2941
44175,327463018,327465803,False,1,2785
44176,327519928,327521158,False,1,1230
44177,327562375,327694818,False,1,132443
44178,327672041,327711983,True,6,39942
44179,328096126,328102163,True,1,6037
44180,328100322,328104126,True,1,3804
44181,328185363,328217571,False,1,32208
44182,328492026,328492122,True,2,96
44183,328530242,328531954,True,1,1712
44184,328831628,328843855,True,1,12227
44185,328895647,328912195,True,2,16548
44186,328932433,329055528,True,1,123095
44187,329057846,329061069,True,3,3223
44188,329057846,329290325,True,1,232479
44189,329117603,329320494,True,1,202891
44190,329190605,329205536,False,1,14931
44191,329393903,329396714,True,1,2811
44192,329476945,329477446,False,1,501
44193,329813146,329817873,True,1,4727
44194,329813146,329818885,True,1,5739
44195,330344380,330346202,True,4,1822
44196,330414504,330425306,False,1,10802
44197,330699014,330700261,True,2,1247
44198,330740805,330746205,True,3,5400
44199,330812602,330820244,False,1,7642
44200,330892430,330897662,False,2,5232
44201,330918577,330927058,False,1,8481
44202,330924637,330932863,False,1,8226
44203,330981985,330994622,False,1,12637
44204,330981985,330994622,True,1,12637
44205,331027632,331046217,True,1,18585
44206,331083799,331089986,True,6,6187
44207,331114297,331116643,False,1,2346
44208,331200348,331297627,True,1,97279
44209,331200639,331219185,True,1,18546
44210,331263829,331265701,True,3,1872
44211,331276257,331276504,True,1,247
44212,331336068,331338902,False,1,2834
44213,331350845,331366851,False,1,16006
44214,331386751,331388279,True,1,1528
44215,331390310,331398501,False,1,8191
44216,331390885,331405929,False,2,15044
44217,331390885,331405929,True,3,15044
44218,331476777,331480874,False,1,4097
44219,331487391,331490385,False,1,2994
44220,331487391,331490385,True,3,2994
44221,331509948,331519856,True,3,9908
44222,331593900,331656170,True,2,62270
44223,331596714,331598225,False,1,1511
44224,331751517,331751723,True,1,206
44225,331891884,331892791,True,4,907
44226,331906414,331913501,True,2,7087
44227,331907788,331910564,True,2,2776
44228,331998177,332003965,True,1,5788
44229,332056589,332065756,False,1,9167
44230,332056589,332065759,False,1,9170
44231,332056589,332161910,True,1,105321
44232,332079068,332174289,True,1,95221
44233,332192061,332248192,True,1,56131
44234,332257823,332269853,True,1,12030
44235,332262502,332272254,True,2,9752
44236,332300985,332302621,True,1,1636
44237,332304882,332305807,True,1,925
44238,332368859,332399857,True,1,30998
44239,332389167,332593350,False,1,204183
44240,332475050,332480597,True,1,5547
44241,332497733,332503307,True,2,5574
44242,332497733,332507756,True,1,10023
44243,332600776,332685636,True,1,84860
44244,332652406,332677423,True,1,25017
44245,332675682,332738550,True,1,62868
44246,332707201,332753962,True,1,46761
44247,332725112,332762725,True,1,37613
44248,332857942,332880396,True,1,22454
44249,333143221,333145468,True,3,2247
44250,333146373,333147147,True,1,774
44251,333209725,333210562,True,1,837
44252,333223014,333224996,True,1,1982
44253,333253487,333276692,True,1,23205
44254,333423910,333514043,True,2,90133
44255,333428109,333428708,False,2,599
44256,333461213,333462544,True,1,1331
44257,333467260,333469859,True,1,2599
44258,333512753,333517683,False,1,4930
44259,333557348,333557867,False,2,519
44260,333557348,333557867,True,2,519
44261,333566033,333578616,True,1,12583
44262,333571071,333571384,True,1,313
44263,333580952,333581608,False,1,656
44264,333580952,333594071,False,1,13119
44265,333589634,333704940,True,4,115306
44266,333617564,333618913,True,3,1349
44267,333649228,333650133,True,6,905
44268,333652704,333653102,True,2,398
44269,333665110,333670632,True,1,5522
44270,333694601,333696323,True,3,1722
44271,333748476,333750622,False,1,2146
44272,333771067,333772382,True,1,1315
44273,333876228,333887101,False,1,10873
44274,333889721,333903454,True,1,13733
44275,333916783,333918367,True,3,1584
44276,333917239,333917490,True,1,251
44277,333917239,333919131,True,1,1892
44278,333919095,333919774,False,1,679
44279,334045784,334046292,True,1,508
44280,334108070,334112159,True,1,4089
44281,334128266,334147015,True,1,18749
44282,334276506,334279149,True,2,2643
44283,334276506,334279182,True,1,2676
44284,334290650,334295875,False,1,5225
44285,334319549,334323754,True,3,4205
44286,334364189,334484981,True,1,120792
44287,334364189,334561583,True,1,197394
44288,334380260,334400707,True,1,20447
44289,334380260,334462774,False,1,82514
44290,334380260,334462774,True,1,82514
44291,334380260,334491770,True,2,111510
44292,334393256,334414411,True,3,21155
44293,334393256,334481088,True,1,87832
44294,334523238,334526255,False,1,3017
44295,334523238,334526255,True,1,3017
44296,334596823,334599985,True,1,3162
44297,334661589,334664706,True,1,3117
44298,334682426,334684496,True,1,2070
44299,334686282,334687533,True,2,1251
44300,334694484,334699241,True,1,4757
44301,334695442,334698944,True,1,3502
44302,334737024,334749616,False,1,12592
44303,334800859,334802135,True,2,1276
44304,334803871,334806714,True,3,2843
44305,334808978,334812112,True,1,3134
44306,334825817,334826361,True,4,544
44307,334907042,334960328,True,1,53286
44308,334907433,334960407,True,1,52974
44309,335021788,335025586,True,1,3798
44310,335050796,335074818,True,1,24022
44311,335072578,335072863,True,1,285
44312,335072951,335085764,True,1,12813
44313,335090787,335097149,True,1,6362
44314,335103909,335105611,True,1,1702
44315,335168290,335169710,True,1,1420
44316,335199139,335252608,True,2,53469
44317,335227607,335234827,False,2,7220
44318,335310776,335313151,True,10,2375
44319,335351116,335388555,True,1,37439
44320,335382665,335426004,False,1,43339
44321,335382665,335426004,True,4,43339
44322,335409866,335412805,True,2,2939
44323,335438340,335517491,True,3,79151
44324,335455859,335456182,True,4,323
44325,335469280,335475804,True,1,6524
44326,335477281,335490706,True,1,13425
44327,335490063,335504969,True,3,14906
44328,335542304,335543301,True,1,997
44329,335557700,335558584,False,1,884
44330,335557700,335558584,True,3,884
44331,335573424,335574413,True,1,989
44332,335577571,335578820,True,1,1249
44333,335608391,335614252,False,1,5861
44334,335629748,335629878,True,1,130
44335,335666534,335668712,True,1,2178
44336,335698781,335699079,False,1,298
44337,335716705,335726941,True,1,10236
44338,335773509,335775127,True,3,1618
44339,335786879,335798073,True,1,11194
44340,335812042,335826832,True,4,14790
44341,335827010,335829067,True,2,2057
44342,335875519,335881814,True,1,6295
44343,335935124,335994400,False,1,59276
44344,335967253,335968662,True,1,1409
44345,335984990,336059661,True,1,74671
44346,336024345,336025788,True,1,1443
44347,336087833,336111035,True,2,23202
44348,336103813,336105600,True,7,1787
44349,336119589,336125427,True,1,5838
44350,336139112,336146261,False,1,7149
44351,336162922,336163316,False,1,394
44352,336182431,336185523,True,2,3092
44353,336296589,336301308,True,2,4719
44354,336371394,336373210,False,1,1816
44355,336390634,336396004,True,1,5370
44356,336390634,336455650,True,1,65016
44357,336398270,336399559,True,2,1289
44358,336450055,336450650,False,1,595
44359,336455587,336492899,True,3,37312
44360,336456926,336493543,True,1,36617
44361,336500808,336510673,True,1,9865
44362,336533884,336536519,True,1,2635
44363,336562236,336570932,True,1,8696
44364,336583250,336586081,True,1,2831
44365,336629213,336629542,True,1,329
44366,336741007,336751455,False,1,10448
44367,336788334,336789692,False,1,1358
44368,336790006,336791053,False,1,1047
44369,336799771,336818422,False,1,18651
44370,336837272,336848722,True,2,11450
44371,336880657,336889404,False,1,8747
44372,336914482,336916265,True,6,1783
44373,337020360,337021231,True,1,871
44374,337060355,337069061,True,2,8706
44375,337091646,337095009,True,1,3363
44376,337330547,337334947,True,1,4400
44377,337350484,337400500,True,1,50016
44378,337417361,337418429,True,1,1068
44379,337512644,337514195,False,1,1551
44380,337604117,337605585,True,1,1468
44381,337604117,337608072,True,8,3955
44382,337622609,337631699,True,1,9090
44383,337639861,337650420,True,1,10559
44384,337680882,337685997,True,1,5115
44385,337683964,337752423,True,2,68459
44386,337734933,337966363,True,1,231430
44387,338021530,338026033,True,4,4503
44388,338027556,338062920,True,1,35364
44389,338036258,338069280,True,1,33022
44390,338128623,338145655,False,1,17032
44391,338128623,338145655,True,1,17032
44392,338152110,338156552,True,1,4442
44393,338172811,338185223,True,1,12412
44394,338203823,338240451,False,1,36628
44395,338203823,338240451,True,2,36628
44396,338258340,338258438,True,1,98
44397,338262031,338266123,True,1,4092
44398,338275624,338279245,True,1,3621
44399,338279312,338280323,True,1,1011
44400,338509105,338520251,True,1,11146
44401,338557312,338560183,True,2,2871
44402,338582181,338599088,True,1,16907
44403,338622933,338623941,True,1,1008
44404,338625886,338716862,True,2,90976
44405,338634384,338639084,True,1,4700
44406,338674773,338675902,True,3,1129
44407,338691994,338693343,True,1,1349
44408,338728557,338730586,True,3,2029
44409,338776421,338778623,True,1,2202
44410,338781886,338782794,True,1,908
44411,338782151,338784647,True,1,2496
44412,338824521,338832244,False,1,7723
44413,338836561,338850788,True,2,14227
44414,338868363,338870495,True,2,2132
44415,338964888,338965871,True,1,983
44416,338968111,338977953,True,1,9842
44417,338970848,338971817,True,1,969
44418,338982102,338982669,True,1,567
44419,338982102,338982903,True,3,801
44420,338984401,338988606,True,1,4205
44421,338994020,338995047,False,1,1027
44422,339022841,339024486,True,2,1645
44423,339027585,339027959,True,2,374
44424,339031509,339034716,False,1,3207
44425,339066451,339067967,True,1,1516
44426,339066451,339068252,True,1,1801
44427,339080438,339086254,True,1,5816
44428,339105818,339142106,True,1,36288
44429,339115129,339122934,True,2,7805
44430,339115147,339122934,True,1,7787
44431,339116786,339117470,True,2,684
44432,339116890,339117470,True,1,580
44433,339151164,339154767,False,1,3603
44434,339233798,339236165,True,1,2367
44435,339237917,339239568,False,1,1651
44436,339259090,339262634,True,2,3544
44437,339259608,339259789,False,2,181
44438,339263005,339283852,False,1,20847
44439,339266383,339270398,True,1,4015
44440,339286194,339287417,True,1,1223
44441,339318073,339326965,True,2,8892
44442,339318073,339340032,True,1,21959
44443,339319960,339321066,False,1,1106
44444,339319960,339321066,True,1,1106
44445,339320748,339325479,True,2,4731
44446,339328816,339345535,False,1,16719
44447,339341493,339343058,True,1,1565
44448,339345009,339355778,False,1,10769
44449,339350910,339352819,True,3,1909
44450,339369225,339377973,True,2,8748
44451,339375977,339377473,True,1,1496
44452,339385430,339386648,True,1,1218
44453,339425483,339428215,True,1,2732
44454,339455465,339457493,True,1,2028
44455,339506477,339552027,True,1,45550
44456,339511737,339512435,True,2,698
44457,339515808,339516702,True,2,894
44458,339515808,339518762,True,1,2954
44459,339517015,339518284,False,1,1269
44460,339524707,339525623,True,1,916
44461,339527916,339531866,True,1,3950
44462,339528482,339529194,True,1,712
44463,339529673,339532545,True,1,2872
44464,339530093,339532965,True,1,2872
44465,339536096,339539757,True,3,3661
44466,339544745,339545509,True,1,764
44467,339549647,339562069,False,1,12422
44468,339559780,339560613,True,3,833
44469,339561848,339926640,True,1,364792
44470,339570044,339570441,False,1,397
44471,339611141,339615845,True,1,4704
44472,339620531,339621993,True,1,1462
44473,339620539,339625632,True,2,5093
44474,339638992,339644033,True,1,5041
44475,339640827,339640942,True,1,115
44476,339645127,339645623,True,3,496
44477,339693811,339700676,True,1,6865
44478,339707676,339716432,True,1,8756
44479,339715031,339715616,False,1,585
44480,339715031,339829815,True,1,114784
44481,339715031,339840232,True,1,125201
44482,339732067,339754194,True,1,22127
44483,339776751,339777856,True,2,1105
44484,339781391,339813619,True,5,32228
44485,339820220,339831961,True,1,11741
44486,339842907,339844224,True,1,1317
44487,339845675,339850223,True,1,4548
44488,339847321,339849505,True,1,2184
44489,339847321,339861575,True,1,14254
44490,339852189,339855045,True,1,2856
44491,339858279,339859847,True,1,1568
44492,339862684,340027548,True,1,164864
44493,339862684,340070903,True,1,208219
44494,339862684,340076807,True,2,214123
44495,339875278,339875647,True,1,369
44496,339880777,339893235,True,1,12458
44497,339968958,339969139,True,1,181
44498,340019163,340020603,True,1,1440
44499,340033244,340043402,True,1,10158
44500,340075200,340076091,True,1,891
44501,340116193,340116919,True,1,726
44502,340121620,340123156,False,1,1536
44503,340142121,340158540,True,1,16419
44504,340151023,340152957,True,2,1934
44505,340156627,340176440,True,2,19813
44506,340195134,340196723,True,1,1589
44507,340204524,340204763,True,1,239
44508,340208185,340209228,True,2,1043
44509,340217618,340219611,True,1,1993
44510,340230589,340244844,True,1,14255
44511,340273732,340277601,True,2,3869
44512,340278152,340279976,True,1,1824
44513,340280605,340283388,True,1,2783
44514,340303479,340305678,True,2,2199
44515,340303479,340307097,True,1,3618
44516,340308087,340309336,True,1,1249
44517,340335377,340336744,True,1,1367
44518,340362506,340375417,True,1,12911
44519,340370256,340379629,False,1,9373
44520,340380099,340387716,True,1,7617
44521,340380680,340385446,False,1,4766
44522,340421600,340426298,True,2,4698
44523,340481667,340483217,False,1,1550
44524,340577950,340593994,False,4,16044
44525,340577950,340593994,True,3,16044
44526,340630094,340635794,True,5,5700
44527,340672127,340674764,True,3,2637
44528,340733609,340737293,True,1,3684
44529,340772698,340773357,False,1,659
44530,340772698,340773357,True,2,659
44531,340834191,340836629,True,1,2438
44532,340861153,340916326,False,1,55173
44533,340881849,340900999,True,2,19150
44534,340881849,340903396,True,1,21547
44535,340881903,340901046,True,2,19143
44536,340882565,340901306,True,1,18741
44537,340920355,340920685,True,1,330
44538,340952195,340952274,True,1,79
44539,341002687,341003865,True,2,1178
44540,341002687,341009611,True,3,6924
44541,341004626,341007624,True,1,2998
44542,341016914,341019832,True,1,2918
44543,341027812,341034980,True,1,7168
44544,341083885,341098733,True,4,14848
44545,341088418,341093729,False,1,5311
44546,341101995,341102686,True,1,691
44547,341102095,341102686,True,4,591
44548,341102214,341102686,True,1,472
44549,341127886,341130877,True,1,2991
44550,341140742,341167402,True,1,26660
44551,341162811,341182411,True,1,19600
44552,341166977,341168464,False,1,1487
44553,341166977,341168464,True,1,1487
44554,341180952,341181876,True,1,924
44555,341183260,341183367,True,1,107
44556,341193870,341194101,True,1,231
44557,341196396,341196672,True,1,276
44558,341217411,341218282,True,1,871
44559,341220404,341220494,False,1,90
44560,341220404,341220494,True,2,90
44561,341231773,341242299,True,2,10526
44562,341231773,341255378,True,1,23605
44563,341266912,341322177,True,2,55265
44564,341301478,341303471,True,1,1993
44565,341310807,341312781,True,1,1974
44566,341311814,341313248,True,1,1434
44567,341314649,341324550,False,1,9901
44568,341336635,341337232,True,3,597
44569,341368579,341412761,True,1,44182
44570,341430028,341430116,True,3,88
44571,341473077,341473439,True,1,362
44572,341561824,341570568,False,1,8744
44573,341562044,341564265,True,9,2221
44574,341568793,341570904,True,1,2111
44575,341578939,341588422,False,1,9483
44576,341612689,341621060,True,2,8371
44577,341629717,341631760,True,3,2043
44578,341681759,341683121,False,1,1362
44579,341688696,341690523,True,2,1827
44580,341693901,341694075,True,1,174
44581,341715737,341721311,True,1,5574
44582,341726971,341729385,True,1,2414
44583,341726971,341729388,True,1,2417
44584,341726971,341734297,True,1,7326
44585,341732140,341736846,True,1,4706
44586,341743188,341757166,True,1,13978
44587,341771464,341772602,True,2,1138
44588,341775313,341775512,True,1,199
44589,341782187,341782977,True,3,790
44590,341783110,341783425,True,2,315
44591,341809339,341819270,True,3,9931
44592,341821207,341832567,True,1,11360
44593,341821207,341834476,True,1,13269
44594,341905974,341906136,False,1,162
44595,341963492,341964413,True,3,921
44596,342008893,342009587,False,1,694
44597,342069453,342090370,False,3,20917
44598,342069453,342090370,True,3,20917
44599,342111618,342112375,True,1,757
44600,342120122,342121809,True,2,1687
44601,342120139,342121809,True,3,1670
44602,342129729,342152129,False,1,22400
44603,342214661,342222493,True,1,7832
44604,342308885,342309232,True,1,347
44605,342308885,342316859,True,1,7974
44606,342435394,342444851,True,2,9457
44607,342435415,342444881,True,1,9466
44608,342451604,342464241,False,1,12637
44609,342454453,342463775,True,1,9322
44610,342567037,342568808,True,1,1771
44611,342579660,342584167,True,4,4507
44612,342639286,342641281,True,2,1995
44613,342658679,342659322,True,1,643
44614,342743114,342748032,True,1,4918
44615,342909539,342935834,True,3,26295
44616,342941099,342949004,True,1,7905
44617,342994564,342994826,False,1,262
44618,343020477,343023725,True,1,3248
44619,343053660,343056533,True,1,2873
44620,343098069,343102059,True,1,3990
44621,343122470,343130908,True,1,8438
44622,343143929,343144623,True,1,694
44623,343159821,343163511,False,1,3690
44624,343210405,343212291,True,2,1886
44625,343242487,343247560,True,1,5073
44626,343255300,343261258,False,1,5958
44627,343255540,343259764,False,1,4224
44628,343275880,343297773,True,1,21893
44629,343280671,343281449,True,1,778
44630,343340519,343342820,False,2,2301
44631,343342969,343344800,True,2,1831
44632,343346757,343348236,True,1,1479
44633,343346761,343348236,True,1,1475
44634,343411436,343414798,True,1,3362
44635,343501695,343501886,True,1,191
44636,343501695,343503638,True,1,1943
44637,343502020,343503638,True,2,1618
44638,343514978,343587657,False,1,72679
44639,343514978,343587657,True,1,72679
44640,343516757,343588583,True,1,71826
44641,343527422,343533640,True,1,6218
44642,343570017,343589805,True,1,19788
44643,343570948,343578167,True,1,7219
44644,343570948,343589893,True,2,18945
44645,343609790,343610897,True,1,1107
44646,343617195,343629629,True,1,12434
44647,343621574,343701503,True,4,79929
44648,343622272,343623924,True,1,1652
44649,343697798,343700493,True,4,2695
44650,343702596,343795919,True,1,93323
44651,343706432,343707382,False,1,950
44652,343804823,343808273,True,1,3450
44653,343923737,343938256,False,1,14519
44654,344136715,344165061,True,2,28346
44655,344136715,344178695,True,1,41980
44656,344215754,344217292,False,1,1538
44657,344324335,344326486,True,1,2151
44658,344354680,344354682,True,1,2
44659,344354784,344356261,True,4,1477
44660,344391227,344391668,True,2,441
44661,344448006,344450302,False,1,2296
44662,344448006,344450302,True,1,2296
44663,344448006,344455946,True,1,7940
44664,344471399,344476185,True,1,4786
44665,344522658,344576922,True,1,54264
44666,344581506,344582317,True,1,811
44667,344581973,344582351,False,1,378
44668,344581973,344582351,True,2,378
44669,344619356,344635029,True,1,15673
44670,344620006,344620751,False,1,745
44671,344647904,344660495,True,1,12591
44672,344664719,344668910,True,1,4191
44673,344673433,344678235,True,1,4802
44674,344696479,344704428,True,1,7949
44675,344700316,344702138,True,4,1822
44676,344722977,344738374,False,1,15397
44677,344725823,344728575,False,1,2752
44678,344757557,344776849,True,1,19292
44679,344758113,344776958,True,1,18845
44680,344758113,344788719,True,1,30606
44681,344763864,344765940,True,1,2076
44682,344764816,344765940,False,1,1124
44683,344772909,344773304,True,1,395
44684,344779873,344804038,True,1,24165
44685,344821729,344832538,True,1,10809
44686,344822566,344823722,True,1,1156
44687,344822589,344823722,True,1,1133
44688,344937121,344938412,True,2,1291
44689,344937121,344940771,True,2,3650
44690,344944696,344945329,True,1,633
44691,344966836,344990940,True,2,24104
44692,344966836,344990944,True,1,24108
44693,344969082,344991982,True,1,22900
44694,345004896,345022909,True,2,18013
44695,345004953,345022966,True,3,18013
44696,345041420,345044169,True,1,2749
44697,345088055,345090573,True,4,2518
44698,345088564,345090836,True,4,2272
44699,345127286,345132674,True,1,5388
44700,345143076,345145311,True,4,2235
44701,345147821,345155183,True,1,7362
44702,345166493,345167396,True,1,903
44703,345214628,345238595,True,1,23967
44704,345256873,345257417,True,1,544
44705,345256873,345261656,True,1,4783
44706,345281899,345283993,True,2,2094
44707,345319318,345320857,True,1,1539
44708,345319573,345320857,True,1,1284
44709,345319610,345320857,True,1,1247
44710,345381038,345381707,True,1,669
44711,345469715,345470135,True,1,420
44712,345486977,345491945,True,2,4968
44713,345557951,345560979,True,3,3028
44714,345729719,345791027,True,2,61308
44715,345900925,345901587,True,2,662
44716,345900925,345902936,True,1,2011
44717,345929837,345930353,True,1,516
44718,345932246,345932737,True,1,491
44719,346013330,346013875,False,2,545
44720,346021212,346023436,True,1,2224
44721,346069442,346070386,True,1,944
44722,346069442,346074279,True,1,4837
44723,346232520,346269041,True,1,36521
44724,346308873,346310527,True,2,1654
44725,346413360,346635659,False,1,222299
44726,346584279,346622346,True,2,38067
44727,346585011,346622578,True,2,37567
44728,346605300,346624543,True,2,19243
44729,346633191,346652854,True,4,19663
44730,346640266,346657604,True,1,17338
44731,346644949,346645390,True,1,441
44732,346671534,346673201,False,1,1667
44733,346679506,346679979,True,1,473
44734,346744083,346748449,True,1,4366
44735,346774848,346816602,False,1,41754
44736,346801677,346813512,False,1,11835
44737,346832752,346841315,True,1,8563
44738,346840547,346843534,False,1,2987
44739,346840547,346843534,True,1,2987
44740,346841852,346844212,True,3,2360
44741,346893116,346896948,True,1,3832
44742,346939839,346942006,True,2,2167
44743,346945452,346946341,True,1,889
44744,346987983,346989717,False,1,1734
44745,347036552,347049460,True,1,12908
44746,347102424,347103670,False,1,1246
44747,347156828,347171398,True,1,14570
44748,347180078,347186948,False,1,6870
44749,347201300,347260275,True,2,58975
44750,347209644,347210624,True,1,980
44751,347218016,347268616,True,1,50600
44752,347255351,347265733,True,1,10382
44753,347368296,347369219,True,2,923
44754,347368296,347386929,True,1,18633
44755,347369498,347369845,True,1,347
44756,347373018,347468842,True,1,95824
44757,347449829,347507330,True,2,57501
44758,347509112,347537029,True,2,27917
44759,347538344,347540786,True,3,2442
44760,347573961,347612781,True,1,38820
44761,347585825,347618359,True,1,32534
44762,347586006,347618418,True,1,32412
44763,347586006,347618780,True,1,32774
44764,347588290,347589619,True,1,1329
44765,347666251,347666431,False,2,180
44766,347674612,347675280,True,1,668
44767,347675035,347675553,True,3,518
44768,347746144,347749527,True,1,3383
44769,347808360,347810752,True,2,2392
44770,347815806,347818195,True,2,2389
44771,347819700,347824752,False,1,5052
44772,347881294,347896288,True,3,14994
44773,347881294,347975095,True,1,93801
44774,348106718,348138525,False,1,31807
44775,348125992,348134713,False,1,8721
44776,348180015,348259032,True,1,79017
44777,348257346,348316812,True,3,59466
44778,348303615,348307734,True,1,4119
44779,348312837,348387659,False,1,74822
44780,348312837,348410771,False,1,97934
44781,348317598,348413185,False,1,95587
44782,348317598,348427133,False,1,109535
44783,348426683,348429803,True,1,3120
44784,348439272,348442998,True,3,3726
44785,348439272,348447512,True,1,8240
44786,348439382,348441228,True,1,1846
44787,348488579,348489221,True,1,642
44788,348505915,348506496,True,3,581
44789,348584740,348586631,True,1,1891
44790,348618844,348620042,False,1,1198
44791,348618844,348621620,True,1,2776
44792,348692812,348749534,False,1,56722
44793,348896177,348897535,True,2,1358
44794,348903298,348903557,False,2,259
44795,348903298,348903724,False,6,426
44796,348903298,348909605,False,2,6307
44797,348903391,348903724,False,4,333
44798,349154350,349391688,True,1,237338
44799,349163495,349396193,True,1,232698
44800,349339674,349340920,True,2,1246
44801,349340440,349341406,True,1,966
44802,349538672,349550002,True,1,11330
44803,349546171,349548982,True,4,2811
44804,349594362,349595954,False,1,1592
44805,349684626,349778059,True,1,93433
44806,349687167,349690051,True,1,2884
44807,349689506,349691183,True,1,1677
44808,349693272,349773121,True,1,79849
44809,349738259,349738374,True,1,115
44810,349811155,349824609,True,1,13454
44811,349811262,349824688,True,1,13426
44812,349868026,349872316,True,1,4290
44813,349877429,349880868,True,3,3439
44814,349877429,349925080,True,1,47651
44815,349937395,349942318,True,1,4923
44816,349938222,349942639,True,2,4417
44817,349948518,350139214,True,1,190696
44818,349966080,349969645,True,2,3565
44819,350032414,350033691,False,1,1277
44820,350074064,350083511,True,1,9447
44821,350093482,350094986,True,1,1504
44822,350170197,350194749,True,1,24552
44823,350256404,350261818,True,4,5414
44824,350316559,350317952,True,2,1393
44825,350382892,350383937,False,1,1045
44826,350399661,350400653,True,1,992
44827,350409921,350423942,True,1,14021
44828,350410266,350424169,False,1,13903
44829,350410266,350424169,True,1,13903
44830,350426777,350428263,True,2,1486
44831,350447396,350459599,True,1,12203
44832,350521001,350523457,True,2,2456
44833,350521001,350523548,True,1,2547
44834,350521501,350523481,False,1,1980
44835,350549717,350562375,True,1,12658
44836,350584546,350585424,True,2,878
44837,350597208,350604153,True,1,6945
44838,350597443,350600923,True,4,3480
44839,350725946,350728593,True,1,2647
44840,350773668,350774585,True,1,917
44841,350775958,350776078,True,1,120
44842,350823844,350823963,False,1,119
44843,350824301,350932320,False,1,108019
44844,350824572,350825627,True,4,1055
44845,350824572,350828024,True,1,3452
44846,350824572,350841172,True,1,16600
44847,350851631,350856097,True,2,4466
44848,350852350,350852774,True,1,424
44849,350862821,350863497,True,1,676
44850,350873070,350875826,True,2,2756
44851,350954415,350963913,False,1,9498
44852,350975497,350978401,False,1,2904
44853,350976603,350978967,True,1,2364
44854,350981478,351007175,True,1,25697
44855,351023844,351025961,True,1,2117
44856,351052558,351057494,False,1,4936
44857,351052558,351061893,False,1,9335
44858,351056169,351056601,True,1,432
44859,351093253,351093367,False,1,114
44860,351095832,351096595,False,1,763
44861,351128412,351141089,True,1,12677
44862,351128412,351143400,True,1,14988
44863,351140716,351142113,False,1,1397
44864,351200920,351202503,False,1,1583
44865,351225305,351225628,True,2,323
44866,351235959,351236436,True,1,477
44867,351329056,351330474,True,4,1418
44868,351331009,351353398,True,1,22389
44869,351331009,351382024,True,1,51015
44870,351331009,351387400,False,1,56391
44871,351331009,351387400,True,1,56391
44872,351480634,351480839,True,1,205
44873,351501835,351506816,False,1,4981
44874,351505915,351508876,False,1,2961
44875,351547876,351547987,False,1,111
44876,351547876,351547987,True,4,111
44877,351585250,351585882,True,2,632
44878,351622223,351623159,True,1,936
44879,351622226,351623159,True,1,933
44880,351622314,351623159,True,1,845
44881,351626934,351628258,True,1,1324
44882,351631757,351632113,True,1,356
44883,351639401,351642933,True,1,3532
44884,351639401,351644061,False,1,4660
44885,351639401,351644061,True,1,4660
44886,351679130,351679587,True,1,457
44887,351679130,351681344,True,3,2214
44888,351679130,351691643,True,2,12513
44889,351679130,351736003,True,1,56873
44890,351750826,351781542,True,1,30716
44891,351828272,351830295,True,5,2023
44892,351876540,351876703,False,2,163
44893,351876540,351882363,False,3,5823
44894,351876540,351882363,True,8,5823
44895,351876572,351876703,False,1,131
44896,351876572,351882363,True,1,5791
44897,351909790,351909986,True,2,196
44898,351910688,351910822,True,1,134
44899,351939281,351961848,True,1,22567
44900,351952757,351968679,True,1,15922
44901,351958566,351961686,True,1,3120
44902,351984711,351984977,True,1,266
44903,352049680,352059800,True,1,10120
44904,352084115,352084768,True,2,653
44905,352084963,352085809,True,1,846
44906,352095053,352095422,True,4,369
44907,352095053,352100606,True,2,5553
44908,352096518,352101611,True,1,5093
44909,352115747,352126724,True,1,10977
44910,352149090,352153002,True,3,3912
44911,352149090,352154129,True,1,5039
44912,352475380,352527182,True,2,51802
44913,352579470,352581439,True,1,1969
44914,352616087,352616170,True,2,83
44915,352664498,352665015,True,4,517
44916,352676701,352684480,False,1,7779
44917,352692422,352716504,True,1,24082
44918,352793308,352794342,True,1,1034
44919,352794808,352799336,True,1,4528
44920,352864860,352956847,False,1,91987
44921,352864860,352956847,True,2,91987
44922,352899610,352899855,True,1,245
44923,352899610,352917821,True,2,18211
44924,352899610,352927398,True,1,27788
44925,352899610,352938753,True,1,39143
44926,353027954,353030469,True,2,2515
44927,353027998,353030469,True,1,2471
44928,353033244,353033407,False,1,163
44929,353033244,353033939,True,3,695
44930,353110295,353115365,True,6,5070
44931,353120234,353122165,True,2,1931
44932,353121785,353122918,True,2,1133
44933,353124288,353125027,True,1,739
44934,353125118,353198722,True,1,73604
44935,353423025,353428442,False,1,5417
44936,353431737,353434764,True,1,3027
44937,353457006,353457122,True,2,116
44938,353461840,353462386,True,2,546
44939,353466696,353467280,True,1,584
44940,353468782,353471242,True,1,2460
44941,353468909,353468985,True,1,76
44942,353481853,353482700,True,3,847
44943,353517809,353519845,True,1,2036
44944,353538805,353540850,True,1,2045
44945,353569913,353577805,True,2,7892
44946,353585336,353587223,False,1,1887
44947,353585336,353592479,True,5,7143
44948,353587926,353588304,True,1,378
44949,353589581,353590030,True,1,449
44950,353622919,353624125,True,2,1206
44951,353653226,353664418,True,1,11192
44952,353658598,353658687,True,1,89
44953,353663859,353668180,True,1,4321
44954,353676116,353683624,True,1,7508
44955,353707584,353711557,True,3,3973
44956,353717819,353717943,True,1,124
44957,353730760,353731802,False,2,1042
44958,353747756,353754750,True,1,6994
44959,353747756,353755623,True,1,7867
44960,353750733,353757153,True,1,6420
44961,353768117,353768267,True,4,150
44962,353770766,353771155,True,1,389
44963,353810695,353818214,True,1,7519
44964,353821125,353821260,False,1,135
44965,353821125,353821260,True,4,135
44966,353830146,353831289,True,1,1143
44967,353834365,353834640,True,1,275
44968,353859298,353860647,True,3,1349
44969,353862411,353862492,True,1,81
44970,353877505,353877672,True,3,167
44971,353879624,353879757,True,1,133
44972,353890400,353891738,True,1,1338
44973,353891227,353895737,False,1,4510
44974,353893971,353895762,False,1,1791
44975,353893971,353895762,True,5,1791
44976,353915930,353916737,True,1,807
44977,353929632,353929777,True,1,145
44978,353938603,353942882,False,1,4279
44979,353944947,353945716,True,1,769
44980,353963797,353965171,True,1,1374
44981,353974214,353996006,False,1,21792
44982,353974214,354004596,True,1,30382
44983,353974214,354019708,True,2,45494
44984,353975725,353976072,True,1,347
44985,353988923,353989943,True,1,1020
44986,353990138,353990510,True,1,372
44987,353990138,353990513,True,1,375
44988,353999246,353999613,False,1,367
44989,354003066,354005062,False,1,1996
44990,354032906,354033446,True,1,540
44991,354038611,354038786,True,1,175
44992,354054379,354058296,True,1,3917
44993,354057700,354062561,True,1,4861
44994,354062402,354065161,True,1,2759
44995,354079343,354079981,False,2,638
44996,354091890,354092972,False,1,1082
44997,354106588,354107463,True,1,875
44998,354107487,354107581,True,1,94
44999,354107487,354107840,True,1,353
45000,354143362,354144579,True,1,1217
45001,354211767,354214992,True,1,3225
45002,354268519,354269064,True,1,545
45003,354268519,354295708,True,1,27189
45004,354271703,354272792,True,2,1089
45005,354278407,354278983,False,1,576
45006,354281500,354339567,True,1,58067
45007,354298477,354300007,True,2,1530
45008,354301571,354301658,True,1,87
45009,354319606,354416889,True,1,97283
45010,354450286,354451351,True,1,1065
45011,354452515,354468617,True,1,16102
45012,354482459,354484408,True,1,1949
45013,354605122,354605792,True,1,670
45014,354606584,354606786,True,1,202
45015,354757216,354758421,False,1,1205
45016,354839283,354840340,True,1,1057
45017,354868027,354870291,True,1,2264
45018,354872367,354898080,True,1,25713
45019,354989468,354992067,True,1,2599
45020,355069436,355148051,False,1,78615
45021,355081327,355087108,True,1,5781
45022,355116082,355116263,True,3,181
45023,355130367,355134690,True,1,4323
45024,355138069,355138191,True,1,122
45025,355153303,355154351,True,1,1048
45026,355153303,355156954,True,1,3651
45027,355209884,355213029,True,1,3145
45028,355263248,355263321,True,2,73
45029,355263580,355264374,True,1,794
45030,355271455,355274428,False,1,2973
45031,355271455,355274428,True,4,2973
45032,355276939,355277940,True,1,1001
45033,355330317,355330756,True,3,439
45034,355796552,355797166,True,6,614
45035,355830135,355831427,True,1,1292
45036,355952558,355966847,False,1,14289
45037,356060422,356060507,False,1,85
45038,356060422,356060507,True,5,85
45039,356061779,356063146,True,1,1367
45040,356088506,356089626,True,1,1120
45041,356090123,356094599,True,2,4476
45042,356094512,356097093,True,1,2581
45043,356104562,356154319,False,1,49757
45044,356123189,356123309,True,1,120
45045,356123189,356123336,True,1,147
45046,356126692,356315560,True,2,188868
45047,356155020,356157686,True,2,2666
45048,356155020,356157752,True,1,2732
45049,356162902,356162989,True,1,87
45050,356191766,356192148,True,4,382
45051,356195071,356195735,True,1,664
45052,356197203,356226333,True,1,29130
45053,356274151,356311388,False,1,37237
45054,356274151,356662117,True,1,387966
45055,356279143,356290896,True,1,11753
45056,356296773,356300452,False,1,3679
45057,356373304,356374369,False,1,1065
45058,356385039,356385992,False,3,953
45059,356462253,356474601,True,1,12348
45060,356462253,356487830,True,1,25577
45061,356487687,356709489,False,1,221802
45062,356507190,356508550,False,1,1360
45063,356508722,356779352,True,1,270630
45064,356515247,356542465,True,1,27218
45065,356515620,356542763,True,1,27143
45066,356553389,356789545,True,1,236156
45067,356553389,356801746,True,1,248357
45068,356574081,356574949,True,1,868
45069,356575768,356580930,True,1,5162
45070,356621348,356669838,True,1,48490
45071,356645890,356662498,True,1,16608
45072,356679304,356679565,True,2,261
45073,356704890,356706294,False,1,1404
45074,356704890,356706294,True,2,1404
45075,356704890,356707462,False,1,2572
45076,356732729,356738759,False,1,6030
45077,356736580,356737877,True,1,1297
45078,356736580,356737880,True,1,1300
45079,356736638,356737877,True,1,1239
45080,356736638,356737880,True,1,1242
45081,356814184,356815238,True,2,1054
45082,356826884,356826967,True,2,83
45083,356832200,356832341,True,1,141
45084,356843337,356845130,True,1,1793
45085,356901680,356902744,True,1,1064
45086,356964573,356965371,False,1,798
45087,356964573,356965371,True,4,798
45088,356964597,356965371,True,1,774
45089,356975273,356976620,True,1,1347
45090,356982266,357016568,True,3,34302
45091,356987435,357021737,True,1,34302
45092,356987823,356987899,True,2,76
45093,356988416,357022718,True,1,34302
45094,357023950,357026276,False,1,2326
45095,357050383,357068504,True,1,18121
45096,357050383,357085569,False,1,35186
45097,357079176,357086511,True,1,7335
45098,357156086,357157026,True,1,940
45099,357300081,357303429,False,1,3348
45100,357388853,357440114,True,3,51261
45101,357478023,357480219,True,1,2196
45102,357478026,357480219,True,1,2193
45103,357638497,357669709,False,1,31212
45104,357639120,357640485,True,2,1365
45105,357645650,357656815,True,1,11165
45106,357732701,357782846,True,1,50145
45107,357915388,357918131,False,1,2743
45108,357915388,357919817,True,1,4429
45109,357921625,357922834,True,3,1209
45110,357921668,357922877,True,1,1209
45111,357954754,357958168,True,1,3414
45112,357955441,357964585,True,1,9144
45113,357973528,357973716,True,1,188
45114,357973891,357976238,True,1,2347
45115,357990306,358007921,True,1,17615
45116,358036482,358038217,True,1,1735
45117,358081897,358086165,True,1,4268
45118,358083138,358083723,True,5,585
45119,358083138,358084303,True,1,1165
45120,358083182,358084378,True,1,1196
45121,358102633,358103184,True,2,551
45122,358118608,358208859,True,5,90251
45123,358131077,358132110,False,1,1033
45124,358131077,358132110,True,1,1033
45125,358133299,358136234,True,1,2935
45126,358137436,358137882,True,2,446
45127,358146494,358146802,True,4,308
45128,358147037,358147876,True,3,839
45129,358159695,358161157,True,1,1462
45130,358160415,358162228,True,1,1813
45131,358172633,358173702,True,2,1069
45132,358211824,358213430,True,1,1606
45133,358232982,358236851,True,1,3869
45134,358232982,358245073,True,1,12091
45135,358251031,358258105,True,1,7074
45136,358251979,358258607,True,2,6628
45137,358252032,358258607,True,2,6575
45138,358320278,358352175,True,2,31897
45139,358370099,358373872,True,1,3773
45140,358442124,358443568,True,1,1444
45141,358449665,358449760,True,4,95
45142,358466978,358471959,True,1,4981
45143,358468125,358472574,True,1,4449
45144,358469750,358472895,False,1,3145
45145,358493630,358787781,False,1,294151
45146,358495982,358497797,True,1,1815
45147,358499537,358500340,True,1,803
45148,358525919,358534658,True,2,8739
45149,358525919,358555418,True,1,29499
45150,358525919,358567487,True,1,41568
45151,358527837,358528391,True,3,554
45152,358529150,358532135,True,3,2985
45153,358557229,358569480,False,1,12251
45154,358561468,358568317,True,1,6849
45155,358561612,358568317,True,1,6705
45156,358561660,358568317,True,1,6657
45157,358563592,358574340,True,1,10748
45158,358572224,358573040,True,1,816
45159,358580198,358581322,True,6,1124
45160,358589152,358591070,True,1,1918
45161,358591891,358592310,True,1,419
45162,358593121,358597010,True,5,3889
45163,358613037,358616684,True,3,3647
45164,358632658,358634275,True,1,1617
45165,358636451,358637161,True,1,710
45166,358645301,358655312,False,1,10011
45167,358645301,358655331,True,2,10030
45168,358645301,358657343,True,1,12042
45169,358659048,358662767,False,1,3719
45170,358659048,358662767,True,2,3719
45171,358659048,358670177,True,1,11129
45172,358669989,358670391,False,1,402
45173,358669989,358670391,True,1,402
45174,358669989,358673962,True,1,3973
45175,358670367,358670643,False,1,276
45176,358676041,358677042,True,1,1001
45177,358690834,358695564,True,1,4730
45178,358742113,358770596,True,1,28483
45179,358765142,358772942,True,1,7800
45180,358765142,358776277,True,1,11135
45181,358775140,358775730,False,1,590
45182,358776280,358823942,False,1,47662
45183,358782750,358782887,True,6,137
45184,358782750,358783715,True,1,965
45185,358921544,358922660,False,1,1116
45186,359002650,359005548,True,1,2898
45187,359008940,359009198,False,1,258
45188,359009611,359010040,True,1,429
45189,359032566,359038206,True,8,5640
45190,359039026,359039108,True,1,82
45191,359040259,359041409,True,2,1150
45192,359042037,359043846,False,1,1809
45193,359045295,359045409,True,1,114
45194,359056319,359056863,True,3,544
45195,359074341,359074493,False,1,152
45196,359074341,359079479,False,1,5138
45197,359121547,359122190,True,1,643
45198,359122016,359122491,True,2,475
45199,359122193,359122723,True,1,530
45200,359150756,359163093,True,1,12337
45201,359225901,359226984,True,1,1083
45202,359285134,359286215,False,1,1081
45203,359301442,359304659,True,1,3217
45204,359324120,359325924,True,2,1804
45205,359324125,359325924,True,2,1799
45206,359327679,359327771,True,1,92
45207,359330711,359332230,True,3,1519
45208,359347537,359347688,True,1,151
45209,359347537,359348998,True,1,1461
45210,359393650,359396102,True,1,2452
45211,359393894,359408402,True,1,14508
45212,359402962,359410842,True,1,7880
45213,359424855,359489228,True,2,64373
45214,359456307,359457120,True,1,813
45215,359480617,359487373,True,1,6756
45216,359625064,359625769,True,2,705
45217,359663153,359674536,True,1,11383
45218,359703288,359705001,True,2,1713
45219,359842929,359843005,True,1,76
45220,359843179,359877689,True,1,34510
45221,359843337,359877847,True,1,34510
45222,359848184,359879209,True,1,31025
45223,359848184,359879221,True,1,31037
45224,359910704,359911691,True,1,987
45225,359931997,359937994,True,1,5997
45226,359941173,359943867,True,2,2694
45227,360034358,360034702,True,1,344
45228,360058895,360064471,True,1,5576
45229,360070036,360070718,True,1,682
45230,360085996,360087108,True,1,1112
45231,360093195,360093597,True,1,402
45232,360096226,360096514,True,1,288
45233,360109801,360111036,True,1,1235
45234,360111880,360112575,True,1,695
45235,360113530,360113636,True,1,106
45236,360125499,360126404,True,1,905
45237,360248274,360259591,True,2,11317
45238,360399172,360416850,True,1,17678
45239,360437637,360447218,True,1,9581
45240,360437637,360448140,True,1,10503
45241,360437637,360448351,True,1,10714
45242,360437637,360453186,True,3,15549
45243,360479903,360480543,False,1,640
45244,360515003,360541176,True,1,26173
45245,360516185,360516690,False,1,505
45246,360516185,360516713,False,1,528
45247,360516185,360517627,False,1,1442
45248,360549692,360552989,False,1,3297
45249,360553103,360553596,True,2,493
45250,360553103,360562827,True,1,9724
45251,360613614,360614659,False,1,1045
45252,360614905,360616311,True,4,1406
45253,360640127,360640594,True,3,467
45254,360652435,360655420,True,1,2985
45255,360652435,360661660,True,3,9225
45256,360652435,360664413,True,1,11978
45257,360664660,360665862,False,1,1202
45258,360664660,360665862,True,1,1202
45259,360673260,360674900,True,1,1640
45260,360831921,360835655,True,1,3734
45261,360852068,360854355,False,1,2287
45262,360859456,360860525,True,1,1069
45263,360934656,360939689,True,1,5033
45264,360934656,360942149,True,1,7493
45265,361056300,361059447,False,1,3147
45266,361173172,361174402,False,1,1230
45267,361202551,361252639,True,3,50088
45268,361243600,361246104,True,5,2504
45269,361260757,361262671,True,1,1914
45270,361260757,361281353,True,3,20596
45271,361260757,361283157,True,1,22400
45272,361260757,361295884,True,1,35127
45273,361260759,361261706,True,1,947
45274,361266562,361284366,True,1,17804
45275,361302011,361307484,True,1,5473
45276,361302074,361308004,False,1,5930
45277,361302074,361308004,True,3,5930
45278,361315582,361317400,True,1,1818
45279,361321153,361321562,True,1,409
45280,361327969,361328534,True,2,565
45281,361331382,361331690,True,1,308
45282,361332619,361334527,True,1,1908
45283,361334217,361335362,True,1,1145
45284,361367880,361370385,True,1,2505
45285,361376597,361378839,False,3,2242
45286,361376597,361386784,False,1,10187
45287,361403995,361405209,False,3,1214
45288,361403995,361405209,True,3,1214
45289,361486840,361487683,True,1,843
45290,361497495,361499553,True,1,2058
45291,361501181,361501407,True,1,226
45292,361549041,361581130,False,2,32089
45293,361620045,361624840,True,3,4795
45294,361693615,361694309,False,1,694
45295,361764741,361767600,True,1,2859
45296,361785986,361786231,False,1,245
45297,361794991,361801531,True,1,6540
45298,361795274,361805254,True,1,9980
45299,361828410,361858426,False,1,30016
45300,361887957,361895986,True,2,8029
45301,362005160,362005581,True,4,421
45302,362006232,362021208,True,1,14976
45303,362287330,362288090,True,1,760
45304,362411164,362412289,False,1,1125
45305,362656654,362656768,False,3,114
45306,362905831,362932296,True,3,26465
45307,362959330,362960117,True,1,787
45308,363113998,363146151,False,7,32153
45309,363340424,363341499,False,1,1075
45310,363403689,363404090,True,1,401
45311,363690384,363690778,True,1,394
45312,363691041,363692084,True,1,1043
45313,363692054,363692593,True,1,539
45314,363970875,364062006,False,1,91131
45315,363977270,364079759,False,1,102489
45316,364050912,364054405,True,1,3493
45317,364330959,364331271,True,1,312
45318,364644196,364644539,True,2,343
45319,364704696,364705328,True,5,632
45320,364726802,364737681,True,1,10879
45321,364753922,364754416,False,1,494
45322,364773978,364775051,True,1,1073
45323,364804371,364805217,True,16,846
45324,364825879,364825953,True,1,74
45325,364838568,364842346,False,1,3778
45326,364838568,364842346,True,2,3778
45327,364914901,364915532,False,1,631
45328,365022864,365049336,True,2,26472
45329,365084430,365085987,True,1,1557
45330,365087481,365088157,True,1,676
45331,365096396,365097612,True,1,1216
45332,365102580,365105647,True,1,3067
45333,365137405,365138856,True,1,1451
45334,365141916,365142202,True,1,286
45335,365166729,365167297,True,1,568
45336,365180468,365181741,True,1,1273
45337,365183402,365188881,True,1,5479
45338,365230284,365231483,False,1,1199
45339,365231843,365233061,True,3,1218
45340,365232954,365236661,True,1,3707
45341,365323519,365325582,True,1,2063
45342,365466359,365468057,False,2,1698
45343,365466359,365468057,True,3,1698
45344,365475942,365478120,True,1,2178
45345,365513475,365513811,False,1,336
45346,365513475,365513811,True,5,336
45347,365517523,365519948,True,4,2425
45348,365517523,365531414,False,1,13891
45349,365517523,365531414,True,2,13891
45350,365526528,365533145,True,1,6617
45351,365527231,365527324,True,1,93
45352,365561096,365563265,True,1,2169
45353,365617029,365620116,True,2,3087
45354,365682004,365693505,True,1,11501
45355,365693860,365694935,True,1,1075
45356,365700958,365701051,True,1,93
45357,365701468,365703093,True,1,1625
45358,365701468,365703114,False,1,1646
45359,365701468,365703114,True,2,1646
45360,365738368,365741171,True,4,2803
45361,365793121,365793193,True,1,72
45362,365793997,365797601,False,1,3604
45363,365891970,365893268,True,1,1298
45364,365895022,365896190,False,1,1168
45365,365942291,365958315,True,1,16024
45366,365943626,365958889,True,1,15263
45367,365966400,365970373,True,1,3973
45368,365985863,366065055,True,2,79192
45369,366010923,366019199,False,1,8276
45370,366012526,366016522,True,3,3996
45371,366034528,366044046,True,1,9518
45372,366055126,366056209,False,1,1083
45373,366065630,366083230,True,3,17600
45374,366124856,366125012,False,1,156
45375,366130453,366310236,True,1,179783
45376,366258168,366516028,False,1,257860
45377,366310739,366332187,True,3,21448
45378,366330948,366335259,False,1,4311
45379,366331173,366335302,False,1,4129
45380,366413737,366414492,False,1,755
45381,366413737,366414692,False,1,955
45382,366415334,366415598,True,1,264
45383,366420962,366434738,True,1,13776
45384,366439249,366447506,False,1,8257
45385,366439249,366447506,True,2,8257
45386,366490503,366512900,True,1,22397
45387,366490503,366767173,True,1,276670
45388,366505181,366505850,True,1,669
45389,366706991,366707417,True,1,426
45390,366706991,366714676,True,1,7685
45391,366737147,366749327,True,1,12180
45392,366831386,366848535,True,1,17149
45393,366860813,366860909,False,1,96
45394,366883289,366912891,True,1,29602
45395,366883289,366923475,True,3,40186
45396,366883289,366926512,True,2,43223
45397,366987613,366989030,True,1,1417
45398,367050061,367053925,True,4,3864
45399,367068887,367069443,True,1,556
45400,367094669,367098450,True,2,3781
45401,367161977,367162508,False,3,531
45402,367161977,367162508,True,2,531
45403,367192056,367194921,True,2,2865
45404,367202902,367203094,True,1,192
45405,367210843,367271743,True,1,60900
45406,367210843,367316466,True,3,105623
45407,367233356,367237615,True,1,4259
45408,367276912,367281064,True,3,4152
45409,367397696,367400678,True,1,2982
45410,367404222,367404630,False,1,408
45411,367404222,367404630,True,1,408
45412,367404222,367407096,True,1,2874
45413,367407245,367407898,True,1,653
45414,367437489,367450500,False,1,13011
45415,367448374,367452362,False,1,3988
45416,367498690,367502174,True,1,3484
45417,367499124,367502493,True,1,3369
45418,367501463,367503570,True,1,2107
45419,367505854,367508651,True,1,2797
45420,367541769,367543341,True,1,1572
45421,367548732,367549781,True,2,1049
45422,367580124,367581120,True,2,996
45423,367623873,367625425,True,4,1552
45424,367630235,367633122,True,2,2887
45425,367636405,367637237,True,1,832
45426,367636405,367639934,True,2,3529
45427,367706177,367707207,True,3,1030
45428,367746867,367754726,True,2,7859
45429,367749417,367756005,True,1,6588
45430,367764668,367764861,True,1,193
45431,367785380,367787370,True,2,1990
45432,367789593,367791381,True,1,1788
45433,367796441,367796638,True,2,197
45434,367797401,367797500,True,1,99
45435,367798218,367808508,True,1,10290
45436,367807930,367808155,True,2,225
45437,367813136,367814678,True,4,1542
45438,367813170,367813256,True,1,86
45439,367887173,367891520,True,3,4347
45440,367887173,367895052,False,1,7879
45441,367896771,367896849,True,1,78
45442,367901908,367902439,True,1,531
45443,367902445,367902565,True,1,120
45444,367904862,367905258,True,1,396
45445,367920580,367920715,True,4,135
45446,367925711,367925819,True,1,108
45447,367935122,367942703,True,2,7581
45448,367955017,367955905,True,1,888
45449,367969591,367977762,True,1,8171
45450,367978307,367982095,False,1,3788
45451,367978307,367982095,True,2,3788
45452,367987778,367988065,True,3,287
45453,367987778,367988476,True,2,698
45454,367988761,367988946,True,1,185
45455,367989494,367989716,True,1,222
45456,368034210,368034658,True,1,448
45457,368036841,368037691,True,2,850
45458,368041237,368135212,True,1,93975
45459,368041834,368044296,False,1,2462
45460,368041834,368044296,True,2,2462
45461,368064744,368065557,True,5,813
45462,368064744,368065831,True,1,1087
45463,368064744,368067389,True,1,2645
45464,368064744,368067785,True,2,3041
45465,368066284,368066500,True,1,216
45466,368066284,368068058,True,1,1774
45467,368066839,368067113,True,1,274
45468,368076610,368076813,True,1,203
45469,368107627,368108813,True,1,1186
45470,368110781,368111448,True,2,667
45471,368118293,368118787,True,1,494
45472,368128560,368128693,True,4,133
45473,368128560,368133771,True,1,5211
45474,368146159,368146322,True,1,163
45475,368162546,368163945,True,1,1399
45476,368180705,368180948,True,1,243
45477,368180705,368181501,True,1,796
45478,368180721,368180973,True,1,252
45479,368180726,368180973,True,1,247
45480,368180738,368180973,True,1,235
45481,368181034,368181269,True,1,235
45482,368181069,368181184,True,2,115
45483,368181418,368181533,False,1,115
45484,368181418,368181850,False,1,432
45485,368181911,368182086,True,1,175
45486,368182545,368184476,True,1,1931
45487,368196114,368196338,True,4,224
45488,368198174,368198304,True,1,130
45489,368200365,368200467,True,1,102
45490,368229612,368243855,True,1,14243
45491,368249424,368253772,False,1,4348
45492,368260279,368305009,True,1,44730
45493,368309853,368316455,False,1,6602
45494,368361672,368362852,True,1,1180
45495,368373761,368373856,True,1,95
45496,368407818,368409136,True,1,1318
45497,368559727,368568690,True,1,8963
45498,368712651,368802667,True,1,90016
45499,368732010,368732474,True,2,464
45500,368832109,368834600,False,1,2491
45501,368852739,368857652,True,1,4913
45502,368854706,368858668,True,1,3962
45503,369059943,369072261,True,2,12318
45504,369084905,369086281,True,2,1376
45505,369123409,369128290,True,1,4881
45506,369123409,369128427,True,1,5018
45507,369135330,369138242,False,1,2912
45508,369161019,369165417,True,3,4398
45509,369207700,369216245,True,1,8545
45510,369210208,369210297,True,1,89
45511,369323230,369330253,False,1,7023
45512,369323230,369330253,True,1,7023
45513,369323230,369331567,True,1,8337
45514,369380179,369382542,True,1,2363
45515,369525389,369527369,True,1,1980
45516,369527341,369528296,True,1,955
45517,369549947,369551963,True,1,2016
45518,369554176,369564577,True,1,10401
45519,369597188,369666251,True,1,69063
45520,369654617,369748984,True,1,94367
45521,369761460,369775794,False,1,14334
45522,369819686,369830613,True,2,10927
45523,369862886,369863048,True,1,162
45524,370001543,370004031,False,1,2488
45525,370001543,370004031,True,1,2488
45526,370001543,370004039,True,1,2496
45527,370022393,370028254,True,1,5861
45528,370029331,370071232,True,2,41901
45529,370093432,370093542,True,1,110
45530,370093432,370192965,True,1,99533
45531,370161991,370227118,True,2,65127
45532,370176620,370176730,True,2,110
45533,370252487,370256154,True,1,3667
45534,370252736,370256253,True,1,3517
45535,370416933,370419797,True,1,2864
45536,370424832,370426692,True,1,1860
45537,370452234,370454879,True,2,2645
45538,370525389,370533423,False,1,8034
45539,370532941,370534361,False,1,1420
45540,370532941,370534361,True,4,1420
45541,370536553,370536667,True,1,114
45542,370573139,370573317,False,1,178
45543,370586138,370595128,False,1,8990
45544,370601111,370608406,True,1,7295
45545,370608332,370611930,True,2,3598
45546,370619095,370620730,True,1,1635
45547,370724937,370726337,True,7,1400
45548,370862315,370865266,False,1,2951
45549,370862315,370865266,True,1,2951
45550,370926889,371194186,True,1,267297
45551,371055318,371059809,False,1,4491
45552,371099504,371101038,True,2,1534
45553,371099504,371101766,True,1,2262
45554,371141828,371143941,False,1,2113
45555,371141828,371143941,True,4,2113
45556,371152848,371166906,False,1,14058
45557,371231773,371234017,False,1,2244
45558,371231773,371234017,True,1,2244
45559,371237757,371242041,True,1,4284
45560,371267870,371268508,False,2,638
45561,371267870,371268508,True,2,638
45562,371299004,371304975,False,1,5971
45563,371355167,371355535,True,6,368
45564,371355624,371364023,False,1,8399
45565,371379073,371383702,False,1,4629
45566,371407861,371518838,True,1,110977
45567,371530754,371533922,True,2,3168
45568,371531815,371537383,False,1,5568
45569,371532137,371532497,False,1,360
45570,371629447,371632640,False,2,3193
45571,371629447,371632653,False,1,3206
45572,371629447,371634612,False,1,5165
45573,371732966,371744379,True,4,11413
45574,371852472,371857848,True,1,5376
45575,371880103,371880533,True,3,430
45576,371880323,371880621,True,1,298
45577,371946139,371949180,False,1,3041
45578,371994684,371995379,True,1,695
45579,372059756,372476481,False,1,416725
45580,372129053,372130332,True,1,1279
45581,372164897,372165999,True,1,1102
45582,372181673,372187117,True,1,5444
45583,372194632,372196305,True,1,1673
45584,372262692,372299729,True,1,37037
45585,372345732,372345992,False,1,260
45586,372397946,372479963,False,1,82017
45587,372434164,372448767,True,1,14603
45588,372483904,372486566,True,1,2662
45589,372512988,372513373,True,2,385
45590,372528599,372532771,True,3,4172
45591,372530829,372531380,True,4,551
45592,372532060,372536699,False,1,4639
45593,372563943,372564544,True,1,601
45594,372573430,372576823,True,1,3393
45595,372576705,372577833,True,1,1128
45596,372635943,372636141,True,2,198
45597,372642325,372645339,True,2,3014
45598,372653161,372654079,True,1,918
45599,372661992,372664321,True,2,2329
45600,372689995,372693786,True,3,3791
45601,372697914,372701050,True,3,3136
45602,372701209,372703678,True,1,2469
45603,372701209,372707742,True,1,6533
45604,372707774,372712004,True,1,4230
45605,372707774,372716295,True,1,8521
45606,372716622,372716965,True,1,343
45607,372716722,372717065,True,1,343
45608,372716722,372718506,True,1,1784
45609,372716726,372720786,True,1,4060
45610,372733033,372745615,True,2,12582
45611,372760314,372761123,True,1,809
45612,372767800,372770519,True,1,2719
45613,372826335,372828253,True,2,1918
45614,372845451,372847441,False,1,1990
45615,372845451,372847441,True,4,1990
45616,372868755,372869119,True,1,364
45617,372870623,372872989,True,3,2366
45618,372870914,372871278,True,1,364
45619,373002788,373003576,True,2,788
45620,373002788,373003579,True,2,791
45621,373007511,373007622,True,1,111
45622,373015439,373017428,True,16,1989
45623,373015534,373015610,True,2,76
45624,373018804,373019442,True,1,638
45625,373021771,373025870,True,1,4099
45626,373056888,373061317,True,1,4429
45627,373095992,373099520,True,1,3528
45628,373121000,373123806,True,1,2806
45629,373121000,373131300,True,1,10300
45630,373140706,373141240,False,1,534
45631,373170047,373178654,False,1,8607
45632,373207074,373207425,True,1,351
45633,373220450,373221549,True,2,1099
45634,373284837,373285322,True,2,485
45635,373296937,373329885,True,2,32948
45636,373315622,373331639,False,1,16017
45637,373479456,373496192,True,1,16736
45638,373596198,373621447,True,2,25249
45639,373677856,373684525,True,1,6669
45640,373830848,373832610,True,1,1762
45641,373871921,373872693,True,1,772
45642,373906224,373911136,True,2,4912
45643,373929314,373932178,True,2,2864
45644,373980710,373988073,True,1,7363
45645,374005752,374006242,True,1,490
45646,374008704,374009175,True,1,471
45647,374018383,374023071,False,1,4688
45648,374130640,374135539,True,1,4899
45649,374131505,374135961,False,1,4456
45650,374131505,374135961,True,1,4456
45651,374132260,374136319,True,1,4059
45652,374140763,374141071,True,1,308
45653,374146255,374147853,True,1,1598
45654,374172551,374174741,True,1,2190
45655,374225864,374228325,True,1,2461
45656,374251058,374251799,False,1,741
45657,374297412,374298018,True,2,606
45658,374297412,374298068,True,1,656
45659,374374566,374375405,True,2,839
45660,374414671,374416831,False,1,2160
45661,374674769,374682160,False,1,7391
45662,374702068,374710842,True,1,8774
45663,374773758,374774633,True,1,875
45664,374832845,374835797,True,1,2952
45665,374840480,374853561,False,1,13081
45666,374879553,374881891,True,4,2338
45667,374910039,374921535,True,2,11496
45668,374910519,374931142,True,1,20623
45669,374930039,374931677,True,1,1638
45670,375019310,375020456,True,1,1146
45671,375019310,375025777,True,1,6467
45672,375117926,375163741,True,2,45815
45673,375220758,375220863,True,1,105
45674,375258715,375275222,True,1,16507
45675,375385723,375386658,True,1,935
45676,375743471,375995560,True,1,252089
45677,375861554,375873911,True,1,12357
45678,375886507,376002641,True,1,116134
45679,376118950,376183341,True,1,64391
45680,376417815,376423334,True,2,5519
45681,376450857,376451026,False,1,169
45682,376573701,376613732,True,1,40031
45683,376586679,376589085,True,1,2406
45684,376660726,376661435,True,1,709
45685,376686834,376692153,True,2,5319
45686,377330216,377383563,True,1,53347
45687,377779682,377814925,True,1,35243
45688,377833918,377837184,True,1,3266
45689,377833918,377837685,True,1,3767
45690,377913219,377914538,False,1,1319
45691,378025521,378026365,True,1,844
45692,378025521,378030639,True,3,5118
45693,378040111,378041990,True,1,1879
45694,378121717,378122277,True,1,560
45695,378129810,378129984,True,1,174
45696,378313288,378404883,True,4,91595
45697,378315228,378405877,True,1,90649
45698,378315296,378316314,True,1,1018
45699,378643876,378679745,False,1,35869
45700,378698581,378804742,True,4,106161
45701,378753559,378754547,False,2,988
45702,378869601,378883744,True,1,14143
45703,379015079,379033507,True,5,18428
45704,379015079,379089467,True,1,74388
45705,379052375,379108079,True,1,55704
45706,379198140,379253052,True,1,54912
45707,379350309,379356261,True,2,5952
45708,379678392,379688582,True,1,10190
45709,379712842,379713302,False,1,460
45710,379795582,379796280,True,2,698
45711,380049717,380051445,True,1,1728
45712,380135060,380196592,True,2,61532
45713,380211892,380225784,True,1,13892
45714,380211892,380233350,True,1,21458
45715,380293963,380304474,True,1,10511
45716,380463847,380499968,True,1,36121
45717,380463847,380505756,False,1,41909
45718,380463847,380505756,True,3,41909
45719,380463847,380513915,False,1,50068
45720,380463847,380513915,True,2,50068
45721,380612462,380619261,True,3,6799
45722,380852232,380853623,True,1,1391
45723,380874939,380877137,True,1,2198
45724,380889144,380889680,False,3,536
45725,380895011,380895599,False,1,588
45726,381052460,381054749,True,1,2289
45727,381078774,381093469,False,1,14695
45728,381081473,381081890,True,1,417
45729,381082998,381095432,True,1,12434
45730,381144229,381146095,True,1,1866
45731,381168836,381169640,False,1,804
45732,381185404,381185572,True,1,168
45733,381188182,381301585,True,1,113403
45734,381223279,381226659,True,1,3380
45735,381223450,381226667,False,1,3217
45736,381239326,381245184,True,1,5858
45737,381255223,381257084,False,1,1861
45738,381271620,381275281,True,3,3661
45739,381298129,381305324,True,8,7195
45740,381298528,381299308,False,1,780
45741,381313182,381317008,True,2,3826
45742,381365648,381400121,True,1,34473
45743,381417495,381426068,False,1,8573
45744,381437462,381437617,True,1,155
45745,381570554,381642963,True,1,72409
45746,381724199,381726328,True,1,2129
45747,381808380,381809083,True,1,703
45748,381842789,381845211,True,1,2422
45749,381860744,381866855,True,1,6111
45750,381892743,381893059,True,2,316
45751,381971173,381977982,True,1,6809
45752,382005060,382031145,True,1,26085
45753,382030145,382079392,True,1,49247
45754,382091423,382110009,True,1,18586
45755,382091534,382110101,True,1,18567
45756,382094385,382121748,True,2,27363
45757,382139317,382142963,True,1,3646
45758,382139317,382147039,True,1,7722
45759,382416882,382419555,True,1,2673
45760,382416882,382421807,True,1,4925
45761,382416882,382432958,True,1,16076
45762,382546309,382553096,True,1,6787
45763,382668592,382668699,True,1,107
45764,382745656,382746703,True,1,1047
45765,382750349,382754263,False,1,3914
45766,383027933,383028417,True,1,484
45767,383027933,383037729,True,1,9796
45768,383048505,383058834,True,1,10329
45769,383048604,383058933,True,2,10329
45770,383491742,383505422,True,3,13680
45771,383569770,383569857,True,2,87
45772,383584203,383587156,True,1,2953
45773,383584871,383587576,True,1,2705
45774,383669204,383673315,True,3,4111
45775,383680875,383681826,True,2,951
45776,383690740,383692452,True,1,1712
45777,383719097,383745426,True,2,26329
45778,383788893,383789997,True,2,1104
45779,383792309,383793749,True,1,1440
45780,383794726,383795065,True,1,339
45781,383881811,383952097,True,1,70286
45782,384022821,384024138,False,3,1317
45783,384022821,384024138,True,1,1317
45784,384220458,384251717,True,2,31259
45785,384220590,384251864,True,1,31274
45786,384255477,384255939,True,1,462
45787,384255838,384269335,True,1,13497
45788,384492021,384493733,True,1,1712
45789,384513760,384514630,True,1,870
45790,384572356,384598226,True,1,25870
45791,385032043,385150021,True,1,117978
45792,385085764,385086511,False,1,747
45793,385085764,385086511,True,1,747
45794,385086291,385086574,False,1,283
45795,385086291,385086574,True,1,283
45796,385089915,385090269,True,2,354
45797,385096741,385097165,True,1,424
45798,385210714,385211985,True,2,1271
45799,385400474,385410198,True,1,9724
45800,385556479,385557462,True,1,983
45801,385628961,385632174,True,1,3213
45802,385629879,385633149,True,1,3270
45803,385918238,385932354,True,1,14116
45804,385967020,385970930,False,1,3910
45805,385967020,385971720,False,1,4700
45806,385967020,385971720,True,2,4700
45807,385975484,385976969,True,1,1485
45808,385975484,385977759,True,1,2275
45809,385978602,385979241,True,1,639
45810,385979022,385979661,True,1,639
45811,385985921,385987367,True,1,1446
45812,386057457,386066713,True,1,9256
45813,386057457,386073499,True,1,16042
45814,386058355,386067165,True,4,8810
45815,386076909,386083093,True,1,6184
45816,386085888,386090546,True,1,4658
45817,386131483,386132306,True,3,823
45818,386182548,386185327,True,1,2779
45819,386240518,386244965,False,1,4447
45820,386240518,386244965,True,1,4447
45821,386298671,386303006,True,1,4335
45822,386316329,386317156,True,2,827
45823,386353412,386356941,True,1,3529
45824,386622130,386643442,True,8,21312
45825,386673086,386673775,False,1,689
45826,387120852,387121277,False,1,425
45827,387229324,387230083,False,1,759
45828,387351627,387352676,False,1,1049
45829,387533868,387538260,False,1,4392
45830,387708207,387708334,True,2,127
45831,388035729,388036686,False,1,957
45832,388040514,388042532,False,1,2018
45833,388123927,388132462,True,1,8535
45834,388157750,388160058,True,1,2308
45835,388157750,388166363,True,1,8613
45836,388234562,388235514,True,1,952
45837,388250247,388256328,True,1,6081
45838,388250247,388257888,True,1,7641
45839,388300909,388301205,True,1,296
45840,388415769,388416051,False,2,282
45841,388436824,388439041,True,1,2217
45842,388610173,388614744,False,1,4571
45843,388610173,388614748,False,2,4575
45844,388617769,388622169,True,2,4400
45845,388617769,388633415,True,4,15646
45846,388617769,388633442,True,1,15673
45847,388627571,388638783,False,1,11212
45848,388724492,388726816,True,1,2324
45849,388859025,388894450,False,1,35425
45850,389579852,389631765,True,1,51913
45851,389579852,389666188,True,2,86336
45852,389737433,389741568,False,1,4135
45853,389737433,389741583,False,1,4150
45854,389754487,389824613,True,1,70126
45855,389995621,390001987,True,1,6366
45856,390114349,390119842,True,1,5493
45857,390418048,390442568,False,1,24520
45858,390484960,390487033,True,1,2073
45859,390512233,390525256,True,1,13023
45860,390591578,390593718,True,1,2140
45861,390595697,390598180,True,1,2483
45862,390751553,390754118,False,1,2565
45863,390769945,390773534,False,2,3589
45864,390769945,390773534,True,1,3589
45865,390769945,390774349,True,1,4404
45866,390769945,390775864,False,1,5919
45867,390855361,390861824,False,1,6463
45868,390855361,390861828,False,1,6467
45869,390895706,390899301,True,1,3595
45870,390903129,390903641,True,1,512
45871,390904311,390904653,False,1,342
45872,390947888,390949408,False,4,1520
45873,390947888,390949408,True,16,1520
45874,391073715,391075119,False,1,1404
45875,391181293,391183993,True,5,2700
45876,391189811,391190597,False,1,786
45877,391192163,391194232,True,1,2069
45878,391211965,391215074,True,1,3109
45879,391270595,391271680,False,1,1085
45880,391373748,391376960,False,1,3212
45881,391380267,391382273,True,1,2006
45882,391389610,391392941,False,1,3331
45883,391402704,391403841,False,1,1137
45884,391555209,391556441,True,4,1232
45885,391739377,391740281,False,1,904
45886,391739905,391740671,False,1,766
45887,391848918,391849467,False,2,549
45888,391848918,391849467,True,1,549
45889,391848918,391849643,False,1,725
45890,391887003,391888093,True,2,1090
45891,391909002,391909378,True,1,376
45892,391909955,391910489,True,1,534
45893,391931017,391931668,True,2,651
45894,392036334,392040964,True,1,4630
45895,392086057,392093568,False,1,7511
45896,392090528,392095919,True,1,5391
45897,392093181,392096825,True,1,3644
45898,392101284,392101556,True,2,272
45899,392101284,392101560,True,1,276
45900,392164085,392169081,True,3,4996
45901,392254602,392256820,True,1,2218
45902,392392377,392400026,False,2,7649
45903,392392377,392400026,True,3,7649
45904,392395299,392397756,True,2,2457
45905,392454842,392469814,True,1,14972
45906,392468951,392470138,True,2,1187
45907,392499791,392501074,True,1,1283
45908,392562736,392568923,True,1,6187
45909,392591897,392600046,True,1,8149
45910,392684647,392709960,True,1,25313
45911,392733401,392748051,True,1,14650
45912,392867930,392868544,True,1,614
45913,392878759,392882971,True,2,4212
45914,392879536,392883268,False,1,3732
45915,392933755,392976222,True,1,42467
45916,393043265,393066285,True,1,23020
45917,393043856,393066605,True,2,22749
45918,393189670,393206746,True,2,17076
45919,393205277,393207914,True,2,2637
45920,393242312,393263113,True,4,20801
45921,393318550,393541049,True,1,222499
45922,393326225,393326651,False,1,426
45923,393326225,393326651,True,4,426
45924,393328580,393331572,True,1,2992
45925,393348769,393351903,True,1,3134
45926,393458933,393459381,True,1,448
45927,393459620,393460247,False,1,627
45928,393488003,393492219,True,3,4216
45929,393492495,393494096,True,2,1601
45930,393496777,393545489,True,1,48712
45931,393541030,393547876,True,7,6846
45932,393577892,393583465,True,1,5573
45933,393592220,393598795,False,1,6575
45934,393610737,393613253,False,1,2516
45935,393615336,393619797,True,1,4461
45936,393685751,393689076,True,1,3325
45937,393714481,393728689,True,2,14208
45938,393714481,393728692,True,1,14211
45939,393826001,393831516,True,1,5515
45940,393826001,393839952,True,1,13951
45941,393893518,393898679,True,1,5161
45942,394000759,394002648,True,2,1889
45943,394016861,394017970,True,1,1109
45944,394050598,394050964,False,1,366
45945,394106812,394109187,True,2,2375
45946,394114809,394116305,True,1,1496
45947,394130088,394144563,True,2,14475
45948,394249933,394252610,False,1,2677
45949,394251957,394264101,False,1,12144
45950,394251957,394264101,True,1,12144
45951,394341309,394442159,True,1,100850
45952,394474945,394534883,False,1,59938
45953,394474945,394534883,True,4,59938
45954,394475888,394477786,True,3,1898
45955,394604804,394615739,False,1,10935
45956,394640015,394660079,False,1,20064
45957,394659052,394719571,True,1,60519
45958,394682390,394683330,False,2,940
45959,394742273,394742507,False,1,234
45960,394766088,394773086,True,1,6998
45961,394800325,394800549,True,2,224
45962,394806996,394807436,True,1,440
45963,394841395,394842674,True,1,1279
45964,394855348,394855908,True,1,560
45965,394952944,394958962,True,1,6018
45966,394953568,394959918,False,1,6350
45967,394953568,394959918,True,1,6350
45968,394953980,394954734,False,1,754
45969,394953980,394954734,True,1,754
45970,394954953,394960555,True,1,5602
45971,395008857,395015418,False,1,6561
45972,395008857,395015418,True,3,6561
45973,395008857,395025710,False,1,16853
45974,395036555,395059921,True,3,23366
45975,395036555,395071891,True,1,35336
45976,395043626,395073664,True,2,30038
45977,395112978,395114073,True,1,1095
45978,395119652,395125600,True,1,5948
45979,395130923,395140627,False,1,9704
45980,395150931,395155686,True,1,4755
45981,395168392,395169299,True,2,907
45982,395232530,395234260,True,3,1730
45983,395257164,395259042,True,2,1878
45984,395281505,395293485,True,1,11980
45985,395286162,395287652,True,1,1490
45986,395290198,395294391,True,1,4193
45987,395339270,395341284,True,1,2014
45988,395354143,395354856,True,1,713
45989,395354264,395354899,False,1,635
45990,395374260,395388316,True,2,14056
45991,395374381,395388316,True,2,13935
45992,395403823,395405170,True,2,1347
45993,395403823,395406337,True,1,2514
45994,395408064,395445134,True,1,37070
45995,395424487,395447389,True,1,22902
45996,395500346,395500703,False,1,357
45997,395511186,395513413,True,1,2227
45998,395570635,395574990,False,2,4355
45999,395663910,395690045,True,1,26135
46000,395705758,395709690,True,1,3932
46001,395719434,395722308,True,1,2874
46002,395743724,395746605,True,1,2881
46003,395758627,395759311,True,1,684
46004,395763323,395763777,False,1,454
46005,395763323,395768641,True,1,5318
46006,395773643,395775616,True,1,1973
46007,395789288,395802170,False,1,12882
46008,395793643,395797767,False,1,4124
46009,395874354,395874689,False,1,335
46010,395886074,395888903,True,2,2829
46011,395928848,395939682,True,1,10834
46012,396000080,396010443,True,1,10363
46013,396252353,396327808,True,1,75455
46014,396252513,396327788,True,1,75275
46015,396513882,396514391,True,1,509
46016,396563099,396564695,False,1,1596
46017,396567195,396568670,True,1,1475
46018,396568786,396569271,True,1,485
46019,396636618,396642884,True,1,6266
46020,396637467,396643348,True,1,5881
46021,396703229,396703887,True,4,658
46022,396723750,396725031,True,1,1281
46023,396729883,396730516,True,2,633
46024,396760702,396768640,True,1,7938
46025,396761636,396769112,True,2,7476
46026,396761636,396781018,True,2,19382
46027,396762100,396769367,True,1,7267
46028,396872530,396896239,True,1,23709
46029,396985045,396990560,True,3,5515
46030,397115769,397121361,False,1,5592
46031,397184904,397199385,True,4,14481
46032,397186270,397200755,True,1,14485
46033,397216364,397216451,True,7,87
46034,397216826,397269829,True,1,53003
46035,397216881,397269891,False,2,53010
46036,397339488,397536099,True,1,196611
46037,397339488,397617905,True,1,278417
46038,397554503,397646669,False,1,92166
46039,397951726,397952689,False,1,963
46040,398330626,398403284,False,1,72658
46041,399993768,400004556,False,1,10788
46042,399993768,400005513,True,1,11745
46043,399993768,400009629,True,1,15861
46044,400017580,400021557,True,1,3977
46045,400024045,400024852,True,1,807
46046,400271617,400307703,True,4,36086
46047,400624209,400649462,False,1,25253
46048,400665804,400667148,False,1,1344
46049,400671974,400675816,False,1,3842
46050,400754266,400754491,True,1,225
46051,400754437,400754544,True,1,107
46052,400754689,400754910,True,1,221
46053,400762017,400823962,False,1,61945
46054,400978572,400983038,False,1,4466
46055,401043519,401044218,True,2,699
46056,401220502,401227683,True,1,7181
46057,401226809,401230729,True,1,3920
46058,401250816,401336054,True,1,85238
46059,401367562,401393878,True,1,26316
46060,401417779,401438650,True,3,20871
46061,401552472,401565761,True,1,13289
46062,401591679,401594285,False,1,2606
46063,401591679,401594285,True,3,2606
46064,401620000,401626919,True,1,6919
46065,401640098,401640257,True,1,159
46066,401721455,401728059,True,1,6604
46067,401728163,401731381,True,1,3218
46068,401796263,401797087,False,1,824
46069,401881219,401882353,True,2,1134
46070,401881835,401882353,True,2,518
46071,401943443,401944000,True,1,557
46072,401986280,401987624,False,1,1344
46073,402017849,402017996,True,1,147
46074,402208842,402216845,True,5,8003
46075,402231077,402235988,True,1,4911
46076,402319987,402322325,False,1,2338
46077,402319987,402322325,True,1,2338
46078,402341486,402364755,True,1,23269
46079,402341630,402364767,True,2,23137
46080,402342308,402365136,True,2,22828
46081,402343000,402365507,True,1,22507
46082,402347485,402367824,True,1,20339
46083,402505611,402515647,True,3,10036
46084,402656518,402656871,False,1,353
46085,402656518,402656884,False,1,366
46086,402656518,402656884,True,7,366
46087,402656518,402658540,False,1,2022
46088,402664957,402665847,True,2,890
46089,402671964,402672862,False,1,898
46090,402700986,402701343,True,1,357
46091,402707334,402708198,True,1,864
46092,402709022,402711576,True,2,2554
46093,402723162,402724204,True,1,1042
46094,402751272,402752346,True,1,1074
46095,402755584,402756658,False,1,1074
46096,402758547,402759467,True,1,920
46097,402759016,402759936,True,1,920
46098,402781839,402788559,True,4,6720
46099,402869912,402871218,True,1,1306
46100,402869912,402872073,True,1,2161
46101,402901606,402908597,True,1,6991
46102,402906574,402907066,False,1,492
46103,402906574,402907066,True,4,492
46104,402911428,402913266,True,1,1838
46105,402948079,402951272,True,2,3193
46106,403121179,403125097,False,1,3918
46107,403121179,403148144,False,2,26965
46108,403155880,403158083,False,1,2203
46109,403236002,403299392,True,2,63390
46110,403352981,403354197,True,1,1216
46111,403353280,403354540,False,1,1260
46112,403353939,403354836,True,1,897
46113,403354271,403354984,True,1,713
46114,403417625,403458200,True,1,40575
46115,403418166,403458509,True,2,40343
46116,403435903,403436355,True,4,452
46117,403471922,403477318,True,4,5396
46118,403503300,403503835,True,1,535
46119,403508163,403510688,True,1,2525
46120,403508163,403510739,True,1,2576
46121,403508482,403510797,True,1,2315
46122,403513030,403513895,True,1,865
46123,403513742,403514607,True,1,865
46124,403551003,403552909,True,1,1906
46125,403596787,403614692,True,1,17905
46126,403685034,403690526,True,1,5492
46127,403685034,403691423,True,2,6389
46128,403715705,403716367,False,1,662
46129,403715999,403716375,True,1,376
46130,403723035,403734466,True,1,11431
46131,403733109,403733946,True,1,837
46132,403733109,403733947,True,2,838
46133,403849298,403851025,True,1,1727
46134,403873243,403873521,True,1,278
46135,403873243,403880063,True,1,6820
46136,403904006,403909795,True,2,5789
46137,403957499,403958155,True,1,656
46138,403959523,403959944,True,1,421
46139,403959637,403959944,True,1,307
46140,403962080,403975326,True,4,13246
46141,403962080,403978626,True,2,16546
46142,403966892,403977718,True,2,10826
46143,403989180,403992061,True,1,2881
46144,403989320,403992201,False,1,2881
46145,403989320,403992201,True,3,2881
46146,403995544,403998380,True,1,2836
46147,403995608,403998444,True,1,2836
46148,404010159,404015096,True,1,4937
46149,404010179,404018466,False,1,8287
46150,404095651,404098112,False,1,2461
46151,404095651,404098112,True,7,2461
46152,404184749,404188895,True,1,4146
46153,404196442,404196902,True,2,460
46154,404196510,404196902,False,1,392
46155,404196510,404196902,True,3,392
46156,404206175,404206807,True,2,632
46157,404233736,404233822,True,1,86
46158,404233967,404235577,True,4,1610
46159,404234928,404235047,False,1,119
46160,404238530,404240646,True,1,2116
46161,404245645,404253950,True,1,8305
46162,404245645,404259005,True,1,13360
46163,404245858,404253935,False,1,8077
46164,404245858,404253935,True,1,8077
46165,404245858,404253961,True,1,8103
46166,404250558,404256404,True,1,5846
46167,404262723,404267446,True,4,4723
46168,404262723,404268568,True,1,5845
46169,404272582,404273597,True,1,1015
46170,404274817,404274926,False,1,109
46171,404305481,404306502,False,1,1021
46172,404305481,404308081,True,1,2600
46173,404306650,404307324,False,1,674
46174,404306650,404307324,True,3,674
46175,404311502,404311881,False,1,379
46176,404312397,404312525,True,1,128
46177,404312397,404312719,False,1,322
46178,404326446,404357666,True,1,31220
46179,404345907,404367453,False,1,21546
46180,404345907,404367453,True,1,21546
46181,404366647,404377831,True,1,11184
46182,404416300,404453487,False,1,37187
46183,404487870,404490761,True,1,2891
46184,404520017,404522073,True,1,2056
46185,404601872,404602920,True,1,1048
46186,404633052,404635858,True,2,2806
46187,404636099,404703742,True,4,67643
46188,404704768,404708033,True,1,3265
46189,404704768,404712759,True,2,7991
46190,404800085,404801199,True,1,1114
46191,404864095,404889529,True,2,25434
46192,404973951,404975653,True,5,1702
46193,404988087,404988393,False,1,306
46194,405018610,405037244,True,1,18634
46195,405019723,405022008,False,1,2285
46196,405019723,405022008,True,9,2285
46197,405060898,405075362,True,1,14464
46198,405090544,405091004,True,1,460
46199,405125815,405128068,True,3,2253
46200,405131597,405133828,False,1,2231
46201,405131597,405133828,True,1,2231
46202,405174555,405174763,True,1,208
46203,405212483,405214885,True,1,2402
46204,405250721,405256130,True,1,5409
46205,405310559,405320681,True,1,10122
46206,405310559,405326326,True,1,15767
46207,405342421,405343366,True,1,945
46208,405342811,405343516,True,3,705
46209,405394832,405395364,True,2,532
46210,405397989,405398869,True,1,880
46211,405439172,405464261,False,1,25089
46212,405560571,405560774,False,1,203
46213,405560571,405560888,False,1,317
46214,405578906,405581776,False,1,2870
46215,405638550,405640217,False,1,1667
46216,405654372,405655088,True,1,716
46217,405661818,405672207,False,1,10389
46218,405697760,405705508,True,1,7748
46219,405722016,405722594,True,2,578
46220,405722016,405723539,True,2,1523
46221,405724919,405725676,True,1,757
46222,405820788,405821110,True,4,322
46223,405862827,405863192,True,1,365
46224,405864486,405864961,False,1,475
46225,405876411,405877589,True,3,1178
46226,405912369,405913155,True,1,786
46227,405953235,405953433,False,1,198
46228,405953235,405953433,True,3,198
46229,406003669,406019832,True,1,16163
46230,406007328,406007440,True,1,112
46231,406029182,406029462,True,1,280
46232,406041315,406043189,True,2,1874
46233,406051989,406054215,True,1,2226
46234,406065217,406068907,True,1,3690
46235,406105415,406106029,True,1,614
46236,406142946,406146358,True,2,3412
46237,406193891,406194239,True,1,348
46238,406193891,406194746,True,1,855
46239,406194965,406195316,True,1,351
46240,406194965,406195392,True,2,427
46241,406261223,406270348,True,2,9125
46242,406274157,406274691,True,1,534
46243,406296367,406296454,False,1,87
46244,406296771,406296945,True,2,174
46245,406297063,406298346,True,1,1283
46246,406364131,406368823,False,1,4692
46247,406371467,406371634,False,2,167
46248,406371467,406372071,True,3,604
46249,406483322,406570579,True,3,87257
46250,406537660,406538101,False,2,441
46251,406549539,406550893,True,1,1354
46252,406621373,406626169,True,1,4796
46253,406889938,406897177,True,1,7239
46254,406889948,406897177,True,1,7229
46255,406926615,406928361,True,1,1746
46256,407000411,407060502,True,2,60091
46257,407192261,407247782,True,2,55521
46258,407282243,407288511,True,2,6268
46259,407282517,407283631,False,1,1114
46260,407304395,407319152,True,1,14757
46261,407368950,407370407,True,1,1457
46262,407380664,407383743,True,1,3079
46263,407383422,407384612,True,1,1190
46264,407383422,407388126,True,1,4704
46265,407468794,407474237,True,1,5443
46266,407469065,407474237,True,1,5172
46267,407477589,407478719,True,1,1130
46268,407490982,407492754,True,1,1772
46269,407529653,407530169,True,1,516
46270,407529720,407530217,True,2,497
46271,407529720,407535499,True,1,5779
46272,407529720,407552494,True,1,22774
46273,407540117,407554025,True,1,13908
46274,407553066,407562536,True,1,9470
46275,407554024,407554732,True,1,708
46276,407554024,407559575,False,2,5551
46277,407554024,407559575,True,6,5551
46278,407554941,407559714,True,1,4773
46279,407661580,407662061,True,1,481
46280,407661597,407662034,True,1,437
46281,407759306,407760478,False,1,1172
46282,407759306,407760478,True,3,1172
46283,408001374,408001719,True,1,345
46284,408003952,408004405,False,3,453
46285,408085084,408124286,True,2,39202
46286,408146835,408147241,True,1,406
46287,408164304,408165489,True,1,1185
46288,408170669,408170825,True,1,156
46289,408201573,408203830,True,5,2257
46290,408207020,408213730,False,1,6710
46291,408207020,408213730,True,3,6710
46292,408207020,408219851,True,1,12831
46293,408221139,408221226,False,1,87
46294,408248248,408248889,True,1,641
46295,408262640,408268627,True,1,5987
46296,408319393,408321368,True,1,1975
46297,408334911,408335608,True,1,697
46298,408335676,408338049,True,1,2373
46299,408379885,408380566,True,1,681
46300,408386356,408424600,True,4,38244
46301,408386356,408424604,False,1,38248
46302,408386356,408424604,True,1,38248
46303,408421111,408421313,False,1,202
46304,408424638,408426237,False,1,1599
46305,408436703,408437983,True,6,1280
46306,408436703,408444239,True,1,7536
46307,408463370,408472381,True,1,9011
46308,408490037,408491840,True,2,1803
46309,408490037,408500697,True,1,10660
46310,408493840,408502678,True,1,8838
46311,408518991,408526719,True,1,7728
46312,408604674,408608127,True,1,3453
46313,408612994,408615780,True,1,2786
46314,408619089,408622036,True,1,2947
46315,408747932,408751109,True,1,3177
46316,408759408,408759795,False,1,387
46317,408785925,408786496,True,2,571
46318,408847519,408848582,True,1,1063
46319,408847715,408848778,False,1,1063
46320,408971143,408980116,False,4,8973
46321,408971143,408980116,True,5,8973
46322,408988841,408988977,False,1,136
46323,409142668,409162551,False,2,19883
46324,409142668,409162551,True,2,19883
46325,409142668,409165566,True,1,22898
46326,409175648,409176971,True,1,1323
46327,409175648,409238298,True,1,62650
46328,409175648,409240748,True,1,65100
46329,409192406,409193124,False,1,718
46330,409465284,409467817,True,3,2533
46331,409465284,409469939,False,1,4655
46332,409595691,409687539,True,5,91848
46333,409603065,409621827,True,3,18762
46334,409680187,409729747,True,1,49560
46335,409826887,409833036,True,1,6149
46336,409826887,409834490,True,1,7603
46337,409853737,409864158,True,1,10421
46338,409902073,409907469,True,1,5396
46339,409912470,409913561,True,1,1091
46340,409913213,409914304,True,1,1091
46341,409932831,409944980,True,1,12149
46342,409963846,409967286,True,1,3440
46343,410024234,410034290,True,1,10056
46344,410024861,410034565,True,1,9704
46345,410055099,410055518,True,1,419
46346,410056153,410056441,True,1,288
46347,410113209,410119268,True,1,6059
46348,410113212,410119268,True,2,6056
46349,410113212,410119382,True,1,6170
46350,410228503,410228961,True,1,458
46351,410228503,410231436,True,1,2933
46352,410258531,410259517,True,1,986
46353,410394936,410407668,True,1,12732
46354,410396314,410408689,True,1,12375
46355,410431543,410453800,True,1,22257
46356,410450872,410463404,True,1,12532
46357,410452852,410464434,True,1,11582
46358,410476584,410477818,True,1,1234
46359,410544831,410545515,True,1,684
46360,410554011,410554360,True,1,349
46361,410611912,410612813,True,5,901
46362,410684941,410690559,False,1,5618
46363,410701489,410703919,False,2,2430
46364,410701489,410703919,True,2,2430
46365,410701489,410738861,True,1,37372
46366,410701489,410740086,True,1,38597
46367,410821357,410961417,True,5,140060
46368,410850536,410851203,True,1,667
46369,410947607,410965956,True,3,18349
46370,410947607,410966026,False,1,18419
46371,410947607,410966292,False,1,18685
46372,410947689,410965818,True,1,18129
46373,410947689,410965956,True,1,18267
46374,410984309,410984914,True,1,605
46375,410985363,410985968,True,1,605
46376,411076538,411086988,False,1,10450
46377,411076538,411086988,True,2,10450
46378,411097834,411098544,True,1,710
46379,411133684,411134275,False,1,591
46380,411162842,411165153,True,1,2311
46381,411178361,411181197,True,1,2836
46382,411185822,411208651,True,1,22829
46383,411185822,411223790,True,1,37968
46384,411185822,411226414,False,1,40592
46385,411185822,411242323,False,1,56501
46386,411255779,411257967,True,1,2188
46387,411369553,411370599,True,1,1046
46388,411476694,411476972,False,1,278
46389,411476694,411476972,True,4,278
46390,411519066,411522216,True,2,3150
46391,411595020,411596555,False,1,1535
46392,411595020,411596555,True,1,1535
46393,411662932,411691488,False,1,28556
46394,411766487,411766663,True,1,176
46395,411766708,411768585,True,4,1877
46396,412278366,412280354,True,1,1988
46397,412449662,412455088,True,1,5426
46398,412478460,412479013,True,1,553
46399,412635102,412635767,True,2,665
46400,412635102,412636557,True,1,1455
46401,413032561,413073566,True,4,41005
46402,413094987,413095171,True,1,184
46403,413095310,413109489,True,6,14179
46404,413114799,413123412,True,1,8613
46405,413159668,413168982,True,1,9314
46406,413287626,413288082,True,4,456
46407,413362270,413392377,True,3,30107
46408,413461512,413487090,True,1,25578
46409,413513311,413514317,True,1,1006
46410,413530150,413531939,True,2,1789
46411,413556946,413559717,True,1,2771
46412,413618005,413619098,False,1,1093
46413,413618005,413619098,True,1,1093
46414,413618005,413619873,True,1,1868
46415,413717217,413760417,True,2,43200
46416,413728701,413730450,True,1,1749
46417,413883020,413884119,True,1,1099
46418,413944565,413982218,True,1,37653
46419,413976802,413979063,True,6,2261
46420,414004692,414009278,True,1,4586
46421,414020156,414020306,True,1,150
46422,414048725,414048952,True,1,227
46423,414048725,414048998,True,1,273
46424,414049100,414049627,True,1,527
46425,414078509,414078795,True,1,286
46426,414078523,414078809,True,1,286
46427,414082040,414118070,True,6,36030
46428,414136500,414173264,False,1,36764
46429,414141747,414141861,False,1,114
46430,414141747,414141861,True,4,114
46431,414155122,414159435,True,4,4313
46432,414205624,414206706,True,2,1082
46433,414263332,414264333,True,3,1001
46434,414268334,414269322,True,1,988
46435,414279192,414283784,True,1,4592
46436,414279554,414284013,True,1,4459
46437,414388690,414390095,True,2,1405
46438,414415577,414423272,True,1,7695
46439,414440261,414441224,True,2,963
46440,414453330,414454663,True,2,1333
46441,414456192,414462210,True,1,6018
46442,414476853,414479190,True,1,2337
46443,414524502,414525036,True,2,534
46444,414525333,414525452,True,1,119
46445,414525517,414526234,True,1,717
46446,414525517,414526237,True,2,720
46447,414525760,414526480,True,1,720
46448,414555381,414563950,True,1,8569
46449,414617171,414618396,True,1,1225
46450,414620278,414655984,False,1,35706
46451,414990026,414990541,False,1,515
46452,414990026,414990541,True,4,515
46453,414995998,414996868,True,1,870
46454,415014447,415016090,True,1,1643
46455,415032989,415043969,True,1,10980
46456,415197985,415203256,False,1,5271
46457,415205723,415206803,False,1,1080
46458,415205723,415206803,True,2,1080
46459,415220093,415220344,True,1,251
46460,415255465,415267513,True,3,12048
46461,415260489,415261477,True,1,988
46462,415260582,415261477,True,1,895
46463,415260597,415261477,True,1,880
46464,415263561,415266180,True,1,2619
46465,415288773,415290456,True,1,1683
46466,415339205,415348719,True,7,9514
46467,415608668,415618616,True,1,9948
46468,415637132,415669189,False,1,32057
46469,415637132,415669189,True,1,32057
46470,415701646,415702274,False,1,628
46471,415851036,415855739,True,8,4703
46472,415884849,415892041,False,1,7192
46473,415884849,415892041,True,5,7192
46474,415950873,415954214,False,2,3341
46475,416080833,416081836,False,1,1003
46476,416121150,416121907,True,3,757
46477,416121345,416121907,True,1,562
46478,416169119,416179633,False,1,10514
46479,416396270,416396939,True,2,669
46480,416767154,416773425,True,1,6271
46481,416789473,416814965,True,3,25492
46482,416847824,416848793,False,1,969
46483,416892960,416932604,True,1,39644
46484,416952005,416960366,True,3,8361
46485,417152672,417152923,True,1,251
46486,417153103,417165785,True,1,12682
46487,417261027,417261296,True,1,269
46488,417379231,417411838,True,1,32607
46489,417530795,417538000,True,1,7205
46490,417967801,417985630,False,1,17829
46491,417972999,417975164,True,2,2165
46492,417986059,417987023,True,1,964
46493,418014933,418017792,True,1,2859
46494,418051263,418053389,True,1,2126
46495,418060609,418065737,True,1,5128
46496,418202845,418204745,True,3,1900
46497,418240111,418240581,True,1,470
46498,418262129,418267223,True,6,5094
46499,418449530,418517492,True,1,67962
46500,418543397,418564478,True,1,21081
46501,418707611,418709098,False,1,1487
46502,419204600,419204691,True,1,91
46503,419514161,419525342,True,2,11181
46504,419514338,419525359,True,1,11021
46505,419576969,419578031,True,3,1062
46506,419592850,419593174,False,1,324
46507,419607793,419609639,True,1,1846
46508,419697563,419697665,True,1,102
46509,419719154,419737762,True,1,18608
46510,419719154,419737784,True,1,18630
46511,419756510,419757289,True,1,779
46512,419859047,419861770,True,3,2723
46513,419864041,419864219,True,1,178
46514,419912715,419913382,True,1,667
46515,419920956,419921977,True,2,1021
46516,420002826,420004762,True,2,1936
46517,420223140,420237570,False,1,14430
46518,420223140,420237570,True,5,14430
46519,420577770,420661084,True,2,83314
46520,420665566,420666816,True,1,1250
46521,420809919,420811781,True,1,1862
46522,420812550,420817481,True,1,4931
46523,420822609,420823965,True,1,1356
46524,420888881,420889160,True,3,279
46525,420952137,420965823,True,1,13686
46526,421003323,421023870,True,2,20547
46527,421004697,421024524,True,3,19827
46528,421004697,421038443,True,1,33746
46529,421004697,421063059,True,1,58362
46530,421005466,421024914,True,1,19448
46531,421033496,421038900,True,1,5404
46532,421036021,421061159,True,1,25138
46533,421226023,421250773,True,1,24750
46534,421273604,421274532,True,3,928
46535,421388058,421390120,True,1,2062
46536,421648643,421656371,True,1,7728
46537,421651404,421651542,True,1,138
46538,421652037,421658048,True,1,6011
46539,421709136,421800344,True,2,91208
46540,421734784,421735448,True,1,664
46541,421734795,421735448,True,2,653
46542,421734795,421741667,True,3,6872
46543,421734795,421747983,True,2,13188
46544,421748840,421755075,True,1,6235
46545,421773337,421774189,True,2,852
46546,421791687,421792341,False,1,654
46547,421810297,421813707,True,2,3410
46548,421816984,421848430,True,1,31446
46549,422035463,422051072,True,1,15609
46550,422106493,422110241,True,1,3748
46551,422165024,422167567,True,1,2543
46552,422310058,422310621,True,2,563
46553,422595259,422596081,True,3,822
46554,422684895,422763846,True,1,78951
46555,422842905,422859342,True,1,16437
46556,422865775,422866155,False,1,380
46557,422865775,422866155,True,3,380
46558,422866794,422877860,True,1,11066
46559,422916476,422917308,True,1,832
46560,422971407,422971638,False,1,231
46561,422999971,423026535,True,1,26564
46562,423000378,423026726,True,3,26348
46563,423039469,423046284,True,1,6815
46564,423112363,423121052,False,1,8689
46565,423302532,423304323,True,2,1791
46566,423302532,423314971,False,1,12439
46567,423498011,423499711,True,1,1700
46568,423663652,423672044,True,1,8392
46569,423673084,423676560,True,1,3476
46570,423673107,423676559,True,1,3452
46571,423680345,423682225,True,1,1880
46572,423685128,423686075,False,1,947
46573,423840190,423841099,True,2,909
46574,424229193,424231864,True,5,2671
46575,424418202,424425251,True,1,7049
46576,424418202,424426918,True,2,8716
46577,424489226,424492017,True,4,2791
46578,424853299,424910386,True,1,57087
46579,424918511,424961353,True,1,42842
46580,424950581,424977622,True,1,27041
46581,425076533,425086348,True,2,9815
46582,425212690,425222133,True,1,9443
46583,425212690,425223907,False,1,11217
46584,425477500,425527033,True,1,49533
46585,425564241,425566149,True,1,1908
46586,425564241,425570327,True,3,6086
46587,425564241,425570350,True,1,6109
46588,425576761,425576847,True,1,86
46589,425595937,425596199,False,1,262
46590,425720079,425730059,True,1,9980
46591,425811522,425812368,True,2,846
46592,425811522,425857197,True,1,45675
46593,425930498,425933604,True,5,3106
46594,425936820,425938208,True,1,1388
46595,426007087,426012697,True,1,5610
46596,426060205,426061051,True,1,846
46597,426060459,426061051,True,1,592
46598,426064128,426068661,True,1,4533
46599,426247968,426248565,True,3,597
46600,426247968,426258392,False,1,10424
46601,426247968,426258392,True,1,10424
46602,426249840,426259186,True,1,9346
46603,426334057,426336018,False,1,1961
46604,426334057,426336018,True,4,1961
46605,426360420,426361430,True,1,1010
46606,426449438,426459309,True,1,9871
46607,426449438,426468933,True,5,19495
46608,426449438,426475623,True,1,26185
46609,426469592,426479069,False,1,9477
46610,426492539,426497247,True,1,4708
46611,427737218,427742923,False,1,5705
46612,427737218,427742923,True,9,5705
46613,427737218,427751125,True,1,13907
46614,427988753,427998840,False,1,10087
46615,428283941,428284366,True,1,425
46616,428298445,428299710,True,1,1265
46617,428298445,428309888,True,4,11443
46618,428298614,428311123,True,1,12509
46619,428323103,428331087,True,1,7984
46620,428323907,428331653,True,1,7746
46621,428909334,428933092,False,1,23758
46622,428909334,428933092,True,1,23758
46623,428909334,428942667,True,1,33333
46624,429053431,429059891,True,2,6460
46625,429099341,429100861,True,1,1520
46626,429408368,429426142,False,1,17774
46627,429553195,429563586,True,1,10391
46628,430358182,430438593,False,2,80411
46629,430358182,430438593,True,1,80411
46630,430513209,430516268,True,1,3059
46631,430513333,430516268,False,1,2935
46632,430513333,430516268,True,1,2935
46633,430552970,430555296,True,2,2326
46634,430749844,430764801,False,1,14957
46635,431187006,431188407,True,8,1401
46636,431187006,431188411,True,1,1405
46637,431264583,431266159,True,1,1576
46638,431481845,431487861,True,3,6016
46639,431504822,431505592,True,1,770
46640,431593730,431595065,True,3,1335
46641,431595447,431598389,True,1,2942
46642,432353562,432353897,True,1,335
46643,432353907,432354013,True,1,106
46644,432354379,432359910,True,1,5531
46645,432451527,432451868,True,11,341
46646,432459309,432459827,False,3,518
46647,432470171,432471646,True,2,1475
46648,432559064,432563346,True,1,4282
46649,432696115,432710854,True,1,14739
46650,432954746,432956283,False,1,1537
46651,432969477,432970196,False,1,719
46652,433357112,433369079,True,15,11967
46653,433617033,433617605,True,1,572
46654,433722216,433764940,False,1,42724
46655,433807193,433811735,True,1,4542
46656,433893284,433907147,True,1,13863
46657,433893286,433907147,True,1,13861
46658,433893290,433893456,True,1,166
46659,433893290,433907147,True,1,13857
46660,433948199,433951756,True,1,3557
46661,433964124,433965371,True,1,1247
46662,434246986,434264977,True,1,17991
46663,434554507,434555713,True,1,1206
46664,434554993,434556049,True,1,1056
46665,434559607,434560347,True,1,740
46666,434727119,434727510,True,2,391
46667,434996814,435023404,True,1,26590
46668,434996934,435023524,True,1,26590
46669,435078432,435079660,True,1,1228
46670,435208540,435226422,True,1,17882
46671,435245269,435287610,False,1,42341
46672,435448599,435448798,True,1,199
46673,435462305,435463356,False,1,1051
46674,435471197,435471671,True,1,474
46675,435565068,435565195,True,1,127
46676,435609482,435626916,False,1,17434
46677,435609482,435626916,True,1,17434
46678,436132509,436151339,False,1,18830
46679,436298331,436331432,False,2,33101
46680,436917425,436934262,True,1,16837
46681,437035341,437036052,False,1,711
46682,437039064,437055349,False,1,16285
46683,437039064,437055349,True,2,16285
46684,437039064,437097184,False,1,58120
46685,437039064,437097184,True,1,58120
46686,437333837,437337307,True,4,3470
46687,437365894,437368873,True,1,2979
46688,437426042,437457851,True,3,31809
46689,437448375,437469570,True,1,21195
46690,437525212,437527704,False,1,2492
46691,437799563,437799694,True,1,131
46692,437867808,437867939,True,1,131
46693,437980094,437981024,True,1,930
46694,437981542,437981763,True,1,221
46695,437981811,437984770,True,1,2959
46696,438057534,438059196,True,1,1662
46697,438163793,438164000,True,1,207
46698,438164386,438172760,True,1,8374
46699,438201519,438203448,True,1,1929
46700,438251676,438252517,True,1,841
46701,438251676,438253025,True,1,1349
46702,438251676,438253138,True,1,1462
46703,438258182,438258592,True,2,410
46704,438270439,438271216,True,2,777
46705,438279260,438279663,False,1,403
46706,438279260,438279663,True,3,403
46707,438376055,438392405,True,1,16350
46708,438443210,438443394,True,1,184
46709,438462908,438463035,False,1,127
46710,438493849,438494432,True,6,583
46711,438493849,438495715,True,1,1866
46712,438503310,438503643,True,1,333
46713,438509601,438514151,False,1,4550
46714,438526262,438529345,True,1,3083
46715,438529357,438530762,True,2,1405
46716,438533758,438533890,True,1,132
46717,438567728,438572326,True,1,4598
46718,438567728,438578026,True,1,10298
46719,438577055,438577477,True,1,422
46720,438577066,438577488,True,1,422
46721,438634713,438635274,True,5,561
46722,438694514,438699678,True,5,5164
46723,438786516,438787670,True,1,1154
46724,438867003,438878584,False,1,11581
46725,438867003,438878584,True,3,11581
46726,438945280,438952915,True,2,7635
46727,438972514,438973560,True,1,1046
46728,438972514,438983208,True,1,10694
46729,439006170,439008024,True,4,1854
46730,439048844,439049136,True,3,292
46731,439048844,439050038,True,1,1194
46732,439048901,439050038,True,1,1137
46733,439049638,439050154,True,1,516
46734,439057844,439058046,True,2,202
46735,439073686,439074210,True,2,524
46736,439122573,439123009,True,1,436
46737,439151281,439178196,True,1,26915
46738,439151327,439167557,True,1,16230
46739,439206187,439207080,True,1,893
46740,439221831,439222601,True,1,770
46741,439293631,439320769,True,1,27138
46742,439374904,439375472,True,1,568
46743,439378560,439380910,False,1,2350
46744,439383173,439383325,True,1,152
46745,439389804,439390179,True,1,375
46746,439449385,439460292,True,1,10907
46747,439491084,439492135,True,1,1051
46748,439531428,439537094,False,1,5666
46749,439682649,439683207,False,1,558
46750,439683125,439683207,False,1,82
46751,439692786,439694759,True,1,1973
46752,439710032,439710483,True,2,451
46753,439717842,439822456,False,1,104614
46754,439733958,439741613,True,1,7655
46755,439735310,439735422,True,1,112
46756,439766878,439767203,True,1,325
46757,439784000,439784190,True,3,190
46758,439798799,439801508,True,1,2709
46759,439839728,439841294,True,1,1566
46760,439881222,439882011,False,1,789
46761,439881222,439882011,True,1,789
46762,440053106,440053199,True,3,93
46763,440065417,440065566,True,2,149
46764,440074468,440074688,True,2,220
46765,440086293,440086580,True,2,287
46766,440089798,440090221,True,1,423
46767,440093279,440339376,False,1,246097
46768,440143072,440143192,True,1,120
46769,440143072,440143195,True,3,123
46770,440143269,440143552,True,2,283
46771,440144093,440144318,True,1,225
46772,440149255,440149437,True,2,182
46773,440157750,440157951,False,1,201
46774,440168020,440168313,False,1,293
46775,440168020,440168313,True,2,293
46776,440176895,440179200,False,1,2305
46777,440176895,440179200,True,2,2305
46778,440189100,440189426,True,2,326
46779,440189100,440191688,True,2,2588
46780,440189289,440189557,True,1,268
46781,440192108,440192326,True,1,218
46782,440203571,440203734,True,4,163
46783,440220435,440220807,True,2,372
46784,440220718,440220816,True,3,98
46785,440231045,440231285,True,2,240
46786,440236105,440248907,False,1,12802
46787,440236105,440249205,True,1,13100
46788,440284239,440284339,True,1,100
46789,440288279,440288557,True,3,278
46790,440295070,440295272,True,1,202
46791,440309363,440309602,True,3,239
46792,440321229,440322413,True,2,1184
46793,440349076,440353067,True,1,3991
46794,440384415,440385774,True,2,1359
46795,440384415,440386013,True,1,1598
46796,440463157,440463849,True,3,692
46797,440477243,440477754,True,3,511
46798,440499560,440499658,True,1,98
46799,440535279,440536898,True,1,1619
46800,440566860,440567913,True,1,1053
46801,440599786,440609072,True,1,9286
46802,440604038,440609824,False,1,5786
46803,440613577,440614600,True,1,1023
46804,440617176,440617768,True,1,592
46805,440631392,440631736,True,1,344
46806,440646357,440646555,False,1,198
46807,440646357,440646555,True,3,198
46808,440651251,440652135,True,1,884
46809,440727246,440728262,True,1,1016
46810,440727592,440728297,True,1,705
46811,440758919,440775369,True,4,16450
46812,440763847,440778335,True,1,14488
46813,440766579,440766889,True,1,310
46814,440809032,440809334,True,2,302
46815,440817117,440817250,True,1,133
46816,440817843,440818153,True,1,310
46817,440831013,440831698,True,1,685
46818,440840885,440841045,True,3,160
46819,440853167,440853559,True,1,392
46820,440874317,440876367,True,1,2050
46821,440925240,440925409,True,4,169
46822,440925717,440928770,True,1,3053
46823,440984758,440984911,False,1,153
46824,440984758,440984911,True,2,153
46825,440984758,440984971,True,1,213
46826,440993527,440993671,True,1,144
46827,441403782,441454261,True,5,50479
46828,441727680,441733579,True,1,5899
46829,441843820,441849962,True,3,6142
46830,441920599,441924869,True,2,4270
46831,442005380,442006629,False,1,1249
46832,442106533,442107276,True,1,743
46833,443010596,443012472,True,1,1876
46834,443750782,443754198,True,3,3416
46835,444568018,444572673,True,1,4655
46836,444580790,444581081,True,1,291
46837,444580790,444581110,True,1,320
46838,445391830,445392553,True,1,723
46839,445462853,445463206,True,3,353
46840,445463763,445466353,True,1,2590
46841,445485400,445485484,True,1,84
46842,445583028,445585942,True,1,2914
46843,445604647,445606421,True,1,1774
46844,445635591,445636557,True,1,966
46845,445684685,445684827,False,1,142
46846,445684685,445684827,True,2,142
46847,445772189,445772833,False,1,644
46848,445772189,445774929,True,2,2740
46849,445773475,445775741,True,2,2266
46850,445803762,445807903,False,1,4141
46851,445821221,445821775,False,1,554
46852,445821221,445821775,True,1,554
46853,445976943,446061551,True,1,84608
46854,446130564,446130734,True,2,170
46855,446130766,446131266,True,2,500
46856,446130766,446149462,True,1,18696
46857,446133340,446151288,True,1,17948
46858,446316824,446317232,True,1,408
46859,446317368,446318593,True,1,1225
46860,446325957,446331328,True,1,5371
46861,446371395,446371596,False,1,201
46862,446569124,446588562,True,2,19438
46863,446578861,446601321,True,1,22460
46864,446578861,446628606,True,1,49745
46865,446789722,446790749,True,3,1027
46866,446816693,446846221,True,1,29528
46867,446872902,446900806,True,3,27904
46868,446876131,446879813,True,1,3682
46869,447022391,447023804,False,1,1413
46870,447073054,447089517,True,1,16463
46871,447106289,447107030,True,1,741
46872,447430193,447431439,True,1,1246
46873,447451707,447478277,True,2,26570
46874,447778827,447794756,True,1,15929
46875,447800697,447805580,True,1,4883
46876,447833639,447834171,True,1,532
46877,447892508,447894606,True,1,2098
46878,447936190,447939409,True,4,3219
46879,448380964,448384602,False,1,3638
46880,448603886,448619960,True,3,16074
46881,448742029,448748186,True,1,6157
46882,448830407,448833961,True,4,3554
46883,448841893,448845108,False,1,3215
46884,448925671,448928658,True,1,2987
46885,449001098,449005635,True,1,4537
46886,449089207,449092707,True,4,3500
46887,449089207,449096321,True,1,7114
46888,449089257,449098091,False,1,8834
46889,449150406,449154372,False,1,3966
46890,449150406,449154372,True,2,3966
46891,449201647,449206570,True,1,4923
46892,449236281,449236380,True,1,99
46893,449243513,449249974,False,2,6461
46894,449243513,449249974,True,1,6461
46895,449259960,449270509,True,1,10549
46896,449483511,449484903,True,1,1392
46897,449609135,449672836,True,1,63701
46898,449644488,449646369,True,1,1881
46899,449680385,449682023,True,4,1638
46900,450234892,450257725,True,4,22833
46901,450488339,450508510,True,1,20171
46902,450488339,450509166,True,1,20827
46903,450673959,450677781,True,3,3822
46904,450856818,450868295,False,1,11477
46905,451180368,451181307,True,2,939
46906,451260360,451263393,True,1,3033
46907,451260360,451264732,True,2,4372
46908,451303590,451303728,True,1,138
46909,451360047,451360580,True,4,533
46910,451452759,451454564,True,1,1805
46911,451777113,451814100,False,1,36987
46912,451931228,451936514,False,2,5286
46913,451931228,451936514,True,2,5286
46914,451995667,452014220,True,1,18553
46915,451996430,452014537,True,1,18107
46916,452026246,452029425,True,1,3179
46917,452067865,452067965,True,1,100
46918,452108646,452109074,True,1,428
46919,452148771,452149078,True,2,307
46920,452150967,452151750,True,1,783
46921,452215896,452216482,True,2,586
46922,452219336,452219459,True,1,123
46923,452249801,452251356,True,2,1555
46924,452249801,452252886,True,1,3085
46925,452343626,452345997,True,1,2371
46926,452500919,452502435,True,2,1516
46927,452503857,452505032,True,1,1175
46928,452531360,452539179,True,2,7819
46929,452543324,452546150,False,1,2826
46930,452666901,452672413,True,1,5512
46931,452749174,452751168,False,1,1994
46932,452823157,452824588,True,1,1431
46933,452839156,452839644,True,3,488
46934,452841307,452841456,True,1,149
46935,452894407,452938287,True,1,43880
46936,453097633,453098059,True,1,426
46937,453449718,453452154,True,1,2436
46938,453473307,453521001,True,2,47694
46939,453641977,453644768,True,1,2791
46940,453790510,453818120,True,1,27610
46941,454015192,454017830,False,1,2638
46942,454116622,454117233,True,2,611
46943,454126316,454132652,False,1,6336
46944,454171844,454175789,False,1,3945
46945,454171844,454180809,True,1,8965
46946,454256037,454256117,True,1,80
46947,454256037,454277013,True,1,20976
46948,454256037,454277144,True,1,21107
46949,454256037,454293085,True,1,37048
46950,454306809,454318519,True,1,11710
46951,454330328,454334830,True,1,4502
46952,454341329,454341845,True,1,516
46953,454359665,454360087,True,6,422
46954,454384576,454395543,True,1,10967
46955,454422011,454424717,True,1,2706
46956,455162696,455164509,False,1,1813
46957,455196998,455255735,True,1,58737
46958,455401473,455403457,True,1,1984
46959,455401473,455429988,True,2,28515
46960,455502644,455515152,False,1,12508
46961,455502644,455521432,False,1,18788
46962,455502644,455521432,True,1,18788
46963,455502644,455585462,True,1,82818
46964,455543202,455545001,True,1,1799
46965,455739730,455740158,True,2,428
46966,455769599,455770016,False,1,417
46967,455832726,455835523,False,1,2797
46968,455832726,455836327,False,1,3601
46969,455832726,455862933,True,1,30207
46970,455839266,455839469,True,1,203
46971,455839266,455839517,True,1,251
46972,455845896,455858087,True,2,12191
46973,455845896,455869390,True,1,23494
46974,456006982,456007206,True,1,224
46975,456058809,456131962,True,1,73153
46976,456171967,456172863,False,1,896
46977,456218865,456221001,True,1,2136
46978,456221406,456234317,False,1,12911
46979,456345060,456346038,True,1,978
46980,456345060,456346343,True,1,1283
46981,456380009,456383258,True,5,3249
46982,456380009,456385206,True,1,5197
46983,456380009,456386999,False,1,6990
46984,456384468,456385619,True,1,1151
46985,456386898,456387713,True,1,815
46986,456386898,456388733,True,1,1835
46987,456389622,456405088,True,2,15466
46988,456423540,456428668,True,1,5128
46989,456455601,456457680,True,1,2079
46990,456540826,456555137,True,1,14311
46991,456540911,456555137,True,1,14226
46992,456541903,456555627,True,1,13724
46993,456541925,456555627,True,1,13702
46994,456577382,456577465,False,1,83
46995,456577382,456577465,True,1,83
46996,456588998,456589746,True,9,748
46997,456655644,456660994,True,1,5350
46998,456655992,456656751,True,1,759
46999,456655992,456661138,True,3,5146
47000,456664856,456665613,True,1,757
47001,456674191,456693148,True,4,18957
47002,456675122,456682853,True,1,7731
47003,456707286,456715819,True,1,8533
47004,456724561,456724641,True,1,80
47005,456783062,456792327,True,1,9265
47006,456786526,456789561,False,1,3035
47007,456791716,456795295,True,3,3579
47008,456930572,456930658,True,1,86
47009,456951177,456952459,True,1,1282
47010,456951177,456967958,True,1,16781
47011,457045129,457045294,True,1,165
47012,457081414,457084501,True,1,3087
47013,457100810,457101040,False,1,230
47014,457102214,457102805,True,1,591
47015,457103405,457103996,True,1,591
47016,457164329,457166022,True,2,1693
47017,457167982,457168076,True,1,94
47018,457192087,457192506,True,2,419
47019,457193450,457193562,True,1,112
47020,457350646,457351726,True,1,1080
47021,457357260,457358725,True,1,1465
47022,457357260,457358728,True,1,1468
47023,457472771,457477483,True,1,4712
47024,457472771,457486391,False,1,13620
47025,457472771,457486391,True,1,13620
47026,457561172,457566202,True,1,5030
47027,457561172,457653811,False,1,92639
47028,457691245,457700383,True,2,9138
47029,457691245,457725789,True,1,34544
47030,457742574,457744241,True,1,1667
47031,458813925,458829039,False,1,15114
47032,458813925,458829039,True,1,15114
47033,458813925,458838401,True,1,24476
47034,458917909,458919234,False,1,1325
47035,458917909,458919234,True,1,1325
47036,459134381,459134458,True,1,77
47037,459154830,459157702,True,1,2872
47038,459306485,459306914,True,1,429
47039,459459706,459466805,True,1,7099
47040,459473606,459480791,True,1,7185
47041,459524083,459525315,True,1,1232
47042,459524083,459525346,True,1,1263
47043,459779512,459909220,True,3,129708
47044,459779512,460024416,True,1,244904
47045,460387360,460507497,True,1,120137
47046,460406108,460516917,True,1,110809
47047,460406108,460541836,False,1,135728
47048,460445711,460453931,True,1,8220
47049,460624287,460653885,True,1,29598
47050,460796026,460796281,True,1,255
47051,460916757,460918445,True,1,1688
47052,461264395,461265259,True,4,864
47053,461322804,461323710,False,1,906
47054,461344614,461345000,True,1,386
47055,461556625,461573409,True,3,16784
47056,461574531,461584691,True,1,10160
47057,461574531,461628161,True,2,53630
47058,461628898,461629032,True,1,134
47059,461677346,461678208,True,2,862
47060,461766584,461774210,True,2,7626
47061,461766584,461781526,True,1,14942
47062,461801936,461810148,True,1,8212
47063,461821810,461824847,True,2,3037
47064,461948518,461951962,True,4,3444
47065,462021492,462021641,False,1,149
47066,462067597,462068979,True,2,1382
47067,462082628,462083440,True,4,812
47068,462084751,462086442,False,1,1691
47069,462084751,462086442,True,2,1691
47070,462088325,462088615,True,1,290
47071,462181062,462192240,False,1,11178
47072,462181062,462192240,True,6,11178
47073,462229847,462238886,True,2,9039
47074,462310575,462330368,True,1,19793
47075,462383909,462385363,True,1,1454
47076,462413672,462429302,True,1,15630
47077,462471304,462471933,True,1,629
47078,462561913,462563174,True,5,1261
47079,462561913,462588520,True,1,26607
47080,462563066,462563774,True,1,708
47081,462598432,462631788,True,1,33356
47082,462640826,462641664,True,1,838
47083,462719668,462720723,True,2,1055
47084,462720779,462721993,True,1,1214
47085,462724849,462724995,True,1,146
47086,462737905,462739916,True,1,2011
47087,462747375,462749209,True,1,1834
47088,462754120,462763623,True,2,9503
47089,462754120,462773169,True,1,19049
47090,462948031,462949194,True,3,1163
47091,463001717,463002809,True,2,1092
47092,463112583,463114899,False,1,2316
47093,463155501,463202228,True,1,46727
47094,463156779,463202934,True,1,46155
47095,463157035,463202934,True,1,45899
47096,463328970,463329397,False,1,427
47097,463328970,463329397,True,8,427
47098,463357575,463361213,True,1,3638
47099,463454583,463474784,True,1,20201
47100,463459480,463467750,True,2,8270
47101,463459480,463469953,True,1,10473
47102,463480848,463481895,True,1,1047
47103,463480848,463482438,True,1,1590
47104,463502944,463511371,False,1,8427
47105,463525240,463546385,False,1,21145
47106,463525240,463592130,False,7,66890
47107,463525240,463592130,True,25,66890
47108,463525240,463592134,True,1,66894
47109,463525240,463648230,True,1,122990
47110,463545057,463546367,False,1,1310
47111,463547853,463561923,True,1,14070
47112,463550147,463599824,True,1,49677
47113,463699907,463700779,False,1,872
47114,463722087,463725917,False,2,3830
47115,463722087,463725917,True,1,3830
47116,463805194,463808289,True,1,3095
47117,463812095,463817566,True,1,5471
47118,463843332,463847556,True,3,4224
47119,463947072,463951390,True,1,4318
47120,463947072,463961074,True,1,14002
47121,464126705,464134202,True,1,7497
47122,464126705,464134204,True,2,7499
47123,464520859,464522774,True,1,1915
47124,464639436,464639568,True,1,132
47125,464747190,464751372,True,1,4182
47126,464778006,464780702,True,1,2696
47127,465068730,465071847,True,2,3117
47128,465146695,465149290,True,2,2595
47129,465149501,465150546,True,1,1045
47130,465194889,465199041,True,1,4152
47131,465287642,465289205,False,1,1563
47132,465293037,465302885,True,1,9848
47133,465302409,465304424,True,3,2015
47134,465310246,465310804,False,1,558
47135,465317286,465319039,True,1,1753
47136,465573829,465576917,True,1,3088
47137,465580519,465580962,True,1,443
47138,465652767,465705835,False,1,53068
47139,465652767,465705835,True,2,53068
47140,465778026,465783673,False,1,5647
47141,466172859,466177670,True,1,4811
47142,466172859,466178460,False,1,5601
47143,466240104,466241717,True,2,1613
47144,466242167,466253876,True,1,11709
47145,466402613,466471963,False,1,69350
47146,466463011,466479945,False,1,16934
47147,466463109,466480043,False,1,16934
47148,466486935,466487026,True,1,91
47149,466543222,466543316,True,1,94
47150,466641808,466641889,True,1,81
47151,466642076,466642189,True,1,113
47152,466675233,466681499,True,1,6266
47153,466689498,466689643,True,3,145
47154,466770577,466771201,True,1,624
47155,466781846,466782106,False,1,260
47156,466781846,466782106,True,4,260
47157,466808948,466809136,True,3,188
47158,466830810,466836480,True,3,5670
47159,466928092,466945699,True,2,17607
47160,466941649,466998276,True,1,56627
47161,466996922,467025716,True,1,28794
47162,467023340,467023702,True,1,362
47163,467055116,467064474,True,1,9358
47164,467124116,467127307,False,3,3191
47165,467124116,467127307,True,3,3191
47166,467124116,467130146,True,2,6030
47167,467124116,467161877,True,1,37761
47168,467198322,467198989,False,1,667
47169,467258497,467259777,True,1,1280
47170,467264034,467266122,True,3,2088
47171,467264034,467266358,True,1,2324
47172,467351081,467352119,True,1,1038
47173,467470117,467475641,True,1,5524
47174,467487784,467489249,True,3,1465
47175,467500021,467552088,True,1,52067
47176,467518937,467544303,True,1,25366
47177,467531012,467531604,False,1,592
47178,467794963,467796205,True,1,1242
47179,467850357,467869078,True,2,18721
47180,468081554,468081951,True,1,397
47181,468320802,468324962,True,1,4160
47182,468320804,468324962,True,6,4158
47183,468432976,468434065,True,1,1089
47184,468432976,468434114,True,1,1138
47185,468432976,468441027,False,1,8051
47186,468456862,468457467,True,1,605
47187,468526472,468560053,True,1,33581
47188,468593812,468595846,True,1,2034
47189,468655953,468670910,True,1,14957
47190,468686155,468686438,True,1,283
47191,468693887,468697393,False,1,3506
47192,468698204,468698963,False,1,759
47193,468700336,468717177,True,1,16841
47194,468770313,468774011,True,2,3698
47195,468789035,468791295,True,1,2260
47196,468803506,468806711,True,1,3205
47197,468817085,468827217,True,1,10132
47198,468901922,468908658,True,1,6736
47199,469018637,469019187,True,1,550
47200,469019014,469019402,True,1,388
47201,469053498,469201968,True,2,148470
47202,469054549,469055218,True,1,669
47203,469091145,469220800,True,2,129655
47204,469161978,469256221,True,2,94243
47205,469182021,469266261,True,2,84240
47206,469200786,469202763,True,1,1977
47207,469204022,469277189,True,2,73167
47208,469244141,469297315,True,2,53174
47209,469255770,469303115,True,2,47345
47210,469276411,469313450,True,2,37039
47211,469313250,469332203,False,1,18953
47212,469326398,469326612,True,1,214
47213,469326398,469326749,False,1,351
47214,469329724,469330406,False,1,682
47215,469338715,469344596,True,2,5881
47216,469368772,469372358,False,1,3586
47217,469368772,469372360,False,1,3588
47218,469368772,469372684,False,1,3912
47219,469474625,469474734,True,1,109
47220,469483612,469483792,True,1,180
47221,469483612,469484205,True,1,593
47222,469483612,469484253,True,1,641
47223,469491783,469494738,True,3,2955
47224,469530549,469533748,False,1,3199
47225,469550085,469551060,True,1,975
47226,469564285,469573004,False,1,8719
47227,469652119,469661218,True,2,9099
47228,469676755,469677671,True,1,916
47229,469678698,469685307,True,1,6609
47230,469719617,469720756,False,1,1139
47231,469780976,469782112,False,1,1136
47232,469918860,469918958,True,1,98
47233,469918860,469926823,True,1,7963
47234,470186357,470186513,False,1,156
47235,470548080,470549738,True,1,1658
47236,470589809,470593462,False,2,3653
47237,470589809,470593462,True,1,3653
47238,470631882,470633996,True,1,2114
47239,470662176,470666140,True,3,3964
47240,470682175,470685845,True,1,3670
47241,470689580,470700798,True,1,11218
47242,470784325,470786051,True,1,1726
47243,470806165,470806339,True,1,174
47244,470981477,470989219,True,1,7742
47245,470983565,470990307,True,1,6742
47246,470983961,470990423,True,1,6462
47247,470983961,470996889,True,1,12928
47248,471061546,471074059,False,1,12513
47249,471061546,471074059,True,3,12513
47250,471061594,471074059,True,1,12465
47251,471224159,471226904,True,1,2745
47252,471257243,471262374,True,1,5131
47253,471426521,471458022,True,3,31501
47254,471583973,471585193,False,1,1220
47255,471650708,471651612,True,2,904
47256,471721441,471764572,True,1,43131
47257,471774890,471791291,True,1,16401
47258,471774957,471791273,True,1,16316
47259,471802747,471805573,True,1,2826
47260,471845170,471848289,False,2,3119
47261,471910306,471911682,True,1,1376
47262,471981958,471983146,False,1,1188
47263,471986431,471989583,True,1,3152
47264,472280419,472281424,True,3,1005
47265,472612167,472637835,True,1,25668
47266,472760297,472762551,True,1,2254
47267,472798982,472812467,True,1,13485
47268,472806225,473020553,True,3,214328
47269,473115484,473130193,True,1,14709
47270,473117675,473131229,True,1,13554
47271,473363097,473363235,True,1,138
47272,473373662,473374006,False,1,344
47273,473373662,473374006,True,2,344
47274,473374387,473376292,True,1,1905
47275,473378682,473390062,True,1,11380
47276,473426594,473427601,True,2,1007
47277,473532808,473533384,True,1,576
47278,473699868,473730925,True,3,31057
47279,473789146,473792263,True,1,3117
47280,473917617,473925306,True,4,7689
47281,473917617,473928022,False,1,10405
47282,473947697,473949838,True,1,2141
47283,474149386,474150085,True,1,699
47284,474149386,474150396,True,1,1010
47285,474207214,474208427,True,1,1213
47286,474292930,474296252,True,1,3322
47287,474411570,474639496,True,1,227926
47288,474466215,474472789,False,1,6574
47289,474466215,474472789,True,3,6574
47290,474938955,474940121,True,1,1166
47291,474956946,474967460,True,1,10514
47292,474988459,475021833,False,1,33374
47293,474988459,475027009,False,1,38550
47294,475676176,475681784,True,1,5608
47295,475772989,475776812,False,1,3823
47296,475780885,475783944,True,1,3059
47297,475910364,475910548,True,1,184
47298,475936831,475960873,False,1,24042
47299,475988768,475989456,True,1,688
47300,475988768,475989851,False,1,1083
47301,475988768,475989851,True,1,1083
47302,476050979,476051172,False,1,193
47303,476082845,476086838,True,1,3993
47304,476466111,476466855,True,4,744
47305,476505683,476505779,True,1,96
47306,476561239,476563312,True,2,2073
47307,476571401,476574970,True,1,3569
47308,476790433,476791091,True,1,658
47309,476791957,476797921,True,4,5964
47310,476838167,476838359,True,1,192
47311,476853962,476855222,True,1,1260
47312,476950532,476950869,True,1,337
47313,476966735,476966992,False,1,257
47314,476966735,476966992,True,1,257
47315,477072606,477153408,True,1,80802
47316,477201970,477217991,True,4,16021
47317,477288664,477292766,False,1,4102
47318,477356162,477356285,False,1,123
47319,477414891,477429620,True,1,14729
47320,477536556,477554050,True,1,17494
47321,477751360,477757318,False,2,5958
47322,477751360,477757318,True,5,5958
47323,477751360,477772189,True,1,20829
47324,477754985,477759166,True,1,4181
47325,477939348,477942560,True,3,3212
47326,478018304,478019530,True,1,1226
47327,478033045,478050340,True,1,17295
47328,478072199,478072291,True,1,92
47329,478094761,478096686,True,1,1925
47330,478145456,478145541,True,1,85
47331,478148558,478149828,True,1,1270
47332,478158359,478158624,False,1,265
47333,478158359,478158624,True,4,265
47334,478181532,478182997,True,1,1465
47335,478267893,478270076,True,1,2183
47336,478269006,478270076,False,1,1070
47337,478294799,478295033,True,2,234
47338,478295119,478295210,True,1,91
47339,478307843,478310379,True,1,2536
47340,478315167,478316504,True,1,1337
47341,478340660,478341012,True,1,352
47342,478340847,478341199,True,1,352
47343,478458610,478463129,True,2,4519
47344,478671385,478677818,True,1,6433
47345,478718664,478718697,False,1,33
47346,478839917,478879380,False,1,39463
47347,479100391,479205871,False,1,105480
47348,479514046,479552090,True,1,38044
47349,479514046,479588649,True,1,74603
47350,479585211,479587894,True,1,2683
47351,479682209,479682419,False,1,210
47352,479944695,479945017,True,2,322
47353,480023183,480028075,True,1,4892
47354,480033063,480040781,True,3,7718
47355,480096541,480104090,False,1,7549
47356,480341960,480346743,False,1,4783
47357,480512208,480541661,True,2,29453
47358,480817424,480829802,True,1,12378
47359,480817424,480900933,True,1,83509
47360,481000612,481004705,True,1,4093
47361,481243536,481255745,False,1,12209
47362,481309648,481428054,True,1,118406
47363,481369179,481386549,True,1,17370
47364,481797391,481826277,True,1,28886
47365,481846067,481852422,True,1,6355
47366,481863131,481895492,True,1,32361
47367,481878329,481889499,False,1,11170
47368,481878329,481902755,True,4,24426
47369,481878329,481903569,True,1,25240
47370,481878329,481905018,True,1,26689
47371,481905411,481909102,True,1,3691
47372,481915882,481918438,True,1,2556
47373,481938252,481940689,True,1,2437
47374,482132336,482135305,True,1,2969
47375,482140746,482143589,True,1,2843
47376,482157216,482157922,True,1,706
47377,482750615,482773559,True,1,22944
47378,482779583,482784847,True,1,5264
47379,482837910,482839190,True,6,1280
47380,482925228,482926530,True,2,1302
47381,482984639,482986446,True,1,1807
47382,482999964,483000215,True,2,251
47383,483016534,483019841,True,1,3307
47384,483029945,483030901,True,1,956
47385,483052601,483054890,False,3,2289
47386,483052601,483054890,True,5,2289
47387,483052601,483063435,True,1,10834
47388,483089811,483090626,True,2,815
47389,483129646,483134025,True,1,4379
47390,483231995,483232848,False,1,853
47391,483231995,483235601,True,1,3606
47392,483262598,483262888,False,1,290
47393,483262714,483262750,True,1,36
47394,483310003,483310645,True,4,642
47395,483322126,483324591,True,1,2465
47396,483325804,483326219,True,1,415
47397,483391231,483407560,True,3,16329
47398,483514444,483517497,False,2,3053
47399,483514444,483517497,True,1,3053
47400,483616608,483616746,True,2,138
47401,483631510,483639409,True,1,7899
47402,483633378,483633766,True,1,388
47403,483652043,483653171,True,3,1128
47404,483693791,483697549,True,1,3758
47405,483701659,483725864,True,1,24205
47406,483788951,483789295,False,1,344
47407,483844033,483846245,True,1,2212
47408,483876721,483907953,True,1,31232
47409,484005911,484006221,True,1,310
47410,484006970,484007686,True,1,716
47411,484009725,484011891,True,1,2166
47412,484021955,484022029,True,1,74
47413,484023147,484023523,True,2,376
47414,484024361,484025741,True,2,1380
47415,484070397,484071200,True,2,803
47416,484073178,484075145,True,1,1967
47417,484091651,484092279,True,6,628
47418,484107641,484107750,True,2,109
47419,484178146,484181912,True,1,3766
47420,484179863,484182790,True,2,2927
47421,484179863,484187121,True,1,7258
47422,484256104,484257393,True,2,1289
47423,484318478,484320605,True,1,2127
47424,484335783,484335927,True,3,144
47425,484385342,484386894,True,1,1552
47426,484505100,484515656,True,4,10556
47427,484509747,484511634,True,1,1887
47428,484509747,484518351,True,1,8604
47429,484510677,484511115,True,2,438
47430,484510677,484511123,False,1,446
47431,484510677,484514896,True,1,4219
47432,484510677,484518909,True,1,8232
47433,484591466,484608160,True,3,16694
47434,484869237,484869932,True,9,695
47435,484873020,484873101,True,1,81
47436,484878901,484879358,True,1,457
47437,484968059,484981990,True,1,13931
47438,484996553,484997013,True,1,460
47439,485024560,485024639,False,1,79
47440,485047959,485065128,True,2,17169
47441,485154165,485167449,True,6,13284
47442,485185906,485186840,True,1,934
47443,485230808,485233021,False,2,2213
47444,485230808,485233021,True,2,2213
47445,485282972,485285521,True,2,2549
47446,485348139,485348575,False,2,436
47447,485348139,485348575,True,1,436
47448,485348139,485354475,True,1,6336
47449,485376827,485377968,False,1,1141
47450,485379096,485380046,True,1,950
47451,485432638,485454717,True,1,22079
47452,485499869,485500966,False,1,1097
47453,485500528,485505833,True,1,5305
47454,485500528,485505836,True,1,5308
47455,485504585,485506498,True,1,1913
47456,485504585,485507703,True,1,3118
47457,485504585,485507706,True,1,3121
47458,485585481,485586131,False,1,650
47459,485585481,485586131,True,2,650
47460,485623951,485625749,True,1,1798
47461,485826265,485826357,False,1,92
47462,486061795,486067879,False,4,6084
47463,486129043,486145370,False,1,16327
47464,486440187,486440279,False,1,92
47465,486577243,486577720,True,1,477
47466,486577769,486579278,True,4,1509
47467,486749780,486759538,True,1,9758
47468,486838848,486852711,True,1,13863
47469,486838848,486868878,True,2,30030
47470,486899272,486917586,True,1,18314
47471,486912913,486913091,True,1,178
47472,487303286,487314571,True,1,11285
47473,487326108,487338644,True,1,12536
47474,487331656,487338644,True,1,6988
47475,488161531,488222413,False,1,60882
47476,488424535,488429328,True,1,4793
47477,488429306,488431648,True,1,2342
47478,488434874,488434985,True,1,111
47479,489031972,489043924,True,3,11952
47480,489144733,489146380,True,1,1647
47481,489172354,489173389,False,1,1035
47482,489235593,489238471,True,1,2878
47483,489249468,489251880,True,2,2412
47484,489249468,489265513,True,2,16045
47485,489633008,489666248,True,2,33240
47486,489997696,490003882,False,1,6186
47487,489997696,490003882,True,1,6186
47488,489997696,490004133,False,1,6437
47489,490012585,490013843,False,1,1258
47490,490031406,490031874,True,3,468
47491,490266515,490266799,True,1,284
47492,490267028,490298704,True,1,31676
47493,490267375,490299051,True,1,31676
47494,490267375,490314172,True,1,46797
47495,490267375,490356316,False,1,88941
47496,490637075,490637868,True,2,793
47497,491034197,491047113,True,1,12916
47498,491348733,491378370,True,1,29637
47499,491618975,491656926,True,1,37951
47500,491825607,491839982,True,3,14375
47501,493359472,493360339,False,1,867
47502,493408366,493411683,True,1,3317
47503,493423755,493426359,False,1,2604
47504,493459603,493484450,True,1,24847
47505,493459729,493484450,True,1,24721
47506,493775291,493777569,True,1,2278
47507,493879718,493882998,False,1,3280
47508,493905918,493906664,False,1,746
47509,494006701,494008395,True,1,1694
47510,494006701,494009496,True,1,2795
47511,494027660,494028121,False,1,461
47512,494217977,494239843,False,3,21866
47513,494217977,494239843,True,1,21866
47514,494263943,494282384,False,1,18441
47515,494300181,494311272,True,1,11091
47516,494302983,494314074,True,1,11091
47517,494399665,494400049,True,1,384
47518,494399668,494400049,True,1,381
47519,494527884,494528294,True,2,410
47520,494572449,494587292,False,1,14843
47521,494572449,494607582,True,1,35133
47522,494603505,494623752,True,1,20247
47523,494639721,494641508,True,1,1787
47524,494640426,494642027,True,1,1601
47525,494676456,494676667,False,1,211
47526,494838881,494838883,True,1,2
47527,494928199,494935396,True,2,7197
47528,494933136,494937552,True,1,4416
47529,494947365,494960061,True,1,12696
47530,495158952,495160810,True,1,1858
47531,495158952,495160986,True,1,2034
47532,495163733,495167884,True,5,4151
47533,495340928,495360633,False,4,19705
47534,495377215,495377650,False,1,435
47535,495389275,495390240,True,1,965
47536,495424868,495432053,True,1,7185
47537,496041468,496044417,True,1,2949
47538,496062629,496070464,True,1,7835
47539,496201178,496362443,True,1,161265
47540,497764055,497766516,False,1,2461
47541,498211219,498211836,True,3,617
47542,498265279,498271209,True,1,5930
47543,498288917,498289081,True,6,164
47544,498400982,498408454,True,3,7472
