,start_coord,end_coord,translation_status,dataset,count,length
0,7982,15502,Non coding,IonXpress_NONO_c,2,7520
1,7982,15502,Non coding,IonXpress_SFPQt1,5,7520
2,8472,13448,Non coding,IonXpress_NONO_c,2,4976
3,8472,13448,Non coding,IonXpress_SFPQt1,4,4976
4,11231,13977,Non coding,IonXpress_NONO_c,1,2746
5,11231,13977,Non coding,IonXpress_SFPQt1,3,2746
6,1229309,1230799,Protein coding,IonXpress_NONO_c,10,1490
7,1230979,1245904,Protein coding,IonXpress_NONO_c,10,14925
8,1246087,1262889,Protein coding,IonXpress_NONO_c,10,16802
9,1263059,1279634,Protein coding,IonXpress_NONO_c,10,16575
10,1279787,1284192,Protein coding,IonXpress_NONO_c,10,4405
11,1284362,1313148,Protein coding,IonXpress_NONO_c,10,28786
12,1313264,1405221,Protein coding,IonXpress_NONO_c,10,91957
13,1406112,1421267,Protein coding,IonXpress_NONO_c,10,15155
14,1421355,1779243,Protein coding,IonXpress_NONO_c,10,357888
15,1801663,1802433,Protein coding,IonXpress_NONO_c,1,770
16,1802488,1814451,Protein coding,IonXpress_NONO_c,1,11963
17,1814575,1815963,Protein coding,IonXpress_NONO_c,1,1388
18,2227668,2227796,Protein coding,IonXpress_SFPQt1,1,128
19,2227872,2227981,Protein coding,IonXpress_SFPQt1,1,109
20,2228123,2228596,Protein coding,IonXpress_SFPQt1,1,473
21,2228714,2232635,Protein coding,IonXpress_SFPQt1,1,3921
22,2232769,2233807,Protein coding,IonXpress_SFPQt1,1,1038
23,2233919,2234239,Protein coding,IonXpress_SFPQt1,1,320
24,2234403,2235461,Protein coding,IonXpress_SFPQt1,1,1058
25,2235653,2236253,Protein coding,IonXpress_SFPQt1,1,600
26,2236418,2236849,Protein coding,IonXpress_SFPQt1,1,431
27,2237010,2237764,Protein coding,IonXpress_SFPQt1,1,754
28,2238190,2238552,Protein coding,IonXpress_SFPQt1,1,362
29,2238688,2238803,Protein coding,IonXpress_SFPQt1,1,115
30,2239024,2239329,Protein coding,IonXpress_SFPQt1,1,305
31,2239434,2239623,Protein coding,IonXpress_SFPQt1,1,189
32,2241039,2246837,Protein coding,IonXpress_SFPQt1,3,5798
33,2246914,2264929,Protein coding,IonXpress_SFPQt1,3,18015
34,2265093,2265401,Protein coding,IonXpress_SFPQt1,3,308
35,2265564,2266130,Protein coding,IonXpress_SFPQt1,3,566
36,2266199,2266281,Protein coding,IonXpress_SFPQt1,3,82
37,2266428,2266757,Protein coding,IonXpress_SFPQt1,3,329
38,2266893,2267351,Protein coding,IonXpress_SFPQt1,3,458
39,2267477,2267888,Protein coding,IonXpress_SFPQt1,3,411
40,2267957,2268189,Protein coding,IonXpress_SFPQt1,3,232
41,2268351,2268507,Protein coding,IonXpress_SFPQt1,3,156
42,2268635,2270563,Protein coding,IonXpress_SFPQt1,1,1928
43,2268635,2274554,Protein coding,IonXpress_SFPQt1,2,5919
44,2270699,2274554,Protein coding,IonXpress_SFPQt1,1,3855
45,2274709,2275482,Protein coding,IonXpress_SFPQt1,3,773
46,2275548,2275635,Protein coding,IonXpress_SFPQt1,3,87
47,2275782,2276245,Protein coding,IonXpress_SFPQt1,3,463
48,2276375,2276623,Protein coding,IonXpress_SFPQt1,3,248
49,2276807,2278784,Protein coding,IonXpress_SFPQt1,3,1977
50,2279169,2279429,Protein coding,IonXpress_SFPQt1,3,260
51,2279555,2280025,Protein coding,IonXpress_SFPQt1,3,470
52,2280109,2280251,Protein coding,IonXpress_SFPQt1,4,142
53,2280362,2281149,Protein coding,IonXpress_SFPQt1,4,787
54,2281247,2282328,Protein coding,IonXpress_SFPQt1,4,1081
55,2282497,2282724,Protein coding,IonXpress_SFPQt1,3,227
56,2282497,2283557,Protein coding,IonXpress_SFPQt1,1,1060
57,2620376,2638589,Non coding,IonXpress_SFPQt1,5,18213
58,2633309,2633486,Non coding,IonXpress_SFPQt1,3,177
59,2633309,2633486,Protein coding,IonXpress_SFPQt1,3,177
60,2633577,2633923,Non coding,IonXpress_SFPQt1,3,346
61,2633577,2633923,Protein coding,IonXpress_SFPQt1,3,346
62,2633819,2633923,Protein coding,IonXpress_SFPQt1,3,104
63,2634039,2635058,Non coding,IonXpress_SFPQt1,3,1019
64,2634039,2635058,Protein coding,IonXpress_SFPQt1,6,1019
65,2635221,2635393,Non coding,IonXpress_SFPQt1,3,172
66,2635221,2635393,Protein coding,IonXpress_SFPQt1,6,172
67,2635593,2635969,Non coding,IonXpress_SFPQt1,3,376
68,2635593,2635969,Protein coding,IonXpress_SFPQt1,6,376
69,2636158,2636239,Non coding,IonXpress_SFPQt1,3,81
70,2636158,2636239,Protein coding,IonXpress_SFPQt1,6,81
71,2636392,2636578,Non coding,IonXpress_SFPQt1,3,186
72,2636392,2636578,Protein coding,IonXpress_SFPQt1,6,186
73,2636680,2637045,Protein coding,IonXpress_SFPQt1,6,365
74,2636860,2637045,Non coding,IonXpress_SFPQt1,3,185
75,2637195,2637418,Non coding,IonXpress_SFPQt1,3,223
76,2637195,2637418,Protein coding,IonXpress_SFPQt1,6,223
77,2637541,2637725,Non coding,IonXpress_SFPQt1,3,184
78,2637541,2637725,Protein coding,IonXpress_SFPQt1,6,184
79,2637864,2638573,Non coding,IonXpress_SFPQt1,3,709
80,2637864,2638573,Protein coding,IonXpress_SFPQt1,6,709
81,2638632,2642755,Non coding,IonXpress_SFPQt1,5,4123
82,2642780,2655034,Non coding,IonXpress_SFPQt1,2,12254
83,2642780,2709067,Non coding,IonXpress_SFPQt1,1,66287
84,2642780,2713685,Non coding,IonXpress_SFPQt1,1,70905
85,2655094,2655519,Non coding,IonXpress_SFPQt1,1,425
86,2670376,2670937,Non coding,IonXpress_SFPQt1,1,561
87,2670376,2688589,Protein coding,IonXpress_SFPQt1,2,18213
88,2671041,2688589,Non coding,IonXpress_SFPQt1,1,17548
89,2688632,2692755,Non coding,IonXpress_SFPQt1,1,4123
90,2688632,2692755,Protein coding,IonXpress_SFPQt1,2,4123
91,2692780,2700105,Non coding,IonXpress_SFPQt1,1,7325
92,2692780,2700105,Protein coding,IonXpress_SFPQt1,2,7325
93,2700169,2707683,Non coding,IonXpress_SFPQt1,1,7514
94,2700169,2707683,Protein coding,IonXpress_SFPQt1,2,7514
95,2707747,2712574,Protein coding,IonXpress_SFPQt1,2,4827
96,2709124,2709525,Non coding,IonXpress_SFPQt1,1,401
97,2709668,2710204,Non coding,IonXpress_SFPQt1,1,536
98,2710283,2712116,Non coding,IonXpress_SFPQt1,1,1833
99,2712298,2713685,Non coding,IonXpress_SFPQt1,1,1387
100,2712644,2715349,Protein coding,IonXpress_SFPQt1,2,2705
101,2713784,2722639,Non coding,IonXpress_SFPQt1,1,8855
102,2715401,2724740,Protein coding,IonXpress_SFPQt1,1,9339
103,2715401,2726224,Protein coding,IonXpress_SFPQt1,1,10823
104,2724786,2726224,Protein coding,IonXpress_SFPQt1,1,1438
105,2726261,2729375,Protein coding,IonXpress_SFPQt1,2,3114
106,2729493,2732403,Protein coding,IonXpress_SFPQt1,2,2910
107,6714812,6737621,Protein coding,IonXpress_NONO_c,2,22809
108,6737746,6738794,Protein coding,IonXpress_NONO_c,2,1048
109,6738842,6739843,Protein coding,IonXpress_NONO_c,2,1001
110,6739965,6742601,Protein coding,IonXpress_NONO_c,2,2636
111,6742710,6743823,Protein coding,IonXpress_NONO_c,2,1113
112,6743953,6746325,Protein coding,IonXpress_NONO_c,2,2372
113,6746540,6748575,Protein coding,IonXpress_NONO_c,2,2035
114,6748703,6749668,Protein coding,IonXpress_NONO_c,2,965
115,6749770,6750442,Protein coding,IonXpress_NONO_c,2,672
116,6750616,6751150,Protein coding,IonXpress_NONO_c,2,534
117,6751310,6752984,Protein coding,IonXpress_NONO_c,2,1674
118,6753150,6754862,Protein coding,IonXpress_NONO_c,1,1712
119,6753150,6754865,Protein coding,IonXpress_NONO_c,1,1715
120,7194853,7398013,Protein coding,IonXpress_SFPQt1,1,203160
121,7383719,7398013,Protein coding,IonXpress_SFPQt1,1,14294
122,7398082,7533255,Protein coding,IonXpress_SFPQt1,2,135173
123,7533356,7640053,Protein coding,IonXpress_SFPQt1,2,106697
124,7640219,7655859,Protein coding,IonXpress_SFPQt1,2,15640
125,7655934,7663225,Protein coding,IonXpress_SFPQt1,2,7291
126,7663291,7666078,Protein coding,IonXpress_SFPQt1,2,2787
127,7666198,7668849,Protein coding,IonXpress_SFPQt1,2,2651
128,7668940,7677775,Protein coding,IonXpress_SFPQt1,2,8835
129,7677956,7684468,Protein coding,IonXpress_SFPQt1,2,6512
130,7684616,7691211,Protein coding,IonXpress_SFPQt1,2,6595
131,7691315,7698923,Protein coding,IonXpress_SFPQt1,2,7608
132,7699001,7705005,Protein coding,IonXpress_SFPQt1,2,6004
133,7705098,7705902,Protein coding,IonXpress_SFPQt1,2,804
134,7706011,7714458,Protein coding,IonXpress_SFPQt1,2,8447
135,7714580,7715965,Protein coding,IonXpress_SFPQt1,2,1385
136,7716100,7716908,Protein coding,IonXpress_SFPQt1,2,808
137,7717038,7719737,Protein coding,IonXpress_SFPQt1,2,2699
138,7719910,7725422,Protein coding,IonXpress_SFPQt1,2,5512
139,7725610,7726879,Protein coding,IonXpress_SFPQt1,2,1269
140,7727014,7728505,Protein coding,IonXpress_SFPQt1,2,1491
141,7728630,7730075,Protein coding,IonXpress_SFPQt1,2,1445
142,7730189,7731312,Protein coding,IonXpress_SFPQt1,2,1123
143,7731439,7735047,Protein coding,IonXpress_SFPQt1,2,3608
144,7735148,7735997,Protein coding,IonXpress_SFPQt1,2,849
145,7736101,7738791,Protein coding,IonXpress_SFPQt1,1,2690
146,7736101,7738794,Protein coding,IonXpress_SFPQt1,1,2693
147,7738899,7741925,Protein coding,IonXpress_SFPQt1,1,3026
148,7738941,7741925,Protein coding,IonXpress_SFPQt1,1,2984
149,8077590,8077836,Protein coding,IonXpress_NONO_c,2,246
150,8077590,8077857,Protein coding,IonXpress_NONO_c,1,267
151,8077590,8079516,Non coding,IonXpress_NONO_c,1,1926
152,8077934,8079073,Protein coding,IonXpress_NONO_c,3,1139
153,8079175,8079275,Protein coding,IonXpress_NONO_c,1,100
154,8079193,8079275,Protein coding,IonXpress_NONO_c,2,82
155,8079344,8079516,Protein coding,IonXpress_NONO_c,3,172
156,10217088,10217175,Protein coding,IonXpress_SFPQt1,3,87
157,10217347,10218179,Protein coding,IonXpress_SFPQt1,3,832
158,10218282,10218478,Protein coding,IonXpress_SFPQt1,3,196
159,10218530,10218638,Protein coding,IonXpress_SFPQt1,3,108
160,10218810,10220305,Protein coding,IonXpress_SFPQt1,3,1495
161,10220383,10220587,Protein coding,IonXpress_SFPQt1,3,204
162,10220696,10220797,Protein coding,IonXpress_SFPQt1,3,101
163,10220922,10220998,Protein coding,IonXpress_SFPQt1,3,76
164,10221078,10221159,Protein coding,IonXpress_SFPQt1,3,81
165,10221290,10221371,Protein coding,IonXpress_SFPQt1,3,81
166,10221542,10221619,Protein coding,IonXpress_SFPQt1,3,77
167,10221698,10224307,Protein coding,IonXpress_SFPQt1,1,2609
168,10221760,10224307,Protein coding,IonXpress_SFPQt1,1,2547
169,12626156,12626344,Protein coding,IonXpress_NONO_c,2,188
170,12626480,12626619,Protein coding,IonXpress_NONO_c,2,139
171,12626752,12627178,Protein coding,IonXpress_NONO_c,2,426
172,12627298,12629088,Protein coding,IonXpress_NONO_c,2,1790
173,12629136,12632295,Protein coding,IonXpress_NONO_c,2,3159
174,12632473,12633205,Protein coding,IonXpress_NONO_c,2,732
175,12633291,12641188,Protein coding,IonXpress_NONO_c,2,7897
176,12641307,12641649,Protein coding,IonXpress_NONO_c,2,342
177,12641778,12641885,Protein coding,IonXpress_NONO_c,2,107
178,12641914,12645633,Protein coding,IonXpress_NONO_c,2,3719
179,12645788,12647698,Protein coding,IonXpress_NONO_c,2,1910
180,12647798,12650263,Protein coding,IonXpress_NONO_c,2,2465
181,12650422,12650730,Protein coding,IonXpress_NONO_c,2,308
182,12650834,12653447,Protein coding,IonXpress_NONO_c,1,2613
183,12650834,12660012,Protein coding,IonXpress_NONO_c,1,9178
184,12653561,12660012,Protein coding,IonXpress_NONO_c,1,6451
185,12660246,12705310,Protein coding,IonXpress_NONO_c,2,45064
186,12696381,12696954,Protein coding,IonXpress_NONO_c,1,573
187,12697108,12785724,Protein coding,IonXpress_NONO_c,1,88616
188,12785981,12883795,Protein coding,IonXpress_NONO_c,1,97814
189,12883861,12886383,Protein coding,IonXpress_NONO_c,1,2522
190,12886447,12901253,Protein coding,IonXpress_NONO_c,1,14806
191,12901389,12902550,Protein coding,IonXpress_NONO_c,1,1161
192,12902598,12903441,Protein coding,IonXpress_NONO_c,1,843
193,12903504,12904546,Protein coding,IonXpress_NONO_c,1,1042
194,12904672,12923485,Protein coding,IonXpress_NONO_c,1,18813
195,12923660,12946457,Protein coding,IonXpress_NONO_c,1,22797
196,12946599,12951719,Protein coding,IonXpress_NONO_c,1,5120
197,12951873,12958654,Protein coding,IonXpress_NONO_c,1,6781
198,15399918,15456269,Non coding,IonXpress_NONO_c,4,56351
199,15399918,15456269,Non coding,IonXpress_SFPQt1,4,56351
200,15456465,15515828,Non coding,IonXpress_NONO_c,2,59363
201,15456465,15515828,Non coding,IonXpress_SFPQt1,2,59363
202,15456465,15516076,Non coding,IonXpress_NONO_c,2,59611
203,15456465,15516076,Non coding,IonXpress_SFPQt1,2,59611
204,16342343,16342639,Non coding,IonXpress_NONO_c,4,296
205,16342343,16342639,Non coding,IonXpress_SFPQt1,4,296
206,16342374,16342639,Non coding,IonXpress_NONO_c,36,265
207,16342374,16342639,Non coding,IonXpress_SFPQt1,38,265
208,16342374,16343497,Non coding,IonXpress_NONO_c,2,1123
209,16342374,16343497,Non coding,IonXpress_SFPQt1,2,1123
210,16342707,16343497,Non coding,IonXpress_NONO_c,2,790
211,16342707,16343497,Non coding,IonXpress_SFPQt1,2,790
212,16342728,16342840,Non coding,IonXpress_NONO_c,4,112
213,16342728,16342840,Non coding,IonXpress_SFPQt1,5,112
214,16342728,16342893,Non coding,IonXpress_NONO_c,6,165
215,16342728,16342893,Non coding,IonXpress_SFPQt1,6,165
216,16342728,16342972,Non coding,IonXpress_NONO_c,6,244
217,16342728,16342972,Non coding,IonXpress_SFPQt1,6,244
218,16342728,16342972,Protein coding,IonXpress_NONO_c,4,244
219,16342728,16342972,Protein coding,IonXpress_SFPQt1,5,244
220,16342728,16343423,Non coding,IonXpress_NONO_c,2,695
221,16342728,16343423,Non coding,IonXpress_SFPQt1,2,695
222,16342728,16343497,Non coding,IonXpress_NONO_c,20,769
223,16342728,16343497,Non coding,IonXpress_SFPQt1,21,769
224,16343017,16343423,Non coding,IonXpress_NONO_c,2,406
225,16343017,16343423,Non coding,IonXpress_SFPQt1,2,406
226,16343017,16343497,Non coding,IonXpress_NONO_c,14,480
227,16343017,16343497,Non coding,IonXpress_SFPQt1,15,480
228,16343017,16343497,Protein coding,IonXpress_NONO_c,4,480
229,16343017,16343497,Protein coding,IonXpress_SFPQt1,5,480
230,16343567,16344386,Non coding,IonXpress_NONO_c,30,819
231,16343567,16344386,Non coding,IonXpress_SFPQt1,32,819
232,16343567,16344386,Protein coding,IonXpress_NONO_c,2,819
233,16343567,16344386,Protein coding,IonXpress_SFPQt1,2,819
234,16343567,16344680,Non coding,IonXpress_NONO_c,8,1113
235,16343567,16344680,Non coding,IonXpress_SFPQt1,8,1113
236,16343567,16344680,Protein coding,IonXpress_NONO_c,2,1113
237,16343567,16344680,Protein coding,IonXpress_SFPQt1,2,1113
238,16343567,16364205,Non coding,IonXpress_NONO_c,2,20638
239,16343567,16364205,Non coding,IonXpress_SFPQt1,2,20638
240,16343567,16373614,Non coding,IonXpress_NONO_c,2,30047
241,16343567,16373614,Non coding,IonXpress_SFPQt1,2,30047
242,16344444,16344680,Non coding,IonXpress_NONO_c,16,236
243,16344444,16344680,Non coding,IonXpress_SFPQt1,16,236
244,16344444,16344680,Protein coding,IonXpress_NONO_c,2,236
245,16344444,16344680,Protein coding,IonXpress_SFPQt1,2,236
246,16344444,16366145,Non coding,IonXpress_NONO_c,8,21701
247,16344444,16366145,Non coding,IonXpress_SFPQt1,8,21701
248,16344444,16373614,Non coding,IonXpress_NONO_c,6,29170
249,16344444,16373614,Non coding,IonXpress_SFPQt1,6,29170
250,16364559,16366145,Non coding,IonXpress_NONO_c,2,1586
251,16364559,16366145,Non coding,IonXpress_SFPQt1,2,1586
252,16366255,16366476,Non coding,IonXpress_NONO_c,4,221
253,16366255,16366476,Non coding,IonXpress_SFPQt1,4,221
254,16366255,16366479,Non coding,IonXpress_NONO_c,6,224
255,16366255,16366479,Non coding,IonXpress_SFPQt1,6,224
256,16366561,16373614,Non coding,IonXpress_NONO_c,4,7053
257,16366561,16373614,Non coding,IonXpress_SFPQt1,4,7053
258,16366631,16373614,Non coding,IonXpress_NONO_c,6,6983
259,16366631,16373614,Non coding,IonXpress_SFPQt1,6,6983
260,16594058,16596291,Protein coding,IonXpress_SFPQt1,1,2233
261,16596363,16608463,Protein coding,IonXpress_SFPQt1,1,12100
262,16608713,16610781,Protein coding,IonXpress_SFPQt1,1,2068
263,16610856,16612108,Protein coding,IonXpress_SFPQt1,1,1252
264,16610856,16614991,Protein coding,IonXpress_SFPQt1,1,4135
265,16612949,16614991,Protein coding,IonXpress_SFPQt1,1,2042
266,16615129,16623510,Non coding,IonXpress_SFPQt1,1,8381
267,16615129,16623510,Protein coding,IonXpress_SFPQt1,2,8381
268,16623545,16623829,Non coding,IonXpress_SFPQt1,1,284
269,16623545,16623829,Protein coding,IonXpress_SFPQt1,2,284
270,16623972,16630839,Non coding,IonXpress_SFPQt1,1,6867
271,16623972,16630839,Protein coding,IonXpress_SFPQt1,2,6867
272,16631054,16635112,Non coding,IonXpress_SFPQt1,1,4058
273,16631054,16635112,Protein coding,IonXpress_SFPQt1,2,4058
274,16635297,16635850,Non coding,IonXpress_SFPQt1,1,553
275,16635297,16635850,Protein coding,IonXpress_SFPQt1,2,553
276,16635980,16638002,Non coding,IonXpress_SFPQt1,1,2022
277,16635980,16638002,Protein coding,IonXpress_SFPQt1,2,2022
278,16638957,16640850,Protein coding,IonXpress_SFPQt1,1,1893
279,16638957,16664737,Non coding,IonXpress_SFPQt1,1,25780
280,16638957,16664737,Protein coding,IonXpress_SFPQt1,1,25780
281,16640989,16664737,Protein coding,IonXpress_SFPQt1,1,23748
282,16665032,16665625,Non coding,IonXpress_SFPQt1,1,593
283,16665032,16665625,Protein coding,IonXpress_SFPQt1,2,593
284,16665847,16667277,Non coding,IonXpress_SFPQt1,1,1430
285,16665847,16667277,Protein coding,IonXpress_SFPQt1,2,1430
286,16667489,16675289,Non coding,IonXpress_SFPQt1,1,7800
287,16667489,16675289,Protein coding,IonXpress_SFPQt1,1,7800
288,16675333,16675912,Protein coding,IonXpress_SFPQt1,1,579
289,16675333,16676809,Non coding,IonXpress_SFPQt1,1,1476
290,16676023,16676809,Protein coding,IonXpress_SFPQt1,1,786
291,16677596,16686935,Non coding,IonXpress_SFPQt1,1,9339
292,16687047,16687735,Non coding,IonXpress_SFPQt1,1,688
293,16687794,16690260,Non coding,IonXpress_SFPQt1,1,2466
294,16690436,16691247,Non coding,IonXpress_SFPQt1,1,811
295,16691449,16699355,Non coding,IonXpress_SFPQt1,1,7906
296,16699548,16701554,Non coding,IonXpress_SFPQt1,1,2006
297,16701844,16703263,Non coding,IonXpress_SFPQt1,1,1419
298,16703685,16704348,Non coding,IonXpress_SFPQt1,1,663
299,16704442,16705571,Non coding,IonXpress_SFPQt1,1,1129
300,16860704,16860919,Non coding,IonXpress_SFPQt1,1,215
301,17066892,17256779,Protein coding,IonXpress_NONO_c,1,189887
302,17066892,17256779,Protein coding,IonXpress_SFPQt1,3,189887
303,17199602,17200216,Non coding,IonXpress_NONO_c,1,614
304,17256842,17256922,Protein coding,IonXpress_NONO_c,1,80
305,17256842,17256922,Protein coding,IonXpress_SFPQt1,3,80
306,17257089,17263130,Protein coding,IonXpress_NONO_c,1,6041
307,17257089,17263130,Protein coding,IonXpress_SFPQt1,3,6041
308,17263368,17264134,Protein coding,IonXpress_NONO_c,1,766
309,17263368,17264134,Protein coding,IonXpress_SFPQt1,3,766
310,17264232,17264893,Protein coding,IonXpress_NONO_c,1,661
311,17264232,17264893,Protein coding,IonXpress_SFPQt1,3,661
312,17264978,17265402,Protein coding,IonXpress_NONO_c,1,424
313,17264978,17265402,Protein coding,IonXpress_SFPQt1,3,424
314,17265637,17266387,Protein coding,IonXpress_NONO_c,1,750
315,17265637,17266387,Protein coding,IonXpress_SFPQt1,3,750
316,17266588,17267265,Protein coding,IonXpress_NONO_c,1,677
317,17266588,17267265,Protein coding,IonXpress_SFPQt1,3,677
318,17923051,17923752,Protein coding,IonXpress_SFPQt1,3,701
319,17923839,17928128,Protein coding,IonXpress_SFPQt1,3,4289
320,17928289,17929532,Protein coding,IonXpress_SFPQt1,4,1243
321,17929620,17929706,Protein coding,IonXpress_SFPQt1,4,86
322,17929747,17930774,Protein coding,IonXpress_SFPQt1,4,1027
323,17930851,17930933,Protein coding,IonXpress_SFPQt1,4,82
324,17931040,17932142,Protein coding,IonXpress_SFPQt1,4,1102
325,17932239,17933229,Protein coding,IonXpress_SFPQt1,4,990
326,17933354,17934638,Protein coding,IonXpress_SFPQt1,4,1284
327,17934761,17936007,Protein coding,IonXpress_SFPQt1,4,1246
328,17936119,17937575,Protein coding,IonXpress_SFPQt1,4,1456
329,17937681,17949016,Protein coding,IonXpress_SFPQt1,3,11335
330,17937681,17949341,Protein coding,IonXpress_SFPQt1,1,11660
331,17949100,17949341,Protein coding,IonXpress_SFPQt1,1,241
332,20113469,20113796,Non coding,IonXpress_SFPQt1,1,327
333,20113469,20113796,Protein coding,IonXpress_SFPQt1,2,327
334,20113469,20130155,Protein coding,IonXpress_SFPQt1,1,16686
335,20114038,20130155,Non coding,IonXpress_SFPQt1,1,16117
336,20114038,20130155,Protein coding,IonXpress_SFPQt1,2,16117
337,20130313,20131028,Non coding,IonXpress_SFPQt1,1,715
338,20130313,20131028,Protein coding,IonXpress_SFPQt1,3,715
339,20131170,20132042,Protein coding,IonXpress_SFPQt1,2,872
340,20131170,20132142,Non coding,IonXpress_SFPQt1,1,972
341,20131170,20135230,Protein coding,IonXpress_SFPQt1,1,4060
342,20132208,20133160,Non coding,IonXpress_SFPQt1,1,952
343,20132208,20133160,Protein coding,IonXpress_SFPQt1,2,952
344,20133272,20135226,Non coding,IonXpress_SFPQt1,1,1954
345,20133272,20135230,Protein coding,IonXpress_SFPQt1,2,1958
346,20135364,20135978,Non coding,IonXpress_SFPQt1,1,614
347,20135364,20135978,Protein coding,IonXpress_SFPQt1,3,614
348,20136126,20137502,Non coding,IonXpress_SFPQt1,1,1376
349,20136126,20137502,Protein coding,IonXpress_SFPQt1,3,1376
350,20137707,20138024,Non coding,IonXpress_SFPQt1,1,317
351,20137707,20138024,Protein coding,IonXpress_SFPQt1,3,317
352,20138162,20141518,Non coding,IonXpress_SFPQt1,1,3356
353,20138162,20141518,Protein coding,IonXpress_SFPQt1,3,3356
354,20141600,20145545,Non coding,IonXpress_SFPQt1,1,3945
355,20141600,20145545,Protein coding,IonXpress_SFPQt1,3,3945
356,20145757,20146220,Non coding,IonXpress_SFPQt1,1,463
357,20145757,20146220,Protein coding,IonXpress_SFPQt1,3,463
358,20146331,20147923,Non coding,IonXpress_SFPQt1,1,1592
359,20146331,20147923,Protein coding,IonXpress_SFPQt1,3,1592
360,20147978,20151174,Non coding,IonXpress_SFPQt1,1,3196
361,20147978,20151174,Protein coding,IonXpress_SFPQt1,3,3196
362,20151245,20153593,Non coding,IonXpress_SFPQt1,1,2348
363,20151245,20153593,Protein coding,IonXpress_SFPQt1,3,2348
364,20153739,20160313,Non coding,IonXpress_SFPQt1,1,6574
365,20153739,20160313,Protein coding,IonXpress_SFPQt1,2,6574
366,20153739,20166483,Protein coding,IonXpress_SFPQt1,1,12744
367,20160375,20162054,Protein coding,IonXpress_SFPQt1,1,1679
368,20160375,20166483,Non coding,IonXpress_SFPQt1,1,6108
369,20160375,20166483,Protein coding,IonXpress_SFPQt1,1,6108
370,20162088,20166483,Protein coding,IonXpress_SFPQt1,1,4395
371,20166670,20169239,Non coding,IonXpress_SFPQt1,1,2569
372,20166670,20169239,Protein coding,IonXpress_SFPQt1,3,2569
373,20169366,20173322,Non coding,IonXpress_SFPQt1,1,3956
374,20169366,20173322,Protein coding,IonXpress_SFPQt1,3,3956
375,20173469,20174227,Non coding,IonXpress_SFPQt1,1,758
376,20173469,20174227,Protein coding,IonXpress_SFPQt1,3,758
377,20174394,20175289,Non coding,IonXpress_SFPQt1,1,895
378,20174394,20175289,Protein coding,IonXpress_SFPQt1,3,895
379,20175424,20178510,Non coding,IonXpress_SFPQt1,1,3086
380,20175424,20178510,Protein coding,IonXpress_SFPQt1,2,3086
381,20178640,20180450,Non coding,IonXpress_SFPQt1,1,1810
382,20178640,20180450,Protein coding,IonXpress_SFPQt1,2,1810
383,20180544,20182222,Non coding,IonXpress_SFPQt1,1,1678
384,20180544,20182222,Protein coding,IonXpress_SFPQt1,2,1678
385,20182295,20188924,Non coding,IonXpress_SFPQt1,1,6629
386,20182295,20188924,Protein coding,IonXpress_SFPQt1,2,6629
387,20189043,20189751,Non coding,IonXpress_SFPQt1,1,708
388,20189043,20189751,Protein coding,IonXpress_SFPQt1,2,708
389,20523178,20709592,Protein coding,IonXpress_NONO_c,16,186414
390,20523178,20709592,Protein coding,IonXpress_SFPQt1,3,186414
391,20709644,20766375,Protein coding,IonXpress_NONO_c,16,56731
392,20709644,20766375,Protein coding,IonXpress_SFPQt1,3,56731
393,20766634,20769162,Protein coding,IonXpress_NONO_c,16,2528
394,20766634,20769162,Protein coding,IonXpress_SFPQt1,3,2528
395,20769318,20774228,Protein coding,IonXpress_NONO_c,16,4910
396,20769318,20774228,Protein coding,IonXpress_SFPQt1,3,4910
397,20774345,20782840,Protein coding,IonXpress_NONO_c,16,8495
398,20774345,20782840,Protein coding,IonXpress_SFPQt1,3,8495
399,20783061,20786625,Protein coding,IonXpress_NONO_c,16,3564
400,20783061,20786625,Protein coding,IonXpress_SFPQt1,3,3564
401,20786712,20787834,Protein coding,IonXpress_NONO_c,16,1122
402,20786712,20787834,Protein coding,IonXpress_SFPQt1,3,1122
403,20787990,20790032,Protein coding,IonXpress_NONO_c,16,2042
404,20787990,20790032,Protein coding,IonXpress_SFPQt1,3,2042
405,20790171,20792778,Protein coding,IonXpress_NONO_c,16,2607
406,20790171,20792778,Protein coding,IonXpress_SFPQt1,3,2607
407,20792891,20799422,Protein coding,IonXpress_NONO_c,16,6531
408,20792891,20799422,Protein coding,IonXpress_SFPQt1,3,6531
409,20799537,20799683,Protein coding,IonXpress_NONO_c,16,146
410,20799537,20799683,Protein coding,IonXpress_SFPQt1,3,146
411,20799884,20801620,Protein coding,IonXpress_NONO_c,16,1736
412,20799884,20801620,Protein coding,IonXpress_SFPQt1,3,1736
413,20801825,20803377,Protein coding,IonXpress_NONO_c,16,1552
414,20801825,20803377,Protein coding,IonXpress_SFPQt1,3,1552
415,20803534,20806879,Protein coding,IonXpress_NONO_c,16,3345
416,20803534,20806879,Protein coding,IonXpress_SFPQt1,3,3345
417,20807139,20832962,Protein coding,IonXpress_NONO_c,16,25823
418,20807139,20832962,Protein coding,IonXpress_SFPQt1,3,25823
419,21455943,21476896,Non coding,IonXpress_NONO_c,1,20953
420,21477034,21477166,Non coding,IonXpress_NONO_c,1,132
421,21477291,21559486,Non coding,IonXpress_NONO_c,1,82195
422,24712103,24717540,Protein coding,IonXpress_NONO_c,1,5437
423,24717666,24721366,Protein coding,IonXpress_NONO_c,1,3700
424,24721464,24722504,Protein coding,IonXpress_NONO_c,1,1040
425,24722586,24732669,Protein coding,IonXpress_NONO_c,1,10083
426,24732786,24733256,Protein coding,IonXpress_NONO_c,1,470
427,24733320,24734477,Protein coding,IonXpress_NONO_c,1,1157
428,24734571,24734999,Protein coding,IonXpress_NONO_c,1,428
429,24735088,24735405,Protein coding,IonXpress_NONO_c,1,317
430,24735608,24735695,Protein coding,IonXpress_NONO_c,1,87
431,24735875,24741270,Protein coding,IonXpress_NONO_c,1,5395
432,24741384,24742450,Protein coding,IonXpress_NONO_c,1,1066
433,24742568,24744096,Protein coding,IonXpress_NONO_c,1,1528
434,24744172,24745048,Protein coding,IonXpress_NONO_c,1,876
435,24745188,24745897,Protein coding,IonXpress_NONO_c,1,709
436,24746053,24750485,Protein coding,IonXpress_NONO_c,1,4432
437,24750571,24751870,Protein coding,IonXpress_NONO_c,1,1299
438,24751933,24753514,Protein coding,IonXpress_NONO_c,1,1581
439,24753605,24755740,Protein coding,IonXpress_NONO_c,1,2135
440,24755858,24757490,Protein coding,IonXpress_NONO_c,1,1632
441,24757667,24759490,Protein coding,IonXpress_NONO_c,1,1823
442,24759621,24760117,Protein coding,IonXpress_NONO_c,1,496
443,24760238,24761345,Protein coding,IonXpress_NONO_c,1,1107
444,24761446,24763533,Protein coding,IonXpress_NONO_c,1,2087
445,24763659,24766426,Protein coding,IonXpress_NONO_c,1,2767
446,24766577,24766985,Protein coding,IonXpress_NONO_c,1,408
447,24767109,24828013,Protein coding,IonXpress_NONO_c,1,60904
448,24828047,24828823,Protein coding,IonXpress_NONO_c,1,776
449,24828917,24830773,Protein coding,IonXpress_NONO_c,1,1856
450,24830980,24833094,Protein coding,IonXpress_NONO_c,1,2114
451,24833228,24839567,Protein coding,IonXpress_NONO_c,1,6339
452,24839700,24844542,Protein coding,IonXpress_NONO_c,1,4842
453,24844718,24859767,Protein coding,IonXpress_NONO_c,1,15049
454,24859947,24861661,Protein coding,IonXpress_NONO_c,1,1714
455,24861794,24906121,Protein coding,IonXpress_NONO_c,1,44327
456,24906239,24948568,Protein coding,IonXpress_NONO_c,1,42329
457,24948666,25013920,Protein coding,IonXpress_NONO_c,1,65254
458,26934569,26942147,Non coding,IonXpress_NONO_c,1,7578
459,26942233,26946203,Non coding,IonXpress_NONO_c,1,3970
460,27047048,27047723,Protein coding,IonXpress_NONO_c,1,675
461,27047048,27047723,Protein coding,IonXpress_SFPQt1,2,675
462,27047448,27047723,Protein coding,IonXpress_NONO_c,1,275
463,27047448,27047723,Protein coding,IonXpress_SFPQt1,2,275
464,27047908,27049739,Protein coding,IonXpress_NONO_c,2,1831
465,27047908,27049739,Protein coding,IonXpress_SFPQt1,4,1831
466,27049917,27050587,Protein coding,IonXpress_NONO_c,2,670
467,27049917,27050587,Protein coding,IonXpress_SFPQt1,4,670
468,27050658,27050883,Protein coding,IonXpress_NONO_c,2,225
469,27050658,27050883,Protein coding,IonXpress_SFPQt1,4,225
470,27825722,27827900,Protein coding,IonXpress_SFPQt1,2,2178
471,27827980,27828355,Protein coding,IonXpress_SFPQt1,1,375
472,27827980,27829377,Protein coding,IonXpress_SFPQt1,1,1397
473,27828418,27829377,Protein coding,IonXpress_SFPQt1,1,959
474,27829491,27830319,Protein coding,IonXpress_SFPQt1,2,828
475,27830471,27830571,Protein coding,IonXpress_SFPQt1,1,100
476,28905192,28906043,Non coding,IonXpress_SFPQt1,10,851
477,28906099,28906422,Non coding,IonXpress_SFPQt1,4,323
478,28906493,28907070,Non coding,IonXpress_SFPQt1,6,577
479,28907158,28907604,Non coding,IonXpress_SFPQt1,2,446
480,28907158,28907621,Non coding,IonXpress_SFPQt1,4,463
481,28907741,28908100,Non coding,IonXpress_SFPQt1,8,359
482,30882121,30882585,Protein coding,IonXpress_SFPQt1,2,464
483,30882121,30882931,Protein coding,IonXpress_SFPQt1,2,810
484,30882246,30882580,Protein coding,IonXpress_SFPQt1,2,334
485,30882814,30882931,Non coding,IonXpress_SFPQt1,4,117
486,30882814,30882931,Protein coding,IonXpress_SFPQt1,8,117
487,30883014,30883130,Non coding,IonXpress_SFPQt1,4,116
488,30883014,30883130,Protein coding,IonXpress_SFPQt1,10,116
489,30883232,30883521,Non coding,IonXpress_SFPQt1,4,289
490,30883232,30883521,Protein coding,IonXpress_SFPQt1,10,289
491,30883644,30883756,Non coding,IonXpress_SFPQt1,4,112
492,30883644,30883756,Protein coding,IonXpress_SFPQt1,10,112
493,30883824,30883927,Non coding,IonXpress_SFPQt1,4,103
494,30883824,30883927,Protein coding,IonXpress_SFPQt1,10,103
495,30884026,30884653,Non coding,IonXpress_SFPQt1,4,627
496,30884026,30884653,Protein coding,IonXpress_SFPQt1,10,627
497,30884736,30884880,Non coding,IonXpress_SFPQt1,4,144
498,30884736,30884880,Protein coding,IonXpress_SFPQt1,10,144
499,30885001,30885470,Non coding,IonXpress_SFPQt1,4,469
500,30885001,30885470,Protein coding,IonXpress_SFPQt1,10,469
501,30885583,30886602,Non coding,IonXpress_SFPQt1,4,1019
502,30885583,30886602,Protein coding,IonXpress_SFPQt1,10,1019
503,30886692,30887533,Non coding,IonXpress_SFPQt1,4,841
504,30886692,30887533,Protein coding,IonXpress_SFPQt1,10,841
505,30887625,30887864,Non coding,IonXpress_SFPQt1,4,239
506,30887625,30887864,Protein coding,IonXpress_SFPQt1,10,239
507,30887625,30887870,Protein coding,IonXpress_SFPQt1,2,245
508,30887993,30888108,Non coding,IonXpress_SFPQt1,4,115
509,30887993,30888108,Protein coding,IonXpress_SFPQt1,12,115
510,30888213,30888443,Non coding,IonXpress_SFPQt1,4,230
511,30888213,30888443,Protein coding,IonXpress_SFPQt1,12,230
512,30888526,30888840,Non coding,IonXpress_SFPQt1,4,314
513,30888526,30888840,Protein coding,IonXpress_SFPQt1,12,314
514,30888918,30889005,Non coding,IonXpress_SFPQt1,4,87
515,30888918,30889005,Protein coding,IonXpress_SFPQt1,12,87
516,30889082,30889364,Non coding,IonXpress_SFPQt1,4,282
517,30889082,30889364,Protein coding,IonXpress_SFPQt1,12,282
518,30889468,30889700,Non coding,IonXpress_SFPQt1,2,232
519,30889468,30889700,Protein coding,IonXpress_SFPQt1,12,232
520,30889468,30889891,Non coding,IonXpress_SFPQt1,2,423
521,30889772,30889891,Non coding,IonXpress_SFPQt1,2,119
522,30889772,30889891,Protein coding,IonXpress_SFPQt1,12,119
523,30890018,30890157,Protein coding,IonXpress_SFPQt1,2,139
524,30890018,30890225,Non coding,IonXpress_SFPQt1,4,207
525,30890018,30890225,Protein coding,IonXpress_SFPQt1,10,207
526,30890331,30890481,Non coding,IonXpress_SFPQt1,4,150
527,30890331,30890481,Protein coding,IonXpress_SFPQt1,12,150
528,30890551,30890673,Non coding,IonXpress_SFPQt1,4,122
529,30890551,30890673,Protein coding,IonXpress_SFPQt1,12,122
530,30890753,30890879,Non coding,IonXpress_SFPQt1,4,126
531,30890753,30890879,Protein coding,IonXpress_SFPQt1,12,126
532,30891008,30891128,Non coding,IonXpress_SFPQt1,4,120
533,30891008,30891128,Protein coding,IonXpress_SFPQt1,12,120
534,30891282,30892129,Non coding,IonXpress_SFPQt1,4,847
535,30891282,30892129,Protein coding,IonXpress_SFPQt1,12,847
536,30892337,30893049,Protein coding,IonXpress_SFPQt1,12,712
537,30892337,30893319,Non coding,IonXpress_SFPQt1,4,982
538,30893162,30893319,Protein coding,IonXpress_SFPQt1,12,157
539,30893496,30893655,Non coding,IonXpress_SFPQt1,4,159
540,30893496,30893655,Protein coding,IonXpress_SFPQt1,12,159
541,30893785,30893884,Non coding,IonXpress_SFPQt1,4,99
542,30893785,30893884,Protein coding,IonXpress_SFPQt1,12,99
543,31085952,31087565,Protein coding,IonXpress_SFPQt1,1,1613
544,31093022,31094290,Protein coding,IonXpress_SFPQt1,1,1268
545,31498227,31498554,Protein coding,IonXpress_SFPQt1,8,327
546,31498703,31498828,Protein coding,IonXpress_SFPQt1,8,125
547,31498974,31499071,Protein coding,IonXpress_SFPQt1,8,97
548,31499182,31500555,Protein coding,IonXpress_SFPQt1,8,1373
549,31500688,31503142,Protein coding,IonXpress_SFPQt1,8,2454
550,31503262,31504275,Protein coding,IonXpress_SFPQt1,16,1013
551,31504460,31506538,Non coding,IonXpress_SFPQt1,1,2078
552,31504460,31506538,Protein coding,IonXpress_SFPQt1,12,2078
553,31504460,31508097,Protein coding,IonXpress_SFPQt1,4,3637
554,31506632,31506715,Non coding,IonXpress_SFPQt1,1,83
555,31506632,31506922,Protein coding,IonXpress_SFPQt1,10,290
556,31506632,31508097,Protein coding,IonXpress_SFPQt1,2,1465
557,31506836,31506922,Non coding,IonXpress_SFPQt1,1,86
558,31507051,31508097,Non coding,IonXpress_SFPQt1,1,1046
559,31507051,31508097,Protein coding,IonXpress_SFPQt1,10,1046
560,31508311,31509725,Protein coding,IonXpress_SFPQt1,6,1414
561,31508441,31509725,Non coding,IonXpress_SFPQt1,1,1284
562,31508441,31509725,Protein coding,IonXpress_SFPQt1,8,1284
563,31509925,31513884,Protein coding,IonXpress_SFPQt1,2,3959
564,31513986,31514253,Protein coding,IonXpress_SFPQt1,2,267
565,31802977,31803186,Protein coding,IonXpress_SFPQt1,2,209
566,31802977,31805011,Protein coding,IonXpress_SFPQt1,1,2034
567,31803228,31804199,Protein coding,IonXpress_SFPQt1,1,971
568,31803228,31805011,Protein coding,IonXpress_SFPQt1,1,1783
569,31804294,31805011,Protein coding,IonXpress_SFPQt1,1,717
570,31805212,31807318,Protein coding,IonXpress_SFPQt1,3,2106
571,33474929,33475278,Protein coding,IonXpress_NONO_c,2,349
572,33474929,33475278,Protein coding,IonXpress_SFPQt1,2,349
573,33474929,33475281,Protein coding,IonXpress_NONO_c,1,352
574,33474929,33475281,Protein coding,IonXpress_SFPQt1,1,352
575,33475450,33475990,Protein coding,IonXpress_NONO_c,4,540
576,33475450,33475990,Protein coding,IonXpress_SFPQt1,4,540
577,33476028,33477065,Protein coding,IonXpress_NONO_c,4,1037
578,33476028,33477065,Protein coding,IonXpress_SFPQt1,4,1037
579,33477242,33479910,Protein coding,IonXpress_NONO_c,4,2668
580,33477242,33479910,Protein coding,IonXpress_SFPQt1,4,2668
581,33480001,33481591,Protein coding,IonXpress_NONO_c,4,1590
582,33480001,33481591,Protein coding,IonXpress_SFPQt1,4,1590
583,33481760,33482313,Protein coding,IonXpress_NONO_c,4,553
584,33481760,33482313,Protein coding,IonXpress_SFPQt1,4,553
585,33482483,33486392,Protein coding,IonXpress_NONO_c,4,3909
586,33482483,33486392,Protein coding,IonXpress_SFPQt1,4,3909
587,33486564,33491012,Protein coding,IonXpress_NONO_c,4,4448
588,33486564,33491012,Protein coding,IonXpress_SFPQt1,4,4448
589,33491185,33495078,Protein coding,IonXpress_NONO_c,4,3893
590,33491185,33495078,Protein coding,IonXpress_SFPQt1,4,3893
591,33495380,33496854,Protein coding,IonXpress_NONO_c,3,1474
592,33495380,33496854,Protein coding,IonXpress_SFPQt1,3,1474
593,33495380,33498339,Protein coding,IonXpress_NONO_c,1,2959
594,33495380,33498339,Protein coding,IonXpress_SFPQt1,1,2959
595,33496950,33497131,Protein coding,IonXpress_NONO_c,3,181
596,33496950,33497131,Protein coding,IonXpress_SFPQt1,3,181
597,33497274,33498339,Protein coding,IonXpress_NONO_c,2,1065
598,33497274,33498339,Protein coding,IonXpress_SFPQt1,2,1065
599,33497280,33498339,Protein coding,IonXpress_NONO_c,1,1059
600,33497280,33498339,Protein coding,IonXpress_SFPQt1,1,1059
601,33498481,33501259,Protein coding,IonXpress_NONO_c,4,2778
602,33498481,33501259,Protein coding,IonXpress_SFPQt1,4,2778
603,33501388,33502985,Protein coding,IonXpress_NONO_c,4,1597
604,33501388,33502985,Protein coding,IonXpress_SFPQt1,4,1597
605,33503053,33504034,Protein coding,IonXpress_NONO_c,4,981
606,33503053,33504034,Protein coding,IonXpress_SFPQt1,4,981
607,33504149,33504512,Protein coding,IonXpress_NONO_c,4,363
608,33504149,33504512,Protein coding,IonXpress_SFPQt1,4,363
609,33504629,33507576,Protein coding,IonXpress_NONO_c,4,2947
610,33504629,33507576,Protein coding,IonXpress_SFPQt1,4,2947
611,33507695,33510444,Protein coding,IonXpress_NONO_c,4,2749
612,33507695,33510444,Protein coding,IonXpress_SFPQt1,4,2749
613,33510601,33513316,Protein coding,IonXpress_NONO_c,4,2715
614,33510601,33513316,Protein coding,IonXpress_SFPQt1,4,2715
615,33922597,33922683,Protein coding,IonXpress_SFPQt1,6,86
616,33922876,33922962,Protein coding,IonXpress_SFPQt1,6,86
617,33923031,33923182,Protein coding,IonXpress_SFPQt1,6,151
618,33923291,33923375,Protein coding,IonXpress_SFPQt1,6,84
619,33923476,33923791,Protein coding,IonXpress_SFPQt1,7,315
620,33923998,33924202,Protein coding,IonXpress_SFPQt1,7,204
621,33924282,33926613,Protein coding,IonXpress_SFPQt1,7,2331
622,33926662,33926985,Protein coding,IonXpress_SFPQt1,7,323
623,33927078,33927793,Protein coding,IonXpress_SFPQt1,7,715
624,33927990,33932558,Protein coding,IonXpress_SFPQt1,7,4568
625,33927990,33933486,Protein coding,IonXpress_SFPQt1,1,5496
626,33932626,33933486,Protein coding,IonXpress_SFPQt1,7,860
627,33933626,33934050,Protein coding,IonXpress_SFPQt1,1,424
628,33933626,33935835,Protein coding,IonXpress_SFPQt1,7,2209
629,33935876,33941645,Protein coding,IonXpress_SFPQt1,7,5769
630,33941860,33943416,Protein coding,IonXpress_SFPQt1,7,1556
631,33943587,33944361,Protein coding,IonXpress_SFPQt1,7,774
632,33944637,33948370,Protein coding,IonXpress_SFPQt1,7,3733
633,33948585,33953281,Protein coding,IonXpress_SFPQt1,7,4696
634,33953472,33956075,Protein coding,IonXpress_SFPQt1,6,2603
635,33953472,33960822,Protein coding,IonXpress_SFPQt1,1,7350
636,33956144,33960822,Protein coding,IonXpress_SFPQt1,5,4678
637,33956144,33998783,Protein coding,IonXpress_SFPQt1,1,42639
638,33960876,33963722,Protein coding,IonXpress_SFPQt1,6,2846
639,33963789,33971647,Protein coding,IonXpress_SFPQt1,2,7858
640,33963789,33986756,Protein coding,IonXpress_SFPQt1,4,22967
641,33971752,33973179,Protein coding,IonXpress_SFPQt1,2,1427
642,33973235,33986756,Protein coding,IonXpress_SFPQt1,2,13521
643,33986835,33988969,Protein coding,IonXpress_SFPQt1,6,2134
644,33989124,33996219,Protein coding,IonXpress_SFPQt1,4,7095
645,33989124,33998783,Protein coding,IonXpress_SFPQt1,2,9659
646,33996331,33998783,Protein coding,IonXpress_SFPQt1,4,2452
647,33998862,34011623,Protein coding,IonXpress_SFPQt1,4,12761
648,33998862,34017046,Protein coding,IonXpress_SFPQt1,2,18184
649,33998862,34048821,Protein coding,IonXpress_SFPQt1,1,49959
650,34011662,34017046,Protein coding,IonXpress_SFPQt1,4,5384
651,34017187,34048821,Protein coding,IonXpress_SFPQt1,4,31634
652,34017187,34048874,Protein coding,IonXpress_SFPQt1,2,31687
653,34392402,34395267,Protein coding,IonXpress_NONO_c,1,2865
654,34395406,34398052,Protein coding,IonXpress_NONO_c,1,2646
655,34398121,34399924,Protein coding,IonXpress_NONO_c,1,1803
656,34400023,34403971,Protein coding,IonXpress_NONO_c,1,3948
657,34404154,34404854,Protein coding,IonXpress_NONO_c,1,700
658,34404992,34405391,Protein coding,IonXpress_NONO_c,1,399
659,34405491,34409283,Protein coding,IonXpress_NONO_c,1,3792
660,34409354,34540222,Protein coding,IonXpress_NONO_c,1,130868
661,34855924,34856163,Protein coding,IonXpress_NONO_c,2,239
662,34856293,34857248,Protein coding,IonXpress_NONO_c,4,955
663,34857340,34857686,Protein coding,IonXpress_NONO_c,4,346
664,34857756,34859486,Protein coding,IonXpress_NONO_c,4,1730
665,34859607,34868406,Protein coding,IonXpress_NONO_c,2,8799
666,34859607,34868638,Protein coding,IonXpress_NONO_c,2,9031
667,34868491,34868638,Protein coding,IonXpress_NONO_c,2,147
668,34868786,34869837,Protein coding,IonXpress_NONO_c,4,1051
669,34869910,34870421,Protein coding,IonXpress_NONO_c,4,511
670,34870467,34872369,Protein coding,IonXpress_NONO_c,4,1902
671,34872424,34884151,Protein coding,IonXpress_NONO_c,4,11727
672,34884213,34884631,Protein coding,IonXpress_NONO_c,4,418
673,34884676,34884817,Protein coding,IonXpress_NONO_c,4,141
674,34884971,34887204,Protein coding,IonXpress_NONO_c,4,2233
675,34887335,34887484,Protein coding,IonXpress_NONO_c,4,149
676,34887562,34890110,Protein coding,IonXpress_NONO_c,4,2548
677,34890240,34890459,Protein coding,IonXpress_NONO_c,4,219
678,34890536,34890622,Protein coding,IonXpress_NONO_c,4,86
679,34890690,34890804,Protein coding,IonXpress_NONO_c,4,114
680,35642072,35642918,Non coding,IonXpress_NONO_c,1,846
681,35642075,35642918,Non coding,IonXpress_NONO_c,1,843
682,35643000,35643588,Non coding,IonXpress_NONO_c,2,588
683,35650194,35652600,Protein coding,IonXpress_NONO_c,1,2406
684,35652723,35652802,Protein coding,IonXpress_NONO_c,1,79
685,35652852,35653572,Protein coding,IonXpress_NONO_c,1,720
686,35653691,35654602,Protein coding,IonXpress_NONO_c,1,911
687,35654688,35654785,Protein coding,IonXpress_NONO_c,1,97
688,35654983,35656097,Protein coding,IonXpress_NONO_c,1,1114
689,35656194,35656293,Protein coding,IonXpress_NONO_c,1,99
690,35656596,35656940,Protein coding,IonXpress_NONO_c,1,344
691,35657130,35657821,Protein coding,IonXpress_NONO_c,1,691
692,36040299,36042921,Protein coding,IonXpress_NONO_c,1,2622
693,36043093,36070832,Protein coding,IonXpress_NONO_c,1,27739
694,36068975,36070832,Protein coding,IonXpress_NONO_c,3,1857
695,36070883,36074845,Protein coding,IonXpress_NONO_c,4,3962
696,36075009,36096873,Protein coding,IonXpress_NONO_c,4,21864
697,36096945,36097035,Protein coding,IonXpress_NONO_c,1,90
698,36096945,36101909,Protein coding,IonXpress_NONO_c,3,4964
699,36102033,36106941,Protein coding,IonXpress_NONO_c,2,4908
700,36102033,36107016,Protein coding,IonXpress_NONO_c,1,4983
701,37120620,37126307,Protein coding,IonXpress_NONO_c,1,5687
702,37120620,37302183,Protein coding,IonXpress_NONO_c,1,181563
703,37120624,37126307,Protein coding,IonXpress_NONO_c,1,5683
704,37120773,37121595,Protein coding,IonXpress_NONO_c,1,822
705,37120773,37126307,Protein coding,IonXpress_NONO_c,1,5534
706,37120891,37126307,Protein coding,IonXpress_NONO_c,1,5416
707,37121669,37126307,Protein coding,IonXpress_NONO_c,1,4638
708,37126939,37186707,Protein coding,IonXpress_NONO_c,1,59768
709,37126939,37302183,Protein coding,IonXpress_NONO_c,4,175244
710,37302228,37304183,Protein coding,IonXpress_NONO_c,5,1955
711,37304310,37305539,Protein coding,IonXpress_NONO_c,5,1229
712,37305711,37327794,Protein coding,IonXpress_NONO_c,5,22083
713,37327831,37349352,Protein coding,IonXpress_NONO_c,5,21521
714,37349449,37354705,Protein coding,IonXpress_NONO_c,5,5256
715,37354821,37356830,Protein coding,IonXpress_NONO_c,5,2009
716,39699922,39739038,Protein coding,IonXpress_NONO_c,1,39116
717,39700010,39739038,Protein coding,IonXpress_NONO_c,3,39028
718,39700010,39747370,Non coding,IonXpress_NONO_c,1,47360
719,39700010,39757275,Protein coding,IonXpress_NONO_c,1,57265
720,39708989,39709194,Protein coding,IonXpress_NONO_c,3,205
721,39709315,39709637,Protein coding,IonXpress_NONO_c,3,322
722,39709734,39710110,Protein coding,IonXpress_NONO_c,3,376
723,39710213,39710689,Protein coding,IonXpress_NONO_c,3,476
724,39710851,39711372,Protein coding,IonXpress_NONO_c,3,521
725,39711530,39712826,Protein coding,IonXpress_NONO_c,1,1296
726,39711560,39712709,Protein coding,IonXpress_NONO_c,2,1149
727,39712846,39713464,Protein coding,IonXpress_NONO_c,2,618
728,39713026,39713464,Protein coding,IonXpress_NONO_c,1,438
729,39713634,39714403,Protein coding,IonXpress_NONO_c,3,769
730,39714597,39715598,Protein coding,IonXpress_NONO_c,2,1001
731,39714597,39715730,Protein coding,IonXpress_NONO_c,1,1133
732,39739133,39747370,Protein coding,IonXpress_NONO_c,4,8237
733,39747430,39757275,Non coding,IonXpress_NONO_c,1,9845
734,39747430,39757275,Protein coding,IonXpress_NONO_c,3,9845
735,39747430,39779300,Protein coding,IonXpress_NONO_c,1,31870
736,39757359,39776452,Non coding,IonXpress_NONO_c,1,19093
737,39757359,39776452,Protein coding,IonXpress_NONO_c,4,19093
738,39776553,39779300,Non coding,IonXpress_NONO_c,1,2747
739,39776553,39779300,Protein coding,IonXpress_NONO_c,3,2747
740,39776553,39779978,Protein coding,IonXpress_NONO_c,1,3425
741,39779430,39779978,Non coding,IonXpress_NONO_c,1,548
742,39779430,39779978,Protein coding,IonXpress_NONO_c,4,548
743,45241272,45241704,Protein coding,IonXpress_NONO_c,1,432
744,45241272,45241704,Protein coding,IonXpress_SFPQt1,2,432
745,45241812,45242345,Protein coding,IonXpress_NONO_c,1,533
746,45241812,45242345,Protein coding,IonXpress_SFPQt1,2,533
747,45242446,45243284,Protein coding,IonXpress_NONO_c,1,838
748,45242446,45243284,Protein coding,IonXpress_SFPQt1,2,838
749,45243461,45243670,Protein coding,IonXpress_NONO_c,1,209
750,45243461,45243670,Protein coding,IonXpress_SFPQt1,2,209
751,45243801,45244246,Protein coding,IonXpress_NONO_c,1,445
752,45243801,45244246,Protein coding,IonXpress_SFPQt1,2,445
753,45286376,45288272,Protein coding,IonXpress_NONO_c,1,1896
754,45286376,45288272,Protein coding,IonXpress_SFPQt1,1,1896
755,45288341,45288739,Protein coding,IonXpress_NONO_c,1,398
756,45288341,45288739,Protein coding,IonXpress_SFPQt1,1,398
757,45288840,45288913,Protein coding,IonXpress_NONO_c,1,73
758,45288840,45288913,Protein coding,IonXpress_SFPQt1,1,73
759,45289057,45291920,Protein coding,IonXpress_NONO_c,1,2863
760,45289057,45291920,Protein coding,IonXpress_SFPQt1,1,2863
761,45292059,45292158,Protein coding,IonXpress_NONO_c,1,99
762,45292059,45292158,Protein coding,IonXpress_SFPQt1,1,99
763,45292440,45292572,Protein coding,IonXpress_NONO_c,1,132
764,45292440,45292572,Protein coding,IonXpress_SFPQt1,1,132
765,45292754,45292837,Protein coding,IonXpress_NONO_c,1,83
766,45292754,45292837,Protein coding,IonXpress_SFPQt1,1,83
767,45292981,45293072,Protein coding,IonXpress_NONO_c,1,91
768,45292981,45293072,Protein coding,IonXpress_SFPQt1,1,91
769,45293386,45293513,Protein coding,IonXpress_NONO_c,1,127
770,45293386,45293513,Protein coding,IonXpress_SFPQt1,1,127
771,45293863,45293966,Protein coding,IonXpress_NONO_c,1,103
772,45293863,45293966,Protein coding,IonXpress_SFPQt1,1,103
773,45294086,45294176,Protein coding,IonXpress_NONO_c,1,90
774,45294086,45294176,Protein coding,IonXpress_SFPQt1,1,90
775,45294303,45294652,Protein coding,IonXpress_NONO_c,1,349
776,45294303,45294652,Protein coding,IonXpress_SFPQt1,1,349
777,45294746,45294827,Protein coding,IonXpress_NONO_c,1,81
778,45294746,45294827,Protein coding,IonXpress_SFPQt1,1,81
779,45294984,45295072,Protein coding,IonXpress_NONO_c,1,88
780,45294984,45295072,Protein coding,IonXpress_SFPQt1,1,88
781,45295205,45295284,Protein coding,IonXpress_NONO_c,1,79
782,45295205,45295284,Protein coding,IonXpress_SFPQt1,1,79
783,45295433,45295579,Protein coding,IonXpress_NONO_c,1,146
784,45295433,45295579,Protein coding,IonXpress_SFPQt1,1,146
785,45295702,45296518,Protein coding,IonXpress_NONO_c,1,816
786,45295702,45296518,Protein coding,IonXpress_SFPQt1,1,816
787,45296715,45297376,Protein coding,IonXpress_NONO_c,1,661
788,45296715,45297376,Protein coding,IonXpress_SFPQt1,1,661
789,45297469,45297645,Protein coding,IonXpress_NONO_c,1,176
790,45297469,45297645,Protein coding,IonXpress_SFPQt1,1,176
791,45297716,45297822,Protein coding,IonXpress_NONO_c,1,106
792,45297716,45297822,Protein coding,IonXpress_SFPQt1,1,106
793,45298013,45307517,Protein coding,IonXpress_NONO_c,1,9504
794,45298013,45307517,Protein coding,IonXpress_SFPQt1,1,9504
795,45307711,45308531,Protein coding,IonXpress_NONO_c,1,820
796,45307711,45308531,Protein coding,IonXpress_SFPQt1,1,820
797,46765815,46765974,Protein coding,IonXpress_SFPQt1,3,159
798,46766127,46771822,Protein coding,IonXpress_SFPQt1,3,5695
799,46771983,46772076,Protein coding,IonXpress_SFPQt1,3,93
800,46772161,46772666,Protein coding,IonXpress_SFPQt1,3,505
801,46772805,46772894,Protein coding,IonXpress_SFPQt1,2,89
802,46772826,46772894,Protein coding,IonXpress_SFPQt1,1,68
803,46773084,46774183,Protein coding,IonXpress_SFPQt1,3,1099
804,46774260,46774858,Protein coding,IonXpress_SFPQt1,3,598
805,46775047,46776436,Protein coding,IonXpress_SFPQt1,2,1389
806,46775047,46780471,Protein coding,IonXpress_SFPQt1,1,5424
807,46776617,46780471,Protein coding,IonXpress_SFPQt1,2,3854
808,46780593,46780817,Protein coding,IonXpress_SFPQt1,3,224
809,46780992,46782160,Protein coding,IonXpress_SFPQt1,3,1168
810,46782334,46783548,Protein coding,IonXpress_SFPQt1,3,1214
811,46783743,46784175,Protein coding,IonXpress_SFPQt1,3,432
812,46784312,46784524,Protein coding,IonXpress_SFPQt1,3,212
813,46784729,46785029,Protein coding,IonXpress_SFPQt1,3,300
814,46785180,46786679,Protein coding,IonXpress_SFPQt1,3,1499
815,46786806,46789123,Protein coding,IonXpress_SFPQt1,3,2317
816,46789213,46791511,Protein coding,IonXpress_SFPQt1,3,2298
817,46791648,46792336,Protein coding,IonXpress_SFPQt1,3,688
818,46792532,46797803,Protein coding,IonXpress_SFPQt1,3,5271
819,46797933,46798987,Protein coding,IonXpress_SFPQt1,3,1054
820,46799102,46799687,Protein coding,IonXpress_SFPQt1,3,585
821,46799863,46800008,Protein coding,IonXpress_SFPQt1,3,145
822,46800149,46801742,Protein coding,IonXpress_SFPQt1,3,1593
823,46801869,46801976,Protein coding,IonXpress_SFPQt1,3,107
824,46802035,46804822,Protein coding,IonXpress_SFPQt1,3,2787
825,46804918,46806036,Protein coding,IonXpress_SFPQt1,3,1118
826,46806223,46810229,Protein coding,IonXpress_SFPQt1,3,4006
827,46810323,46811624,Protein coding,IonXpress_SFPQt1,3,1301
828,46811736,46812018,Protein coding,IonXpress_SFPQt1,3,282
829,46812133,46817142,Protein coding,IonXpress_SFPQt1,3,5009
830,46817326,46818360,Protein coding,IonXpress_SFPQt1,3,1034
831,46818490,46819353,Protein coding,IonXpress_SFPQt1,3,863
832,46819519,46819631,Protein coding,IonXpress_SFPQt1,3,112
833,46819722,46822748,Protein coding,IonXpress_SFPQt1,3,3026
834,46822854,46829579,Protein coding,IonXpress_SFPQt1,3,6725
835,46829694,46830948,Protein coding,IonXpress_SFPQt1,3,1254
836,46831050,46831290,Protein coding,IonXpress_SFPQt1,3,240
837,46831424,46832555,Protein coding,IonXpress_SFPQt1,3,1131
838,46832728,46837747,Protein coding,IonXpress_SFPQt1,3,5019
839,46837955,46839859,Protein coding,IonXpress_SFPQt1,3,1904
840,46840054,46842724,Protein coding,IonXpress_SFPQt1,2,2670
841,46842819,46867769,Protein coding,IonXpress_SFPQt1,2,24950
842,46917632,46918874,Protein coding,IonXpress_NONO_c,8,1242
843,46917632,46918874,Protein coding,IonXpress_SFPQt1,8,1242
844,46918966,46919580,Protein coding,IonXpress_NONO_c,7,614
845,46918966,46919580,Protein coding,IonXpress_SFPQt1,7,614
846,46918966,46923419,Protein coding,IonXpress_NONO_c,1,4453
847,46918966,46923419,Protein coding,IonXpress_SFPQt1,1,4453
848,46919735,46923419,Protein coding,IonXpress_NONO_c,7,3684
849,46919735,46923419,Protein coding,IonXpress_SFPQt1,7,3684
850,46923482,46924246,Protein coding,IonXpress_NONO_c,8,764
851,46923482,46924246,Protein coding,IonXpress_SFPQt1,8,764
852,46924486,46928896,Protein coding,IonXpress_NONO_c,1,4410
853,46924486,46928896,Protein coding,IonXpress_SFPQt1,1,4410
854,46924486,46930565,Protein coding,IonXpress_NONO_c,8,6079
855,46924486,46930565,Protein coding,IonXpress_SFPQt1,8,6079
856,46928998,46930565,Protein coding,IonXpress_NONO_c,1,1567
857,46928998,46930565,Protein coding,IonXpress_SFPQt1,1,1567
858,46930631,46933619,Protein coding,IonXpress_NONO_c,9,2988
859,46930631,46933619,Protein coding,IonXpress_SFPQt1,9,2988
860,46933766,46935574,Protein coding,IonXpress_NONO_c,9,1808
861,46933766,46935574,Protein coding,IonXpress_SFPQt1,9,1808
862,46935708,46936671,Protein coding,IonXpress_NONO_c,9,963
863,46935708,46936671,Protein coding,IonXpress_SFPQt1,9,963
864,46936733,46937248,Protein coding,IonXpress_NONO_c,9,515
865,46936733,46937248,Protein coding,IonXpress_SFPQt1,9,515
866,46937348,46942175,Protein coding,IonXpress_NONO_c,9,4827
867,46937348,46942175,Protein coding,IonXpress_SFPQt1,9,4827
868,46942384,46942866,Protein coding,IonXpress_NONO_c,9,482
869,46942384,46942866,Protein coding,IonXpress_SFPQt1,9,482
870,46942950,46946074,Protein coding,IonXpress_NONO_c,6,3124
871,46942950,46946074,Protein coding,IonXpress_SFPQt1,6,3124
872,46942950,46952023,Protein coding,IonXpress_NONO_c,2,9073
873,46942950,46952023,Protein coding,IonXpress_SFPQt1,2,9073
874,46942950,46961267,Protein coding,IonXpress_NONO_c,1,18317
875,46942950,46961267,Protein coding,IonXpress_SFPQt1,1,18317
876,46946345,46952023,Protein coding,IonXpress_NONO_c,1,5678
877,46946345,46952023,Protein coding,IonXpress_SFPQt1,1,5678
878,46946345,46961267,Protein coding,IonXpress_NONO_c,1,14922
879,46946345,46961267,Protein coding,IonXpress_SFPQt1,1,14922
880,46946732,46950625,Protein coding,IonXpress_NONO_c,1,3893
881,46946732,46950625,Protein coding,IonXpress_SFPQt1,1,3893
882,46946732,46952023,Protein coding,IonXpress_NONO_c,1,5291
883,46946732,46952023,Protein coding,IonXpress_SFPQt1,1,5291
884,46946732,46961267,Protein coding,IonXpress_NONO_c,1,14535
885,46946732,46961267,Protein coding,IonXpress_SFPQt1,1,14535
886,46946732,46961810,Protein coding,IonXpress_NONO_c,1,15078
887,46946732,46961810,Protein coding,IonXpress_SFPQt1,1,15078
888,46950719,46952023,Protein coding,IonXpress_NONO_c,1,1304
889,46950719,46952023,Protein coding,IonXpress_SFPQt1,1,1304
890,46952140,46952580,Protein coding,IonXpress_NONO_c,1,440
891,46952140,46952580,Protein coding,IonXpress_SFPQt1,1,440
892,46952140,46961267,Protein coding,IonXpress_NONO_c,3,9127
893,46952140,46961267,Protein coding,IonXpress_SFPQt1,3,9127
894,46952140,46961810,Protein coding,IonXpress_NONO_c,1,9670
895,46952140,46961810,Protein coding,IonXpress_SFPQt1,1,9670
896,46962014,46963918,Protein coding,IonXpress_NONO_c,1,1904
897,46962014,46963918,Protein coding,IonXpress_SFPQt1,1,1904
898,46962014,47011518,Protein coding,IonXpress_NONO_c,1,49504
899,46962014,47011518,Protein coding,IonXpress_SFPQt1,1,49504
900,47008780,47009952,Protein coding,IonXpress_NONO_c,7,1172
901,47008780,47009952,Protein coding,IonXpress_SFPQt1,7,1172
902,47010141,47015727,Protein coding,IonXpress_NONO_c,7,5586
903,47010141,47015727,Protein coding,IonXpress_SFPQt1,7,5586
904,47014936,47015727,Protein coding,IonXpress_NONO_c,32,791
905,47014936,47015727,Protein coding,IonXpress_SFPQt1,32,791
906,47015920,47016822,Protein coding,IonXpress_NONO_c,39,902
907,47015920,47016822,Protein coding,IonXpress_SFPQt1,39,902
908,47016922,47017161,Protein coding,IonXpress_NONO_c,39,239
909,47016922,47017161,Protein coding,IonXpress_SFPQt1,39,239
910,47017297,47017773,Protein coding,IonXpress_NONO_c,31,476
911,47017297,47017773,Protein coding,IonXpress_SFPQt1,31,476
912,47017297,47017900,Protein coding,IonXpress_NONO_c,8,603
913,47017297,47017900,Protein coding,IonXpress_SFPQt1,8,603
914,47017815,47017900,Protein coding,IonXpress_NONO_c,31,85
915,47017815,47017900,Protein coding,IonXpress_SFPQt1,31,85
916,47017954,47018104,Protein coding,IonXpress_NONO_c,12,150
917,47017954,47018104,Protein coding,IonXpress_SFPQt1,12,150
918,47017954,47018626,Protein coding,IonXpress_NONO_c,4,672
919,47017954,47018626,Protein coding,IonXpress_SFPQt1,4,672
920,47017954,47018643,Protein coding,IonXpress_NONO_c,4,689
921,47017954,47018643,Protein coding,IonXpress_SFPQt1,4,689
922,47017954,47018826,Protein coding,IonXpress_NONO_c,12,872
923,47017954,47018826,Protein coding,IonXpress_SFPQt1,12,872
924,47018203,47018626,Protein coding,IonXpress_NONO_c,4,423
925,47018203,47018626,Protein coding,IonXpress_SFPQt1,4,423
926,47018203,47018643,Protein coding,IonXpress_NONO_c,4,440
927,47018203,47018643,Protein coding,IonXpress_SFPQt1,4,440
928,47018203,47018826,Protein coding,IonXpress_NONO_c,8,623
929,47018203,47018826,Protein coding,IonXpress_SFPQt1,8,623
930,47495337,47497791,Protein coding,IonXpress_NONO_c,2,2454
931,47495337,47497808,Protein coding,IonXpress_NONO_c,2,2471
932,47495337,47531308,Protein coding,IonXpress_NONO_c,2,35971
933,47497904,47531308,Protein coding,IonXpress_NONO_c,4,33404
934,47531399,47533665,Protein coding,IonXpress_NONO_c,6,2266
935,47533805,47536900,Protein coding,IonXpress_NONO_c,6,3095
936,47537001,47545574,Protein coding,IonXpress_NONO_c,6,8573
937,47545683,47549430,Protein coding,IonXpress_NONO_c,6,3747
938,47549512,47581342,Protein coding,IonXpress_NONO_c,6,31830
939,47581459,47614204,Protein coding,IonXpress_NONO_c,4,32745
940,47614269,47621577,Protein coding,IonXpress_NONO_c,4,7308
941,47621674,47622814,Protein coding,IonXpress_NONO_c,4,1140
942,47623013,47627409,Protein coding,IonXpress_NONO_c,4,4396
943,47627468,47628046,Protein coding,IonXpress_NONO_c,4,578
944,47628125,47630282,Protein coding,IonXpress_NONO_c,4,2157
945,47630442,47644735,Protein coding,IonXpress_NONO_c,4,14293
946,47644831,47674944,Protein coding,IonXpress_NONO_c,4,30113
947,47675001,47675508,Protein coding,IonXpress_NONO_c,4,507
948,47675603,47682442,Protein coding,IonXpress_NONO_c,4,6839
949,47682527,47683009,Protein coding,IonXpress_NONO_c,4,482
950,47683115,47684453,Protein coding,IonXpress_NONO_c,4,1338
951,47684537,47684740,Protein coding,IonXpress_NONO_c,4,203
952,47684832,47694415,Protein coding,IonXpress_NONO_c,4,9583
953,47694478,47694566,Protein coding,IonXpress_NONO_c,4,88
954,47694730,47695628,Protein coding,IonXpress_NONO_c,4,898
955,47695711,47697586,Protein coding,IonXpress_NONO_c,4,1875
956,47697645,47698794,Protein coding,IonXpress_NONO_c,2,1149
957,47697645,47699851,Protein coding,IonXpress_NONO_c,2,2206
958,47698886,47703124,Protein coding,IonXpress_NONO_c,2,4238
959,47699943,47703124,Protein coding,IonXpress_NONO_c,2,3181
960,47703328,47722950,Protein coding,IonXpress_NONO_c,4,19622
961,47723086,47727287,Protein coding,IonXpress_NONO_c,4,4201
962,47727418,47730290,Protein coding,IonXpress_NONO_c,4,2872
963,47730399,47732357,Protein coding,IonXpress_NONO_c,4,1958
964,47732499,47733138,Protein coding,IonXpress_NONO_c,4,639
965,47894934,47895639,Non coding,IonXpress_NONO_c,3,705
966,47894934,47895639,Non coding,IonXpress_SFPQt1,3,705
967,47895253,47895639,Non coding,IonXpress_NONO_c,9,386
968,47895253,47895639,Non coding,IonXpress_SFPQt1,9,386
969,47895275,47895639,Non coding,IonXpress_NONO_c,3,364
970,47895275,47895639,Non coding,IonXpress_SFPQt1,3,364
971,47895745,47897020,Non coding,IonXpress_NONO_c,12,1275
972,47895745,47897020,Non coding,IonXpress_SFPQt1,12,1275
973,47895745,47905580,Non coding,IonXpress_NONO_c,3,9835
974,47895745,47905580,Non coding,IonXpress_SFPQt1,3,9835
975,47897107,47897438,Non coding,IonXpress_NONO_c,6,331
976,47897107,47897438,Non coding,IonXpress_SFPQt1,6,331
977,47897107,47905580,Non coding,IonXpress_NONO_c,6,8473
978,47897107,47905580,Non coding,IonXpress_SFPQt1,6,8473
979,47897501,47905580,Non coding,IonXpress_NONO_c,6,8079
980,47897501,47905580,Non coding,IonXpress_SFPQt1,6,8079
981,49522721,49523023,Protein coding,IonXpress_NONO_c,4,302
982,49523173,49523281,Protein coding,IonXpress_NONO_c,4,108
983,49523505,49525079,Protein coding,IonXpress_NONO_c,2,1574
984,49990901,49993105,Protein coding,IonXpress_NONO_c,3,2204
985,49990901,49993105,Protein coding,IonXpress_SFPQt1,9,2204
986,49993169,49993487,Protein coding,IonXpress_NONO_c,1,318
987,49993169,49993487,Protein coding,IonXpress_SFPQt1,3,318
988,49993169,49993730,Protein coding,IonXpress_NONO_c,1,561
989,49993169,49993730,Protein coding,IonXpress_SFPQt1,3,561
990,49993179,49993487,Protein coding,IonXpress_NONO_c,1,308
991,49993179,49993487,Protein coding,IonXpress_SFPQt1,3,308
992,49993554,49993730,Protein coding,IonXpress_NONO_c,2,176
993,49993554,49993730,Protein coding,IonXpress_SFPQt1,6,176
994,49993833,49994034,Protein coding,IonXpress_NONO_c,3,201
995,49993833,49994034,Protein coding,IonXpress_SFPQt1,9,201
996,49994121,49994295,Protein coding,IonXpress_NONO_c,3,174
997,49994121,49994295,Protein coding,IonXpress_SFPQt1,9,174
998,49994356,49994680,Protein coding,IonXpress_NONO_c,3,324
999,49994356,49994680,Protein coding,IonXpress_SFPQt1,9,324
1000,49994804,49994984,Protein coding,IonXpress_NONO_c,3,180
1001,49994804,49994984,Protein coding,IonXpress_SFPQt1,9,180
1002,49999728,50000449,Protein coding,IonXpress_SFPQt1,1,721
1003,50000582,50000775,Protein coding,IonXpress_SFPQt1,1,193
1004,50000852,50001172,Protein coding,IonXpress_SFPQt1,1,320
1005,50001303,50002767,Protein coding,IonXpress_SFPQt1,1,1464
1006,50033049,50251353,Protein coding,IonXpress_SFPQt1,1,218304
1007,50251431,50251641,Protein coding,IonXpress_SFPQt1,1,210
1008,50251722,50251808,Protein coding,IonXpress_SFPQt1,1,86
1009,50251853,50251936,Protein coding,IonXpress_SFPQt1,1,83
1010,50252038,50253434,Protein coding,IonXpress_SFPQt1,1,1396
1011,50253468,50255862,Protein coding,IonXpress_SFPQt1,1,2394
1012,50256061,50256212,Protein coding,IonXpress_SFPQt1,1,151
1013,50256291,50262507,Protein coding,IonXpress_SFPQt1,1,6216
1014,50262662,50266191,Protein coding,IonXpress_SFPQt1,1,3529
1015,50266242,50266352,Protein coding,IonXpress_SFPQt1,1,110
1016,50266396,50267136,Protein coding,IonXpress_SFPQt1,1,740
1017,50267414,50269169,Protein coding,IonXpress_SFPQt1,1,1755
1018,50269291,50269385,Protein coding,IonXpress_SFPQt1,1,94
1019,50269445,50269953,Protein coding,IonXpress_SFPQt1,1,508
1020,50270012,50272737,Protein coding,IonXpress_SFPQt1,1,2725
1021,50272851,50280704,Protein coding,IonXpress_SFPQt1,1,7853
1022,50280768,50281470,Protein coding,IonXpress_SFPQt1,1,702
1023,50281575,50292583,Protein coding,IonXpress_SFPQt1,1,11008
1024,50292673,50295007,Protein coding,IonXpress_SFPQt1,1,2334
1025,50295072,50295332,Protein coding,IonXpress_SFPQt1,1,260
1026,50295525,50295770,Protein coding,IonXpress_SFPQt1,1,245
1027,50295980,50296065,Protein coding,IonXpress_SFPQt1,1,85
1028,50296144,50298015,Protein coding,IonXpress_SFPQt1,1,1871
1029,50298079,50298767,Protein coding,IonXpress_SFPQt1,1,688
1030,50298844,50298923,Protein coding,IonXpress_SFPQt1,1,79
1031,50298995,50300139,Protein coding,IonXpress_SFPQt1,1,1144
1032,50300214,50301079,Protein coding,IonXpress_SFPQt1,1,865
1033,50301167,50304855,Protein coding,IonXpress_SFPQt1,1,3688
1034,50304924,50307434,Protein coding,IonXpress_SFPQt1,1,2510
1035,50307584,50312856,Protein coding,IonXpress_SFPQt1,1,5272
1036,50312983,50318279,Protein coding,IonXpress_SFPQt1,1,5296
1037,50318383,50318523,Protein coding,IonXpress_SFPQt1,1,140
1038,50318593,50319411,Protein coding,IonXpress_SFPQt1,1,818
1039,50794811,50806186,Protein coding,IonXpress_SFPQt1,1,11375
1040,50794811,50821543,Protein coding,IonXpress_SFPQt1,5,26732
1041,50794811,50821546,Protein coding,IonXpress_SFPQt1,1,26735
1042,50806236,50821543,Protein coding,IonXpress_SFPQt1,1,15307
1043,50821692,50822698,Protein coding,IonXpress_SFPQt1,1,1006
1044,50821692,50822716,Protein coding,IonXpress_SFPQt1,7,1024
1045,50822873,50824276,Protein coding,IonXpress_SFPQt1,8,1403
1046,50824353,50829269,Protein coding,IonXpress_SFPQt1,8,4916
1047,50829407,50831516,Protein coding,IonXpress_SFPQt1,8,2109
1048,50831621,50834220,Protein coding,IonXpress_SFPQt1,9,2599
1049,50834332,50835371,Protein coding,IonXpress_SFPQt1,9,1039
1050,50835426,50847241,Protein coding,IonXpress_SFPQt1,7,11815
1051,50835426,50848095,Protein coding,IonXpress_SFPQt1,2,12669
1052,50847455,50848095,Protein coding,IonXpress_SFPQt1,7,640
1053,50848200,50854916,Protein coding,IonXpress_SFPQt1,7,6716
1054,50848200,50856363,Protein coding,IonXpress_SFPQt1,2,8163
1055,50855130,50856363,Protein coding,IonXpress_SFPQt1,5,1233
1056,50856413,50860740,Protein coding,IonXpress_SFPQt1,7,4327
1057,50860903,50867196,Protein coding,IonXpress_SFPQt1,7,6293
1058,50867319,50867780,Protein coding,IonXpress_SFPQt1,7,461
1059,50867890,50869307,Protein coding,IonXpress_SFPQt1,1,1417
1060,50867950,50869307,Protein coding,IonXpress_SFPQt1,6,1357
1061,51302215,51302549,Non coding,IonXpress_SFPQt1,1,334
1062,51302215,51302549,Protein coding,IonXpress_SFPQt1,2,334
1063,51302614,51305472,Non coding,IonXpress_SFPQt1,1,2858
1064,51302614,51305472,Protein coding,IonXpress_SFPQt1,2,2858
1065,51305514,51305709,Non coding,IonXpress_SFPQt1,1,195
1066,51305514,51305709,Protein coding,IonXpress_SFPQt1,1,195
1067,51305514,51307827,Protein coding,IonXpress_SFPQt1,1,2313
1068,51305871,51306808,Non coding,IonXpress_SFPQt1,1,937
1069,51305871,51307827,Protein coding,IonXpress_SFPQt1,1,1956
1070,52720071,52720783,Protein coding,IonXpress_NONO_c,1,712
1071,52720071,52720783,Protein coding,IonXpress_SFPQt1,1,712
1072,52720121,52720783,Protein coding,IonXpress_NONO_c,1,662
1073,52720121,52720783,Protein coding,IonXpress_SFPQt1,1,662
1074,52720218,52720783,Protein coding,IonXpress_NONO_c,1,565
1075,52720218,52720783,Protein coding,IonXpress_SFPQt1,1,565
1076,52720843,52721260,Protein coding,IonXpress_NONO_c,3,417
1077,52720843,52721260,Protein coding,IonXpress_SFPQt1,3,417
1078,52721399,52721516,Protein coding,IonXpress_NONO_c,3,117
1079,52721399,52721516,Protein coding,IonXpress_SFPQt1,3,117
1080,52721631,52722123,Protein coding,IonXpress_NONO_c,3,492
1081,52721631,52722123,Protein coding,IonXpress_SFPQt1,3,492
1082,52722208,52723088,Protein coding,IonXpress_NONO_c,3,880
1083,52722208,52723088,Protein coding,IonXpress_SFPQt1,3,880
1084,52723222,52724606,Protein coding,IonXpress_NONO_c,3,1384
1085,52723222,52724606,Protein coding,IonXpress_SFPQt1,3,1384
1086,52724720,52724959,Protein coding,IonXpress_NONO_c,3,239
1087,52724720,52724959,Protein coding,IonXpress_SFPQt1,3,239
1088,52725087,52725556,Protein coding,IonXpress_NONO_c,3,469
1089,52725087,52725556,Protein coding,IonXpress_SFPQt1,3,469
1090,52725645,52726886,Protein coding,IonXpress_NONO_c,3,1241
1091,52725645,52726886,Protein coding,IonXpress_SFPQt1,3,1241
1092,52727062,52727201,Protein coding,IonXpress_NONO_c,3,139
1093,52727062,52727201,Protein coding,IonXpress_SFPQt1,3,139
1094,52727345,52727422,Protein coding,IonXpress_NONO_c,3,77
1095,52727345,52727422,Protein coding,IonXpress_SFPQt1,3,77
1096,52727560,52727646,Protein coding,IonXpress_NONO_c,3,86
1097,52727560,52727646,Protein coding,IonXpress_SFPQt1,3,86
1098,52727823,52728051,Protein coding,IonXpress_NONO_c,3,228
1099,52727823,52728051,Protein coding,IonXpress_SFPQt1,3,228
1100,52728119,52728207,Protein coding,IonXpress_NONO_c,3,88
1101,52728119,52728207,Protein coding,IonXpress_SFPQt1,3,88
1102,55200334,55200697,Protein coding,IonXpress_NONO_c,5,363
1103,55200757,55200955,Protein coding,IonXpress_NONO_c,5,198
1104,55201003,55201829,Protein coding,IonXpress_NONO_c,5,826
1105,55201900,55209649,Protein coding,IonXpress_NONO_c,5,7749
1106,55209789,55214625,Protein coding,IonXpress_NONO_c,5,4836
1107,55214834,55237221,Protein coding,IonXpress_NONO_c,1,22387
1108,55214834,55252220,Protein coding,IonXpress_NONO_c,2,37386
1109,55214834,55255298,Protein coding,IonXpress_NONO_c,1,40464
1110,55214834,55276879,Protein coding,IonXpress_NONO_c,1,62045
1111,55254621,55255298,Protein coding,IonXpress_NONO_c,2,677
1112,55255356,55276213,Protein coding,IonXpress_NONO_c,1,20857
1113,55255356,55276879,Protein coding,IonXpress_NONO_c,2,21523
1114,62526676,62559686,Protein coding,IonXpress_NONO_c,1,33010
1115,62559805,62560663,Protein coding,IonXpress_NONO_c,1,858
1116,62560878,62562202,Protein coding,IonXpress_NONO_c,1,1324
1117,62562375,62562816,Protein coding,IonXpress_NONO_c,1,441
1118,62600603,62601088,Protein coding,IonXpress_NONO_c,1,485
1119,62600603,62601088,Protein coding,IonXpress_SFPQt1,4,485
1120,62601146,62601262,Protein coding,IonXpress_NONO_c,1,116
1121,62601146,62601262,Protein coding,IonXpress_SFPQt1,4,116
1122,62601409,62601746,Protein coding,IonXpress_NONO_c,1,337
1123,62601409,62601746,Protein coding,IonXpress_SFPQt1,4,337
1124,62601803,62601897,Protein coding,IonXpress_NONO_c,1,94
1125,62601803,62601897,Protein coding,IonXpress_SFPQt1,4,94
1126,62601999,62602901,Protein coding,IonXpress_NONO_c,1,902
1127,62601999,62602901,Protein coding,IonXpress_SFPQt1,4,902
1128,62603004,62603165,Protein coding,IonXpress_NONO_c,1,161
1129,62603004,62603165,Protein coding,IonXpress_SFPQt1,4,161
1130,62603313,62603431,Protein coding,IonXpress_NONO_c,1,118
1131,62603313,62603431,Protein coding,IonXpress_SFPQt1,4,118
1132,62603508,62606584,Protein coding,IonXpress_NONO_c,1,3076
1133,62603508,62606584,Protein coding,IonXpress_SFPQt1,4,3076
1134,62606707,62606792,Protein coding,IonXpress_NONO_c,1,85
1135,62606707,62606792,Protein coding,IonXpress_SFPQt1,4,85
1136,62606900,62606977,Protein coding,IonXpress_NONO_c,1,77
1137,62606900,62606977,Protein coding,IonXpress_SFPQt1,4,77
1138,62607339,62609039,Protein coding,IonXpress_NONO_c,1,1700
1139,62607339,62609039,Protein coding,IonXpress_SFPQt1,4,1700
1140,62620153,62620281,Non coding,IonXpress_NONO_c,8,128
1141,62620153,62620281,Non coding,IonXpress_SFPQt1,24,128
1142,62620311,62620545,Non coding,IonXpress_NONO_c,6,234
1143,62620311,62620545,Non coding,IonXpress_SFPQt1,18,234
1144,62620587,62621022,Non coding,IonXpress_NONO_c,6,435
1145,62620587,62621022,Non coding,IonXpress_SFPQt1,18,435
1146,62621062,62621271,Non coding,IonXpress_NONO_c,8,209
1147,62621062,62621271,Non coding,IonXpress_SFPQt1,24,209
1148,62621305,62621488,Non coding,IonXpress_NONO_c,6,183
1149,62621305,62621488,Non coding,IonXpress_SFPQt1,18,183
1150,62621536,62621989,Non coding,IonXpress_NONO_c,8,453
1151,62621536,62621989,Non coding,IonXpress_SFPQt1,24,453
1152,62622023,62622358,Non coding,IonXpress_NONO_c,8,335
1153,62622023,62622358,Non coding,IonXpress_SFPQt1,24,335
1154,62622410,62622603,Non coding,IonXpress_NONO_c,6,193
1155,62622410,62622603,Non coding,IonXpress_SFPQt1,18,193
1156,62622680,62622894,Non coding,IonXpress_NONO_c,2,214
1157,62622680,62622894,Non coding,IonXpress_SFPQt1,6,214
1158,62622688,62622894,Non coding,IonXpress_NONO_c,4,206
1159,62622688,62622894,Non coding,IonXpress_SFPQt1,12,206
1160,62622938,62623335,Non coding,IonXpress_NONO_c,2,397
1161,62622938,62623335,Non coding,IonXpress_SFPQt1,6,397
1162,63264227,63264351,Non coding,IonXpress_SFPQt1,4,124
1163,63264227,63264351,Protein coding,IonXpress_SFPQt1,2,124
1164,63264418,63466506,Non coding,IonXpress_SFPQt1,2,202088
1165,63264418,63466506,Protein coding,IonXpress_SFPQt1,2,202088
1166,63264418,63542217,Non coding,IonXpress_SFPQt1,2,277799
1167,63429145,63431218,Protein coding,IonXpress_SFPQt1,2,2073
1168,63429145,63466506,Non coding,IonXpress_SFPQt1,2,37361
1169,63429145,63466506,Protein coding,IonXpress_SFPQt1,2,37361
1170,63431252,63466506,Protein coding,IonXpress_SFPQt1,2,35254
1171,63466632,63542217,Protein coding,IonXpress_SFPQt1,6,75585
1172,63466632,63594799,Non coding,IonXpress_SFPQt1,4,128167
1173,63542417,63594799,Non coding,IonXpress_SFPQt1,2,52382
1174,63542417,63594799,Protein coding,IonXpress_SFPQt1,6,52382
1175,63594992,63600898,Non coding,IonXpress_SFPQt1,6,5906
1176,63594992,63600898,Protein coding,IonXpress_SFPQt1,6,5906
1177,64447772,64466442,Non coding,IonXpress_SFPQt1,1,18670
1178,64447772,64466442,Protein coding,IonXpress_SFPQt1,2,18670
1179,64466600,64468657,Non coding,IonXpress_SFPQt1,1,2057
1180,64466600,64468657,Protein coding,IonXpress_SFPQt1,2,2057
1181,64468835,64483841,Non coding,IonXpress_SFPQt1,1,15006
1182,64468835,64483841,Protein coding,IonXpress_SFPQt1,2,15006
1183,64484047,64492847,Non coding,IonXpress_SFPQt1,1,8800
1184,64484047,64492847,Protein coding,IonXpress_SFPQt1,2,8800
1185,64492978,64510619,Non coding,IonXpress_SFPQt1,1,17641
1186,64492978,64510619,Protein coding,IonXpress_SFPQt1,2,17641
1187,64510759,64511149,Non coding,IonXpress_SFPQt1,1,390
1188,64510759,64511149,Protein coding,IonXpress_SFPQt1,3,390
1189,64511314,64520145,Non coding,IonXpress_SFPQt1,1,8831
1190,64511314,64520145,Protein coding,IonXpress_SFPQt1,3,8831
1191,64520227,64520749,Non coding,IonXpress_SFPQt1,1,522
1192,64520227,64520749,Protein coding,IonXpress_SFPQt1,3,522
1193,64520874,64521911,Non coding,IonXpress_SFPQt1,1,1037
1194,64520874,64521911,Protein coding,IonXpress_SFPQt1,3,1037
1195,64522046,64537929,Non coding,IonXpress_SFPQt1,1,15883
1196,64522046,64537929,Protein coding,IonXpress_SFPQt1,3,15883
1197,64538033,64556425,Non coding,IonXpress_SFPQt1,1,18392
1198,64538033,64556425,Protein coding,IonXpress_SFPQt1,3,18392
1199,64556490,64558629,Non coding,IonXpress_SFPQt1,1,2139
1200,64556490,64558642,Protein coding,IonXpress_SFPQt1,3,2152
1201,64558789,64569165,Non coding,IonXpress_SFPQt1,1,10376
1202,64558789,64569165,Protein coding,IonXpress_SFPQt1,3,10376
1203,64569270,64587154,Non coding,IonXpress_SFPQt1,1,17884
1204,64569274,64587154,Protein coding,IonXpress_SFPQt1,3,17880
1205,64587297,64592933,Non coding,IonXpress_SFPQt1,1,5636
1206,64587297,64592933,Protein coding,IonXpress_SFPQt1,1,5636
1207,64587297,64595810,Protein coding,IonXpress_SFPQt1,2,8513
1208,64593071,64595810,Non coding,IonXpress_SFPQt1,1,2739
1209,64593071,64595810,Protein coding,IonXpress_SFPQt1,1,2739
1210,64595958,64625203,Non coding,IonXpress_SFPQt1,1,29245
1211,64595958,64625203,Protein coding,IonXpress_SFPQt1,3,29245
1212,64625310,64629867,Non coding,IonXpress_SFPQt1,1,4557
1213,64625310,64629867,Protein coding,IonXpress_SFPQt1,3,4557
1214,64629912,64747300,Non coding,IonXpress_SFPQt1,1,117388
1215,64629912,64747300,Protein coding,IonXpress_SFPQt1,3,117388
1216,64747447,64747958,Non coding,IonXpress_SFPQt1,1,511
1217,64747447,64747958,Protein coding,IonXpress_SFPQt1,3,511
1218,64748043,64748532,Protein coding,IonXpress_SFPQt1,2,489
1219,64748048,64748532,Non coding,IonXpress_SFPQt1,1,484
1220,64748048,64748532,Protein coding,IonXpress_SFPQt1,1,484
1221,64748745,64755995,Non coding,IonXpress_SFPQt1,1,7250
1222,64748745,64755995,Protein coding,IonXpress_SFPQt1,3,7250
1223,64756165,64766603,Non coding,IonXpress_SFPQt1,1,10438
1224,64756165,64766603,Protein coding,IonXpress_SFPQt1,3,10438
1225,64766969,64769402,Non coding,IonXpress_SFPQt1,1,2433
1226,64766969,64769402,Protein coding,IonXpress_SFPQt1,3,2433
1227,64769779,64777168,Non coding,IonXpress_SFPQt1,1,7389
1228,64769779,64777168,Protein coding,IonXpress_SFPQt1,1,7389
1229,64970809,64971493,Protein coding,IonXpress_SFPQt1,2,684
1230,64971664,64977965,Protein coding,IonXpress_SFPQt1,2,6301
1231,64971664,64988203,Protein coding,IonXpress_SFPQt1,4,16539
1232,64978102,64988203,Protein coding,IonXpress_SFPQt1,2,10101
1233,64990120,64998577,Protein coding,IonXpress_SFPQt1,2,8457
1234,65269864,65270106,Non coding,IonXpress_NONO_c,11,242
1235,65269864,65270106,Non coding,IonXpress_SFPQt1,1,242
1236,66791990,66792392,Protein coding,IonXpress_NONO_c,2,402
1237,66791990,66792392,Protein coding,IonXpress_SFPQt1,8,402
1238,66792514,66792629,Protein coding,IonXpress_NONO_c,2,115
1239,66792514,66792629,Protein coding,IonXpress_SFPQt1,8,115
1240,66792714,66793285,Protein coding,IonXpress_NONO_c,2,571
1241,66792714,66793285,Protein coding,IonXpress_SFPQt1,8,571
1242,66793443,66793711,Protein coding,IonXpress_NONO_c,2,268
1243,66793443,66793711,Protein coding,IonXpress_SFPQt1,8,268
1244,66793842,66794124,Protein coding,IonXpress_NONO_c,3,282
1245,66793842,66794124,Protein coding,IonXpress_SFPQt1,12,282
1246,66794250,66794948,Protein coding,IonXpress_NONO_c,3,698
1247,66794250,66794948,Protein coding,IonXpress_SFPQt1,12,698
1248,66795088,66795394,Protein coding,IonXpress_NONO_c,2,306
1249,66795088,66795394,Protein coding,IonXpress_SFPQt1,8,306
1250,66795502,66795694,Protein coding,IonXpress_NONO_c,3,192
1251,66795502,66795694,Protein coding,IonXpress_SFPQt1,12,192
1252,66795867,66797124,Protein coding,IonXpress_NONO_c,2,1257
1253,66795867,66797124,Protein coding,IonXpress_SFPQt1,8,1257
1254,66795867,66797664,Protein coding,IonXpress_NONO_c,1,1797
1255,66795867,66797664,Protein coding,IonXpress_SFPQt1,4,1797
1256,66798086,66816791,Protein coding,IonXpress_NONO_c,1,18705
1257,66798086,66816791,Protein coding,IonXpress_SFPQt1,4,18705
1258,67705526,67720238,Non coding,IonXpress_NONO_c,1,14712
1259,67720333,67721251,Non coding,IonXpress_NONO_c,1,918
1260,67721428,67890444,Non coding,IonXpress_NONO_c,1,169016
1261,67891263,67894655,Non coding,IonXpress_NONO_c,1,3392
1262,67894776,67939432,Non coding,IonXpress_NONO_c,1,44656
1263,67939533,67997563,Non coding,IonXpress_NONO_c,1,58030
1264,70481039,70482210,Non coding,IonXpress_NONO_c,1,1171
1265,70481039,70482210,Non coding,IonXpress_SFPQt1,1,1171
1266,70481039,70482210,Protein coding,IonXpress_NONO_c,4,1171
1267,70481039,70482210,Protein coding,IonXpress_SFPQt1,4,1171
1268,70481039,70496631,Protein coding,IonXpress_NONO_c,1,15592
1269,70481039,70496631,Protein coding,IonXpress_SFPQt1,1,15592
1270,70481045,70482210,Non coding,IonXpress_NONO_c,1,1165
1271,70481045,70482210,Non coding,IonXpress_SFPQt1,1,1165
1272,70481045,70482210,Protein coding,IonXpress_NONO_c,1,1165
1273,70481045,70482210,Protein coding,IonXpress_SFPQt1,1,1165
1274,70482334,70496631,Non coding,IonXpress_NONO_c,2,14297
1275,70482334,70496631,Non coding,IonXpress_SFPQt1,2,14297
1276,70482334,70496631,Protein coding,IonXpress_NONO_c,5,14297
1277,70482334,70496631,Protein coding,IonXpress_SFPQt1,5,14297
1278,70496805,70497600,Non coding,IonXpress_NONO_c,2,795
1279,70496805,70497600,Non coding,IonXpress_SFPQt1,2,795
1280,70496805,70497600,Protein coding,IonXpress_NONO_c,1,795
1281,70496805,70497600,Protein coding,IonXpress_SFPQt1,1,795
1282,70496805,70500384,Protein coding,IonXpress_NONO_c,3,3579
1283,70496805,70500384,Protein coding,IonXpress_SFPQt1,3,3579
1284,70496805,70502131,Protein coding,IonXpress_NONO_c,1,5326
1285,70496805,70502131,Protein coding,IonXpress_SFPQt1,1,5326
1286,70496805,70502183,Protein coding,IonXpress_NONO_c,1,5378
1287,70496805,70502183,Protein coding,IonXpress_SFPQt1,1,5378
1288,70497646,70500384,Non coding,IonXpress_NONO_c,2,2738
1289,70497646,70500384,Non coding,IonXpress_SFPQt1,2,2738
1290,70497646,70500384,Protein coding,IonXpress_NONO_c,1,2738
1291,70497646,70500384,Protein coding,IonXpress_SFPQt1,1,2738
1292,70500418,70502131,Non coding,IonXpress_NONO_c,2,1713
1293,70500418,70502131,Non coding,IonXpress_SFPQt1,2,1713
1294,70500418,70502131,Protein coding,IonXpress_NONO_c,4,1713
1295,70500418,70502131,Protein coding,IonXpress_SFPQt1,4,1713
1296,70502326,70506916,Non coding,IonXpress_NONO_c,2,4590
1297,70502326,70506916,Non coding,IonXpress_SFPQt1,2,4590
1298,70502326,70506916,Protein coding,IonXpress_NONO_c,6,4590
1299,70502326,70506916,Protein coding,IonXpress_SFPQt1,6,4590
1300,70507032,70507129,Non coding,IonXpress_NONO_c,2,97
1301,70507032,70507129,Non coding,IonXpress_SFPQt1,2,97
1302,70507032,70507129,Protein coding,IonXpress_NONO_c,6,97
1303,70507032,70507129,Protein coding,IonXpress_SFPQt1,6,97
1304,70507323,70508891,Non coding,IonXpress_NONO_c,2,1568
1305,70507323,70508891,Non coding,IonXpress_SFPQt1,2,1568
1306,70507323,70508891,Protein coding,IonXpress_NONO_c,6,1568
1307,70507323,70508891,Protein coding,IonXpress_SFPQt1,6,1568
1308,70509022,70509279,Non coding,IonXpress_NONO_c,2,257
1309,70509022,70509279,Non coding,IonXpress_SFPQt1,2,257
1310,70509022,70509279,Protein coding,IonXpress_NONO_c,6,257
1311,70509022,70509279,Protein coding,IonXpress_SFPQt1,6,257
1312,70509442,70513607,Non coding,IonXpress_NONO_c,2,4165
1313,70509442,70513607,Non coding,IonXpress_SFPQt1,2,4165
1314,70509442,70513607,Protein coding,IonXpress_NONO_c,6,4165
1315,70509442,70513607,Protein coding,IonXpress_SFPQt1,6,4165
1316,70513834,70514469,Non coding,IonXpress_NONO_c,2,635
1317,70513834,70514469,Non coding,IonXpress_SFPQt1,2,635
1318,70513834,70514469,Protein coding,IonXpress_NONO_c,6,635
1319,70513834,70514469,Protein coding,IonXpress_SFPQt1,6,635
1320,70514584,70515125,Non coding,IonXpress_NONO_c,2,541
1321,70514584,70515125,Non coding,IonXpress_SFPQt1,2,541
1322,70514584,70515125,Protein coding,IonXpress_NONO_c,6,541
1323,70514584,70515125,Protein coding,IonXpress_SFPQt1,6,541
1324,70515293,70516028,Protein coding,IonXpress_NONO_c,6,735
1325,70515293,70516028,Protein coding,IonXpress_SFPQt1,6,735
1326,70515293,70517049,Non coding,IonXpress_NONO_c,2,1756
1327,70515293,70517049,Non coding,IonXpress_SFPQt1,2,1756
1328,70516240,70517049,Protein coding,IonXpress_NONO_c,6,809
1329,70516240,70517049,Protein coding,IonXpress_SFPQt1,6,809
1330,70517134,70520762,Non coding,IonXpress_NONO_c,2,3628
1331,70517134,70520762,Non coding,IonXpress_SFPQt1,2,3628
1332,70517134,70520762,Protein coding,IonXpress_NONO_c,6,3628
1333,70517134,70520762,Protein coding,IonXpress_SFPQt1,6,3628
1334,70520949,70525643,Non coding,IonXpress_NONO_c,2,4694
1335,70520949,70525643,Non coding,IonXpress_SFPQt1,2,4694
1336,70520949,70525643,Protein coding,IonXpress_NONO_c,6,4694
1337,70520949,70525643,Protein coding,IonXpress_SFPQt1,6,4694
1338,70525836,70530961,Non coding,IonXpress_NONO_c,2,5125
1339,70525836,70530961,Non coding,IonXpress_SFPQt1,2,5125
1340,70525836,70530961,Protein coding,IonXpress_NONO_c,6,5125
1341,70525836,70530961,Protein coding,IonXpress_SFPQt1,6,5125
1342,70531202,70532743,Non coding,IonXpress_NONO_c,1,1541
1343,70531202,70532743,Non coding,IonXpress_SFPQt1,1,1541
1344,70531202,70532743,Protein coding,IonXpress_NONO_c,2,1541
1345,70531202,70532743,Protein coding,IonXpress_SFPQt1,2,1541
1346,70532856,70545891,Non coding,IonXpress_NONO_c,1,13035
1347,70532856,70545891,Non coding,IonXpress_SFPQt1,1,13035
1348,70532856,70545891,Protein coding,IonXpress_NONO_c,2,13035
1349,70532856,70545891,Protein coding,IonXpress_SFPQt1,2,13035
1350,70545975,70546301,Non coding,IonXpress_NONO_c,1,326
1351,70545975,70546301,Non coding,IonXpress_SFPQt1,1,326
1352,70545975,70546301,Protein coding,IonXpress_NONO_c,2,326
1353,70545975,70546301,Protein coding,IonXpress_SFPQt1,2,326
1354,70546449,70547682,Non coding,IonXpress_NONO_c,1,1233
1355,70546449,70547682,Non coding,IonXpress_SFPQt1,1,1233
1356,70546449,70547682,Protein coding,IonXpress_NONO_c,2,1233
1357,70546449,70547682,Protein coding,IonXpress_SFPQt1,2,1233
1358,70547804,70547898,Non coding,IonXpress_NONO_c,1,94
1359,70547804,70547898,Non coding,IonXpress_SFPQt1,1,94
1360,70547804,70547898,Protein coding,IonXpress_NONO_c,2,94
1361,70547804,70547898,Protein coding,IonXpress_SFPQt1,2,94
1362,70548085,70549465,Non coding,IonXpress_NONO_c,1,1380
1363,70548085,70549465,Non coding,IonXpress_SFPQt1,1,1380
1364,70548085,70549465,Protein coding,IonXpress_NONO_c,1,1380
1365,70548085,70549465,Protein coding,IonXpress_SFPQt1,1,1380
1366,70549672,70550962,Non coding,IonXpress_NONO_c,1,1290
1367,70549672,70550962,Non coding,IonXpress_SFPQt1,1,1290
1368,70549672,70550962,Protein coding,IonXpress_NONO_c,1,1290
1369,70549672,70550962,Protein coding,IonXpress_SFPQt1,1,1290
1370,70557831,70560488,Protein coding,IonXpress_SFPQt1,1,2657
1371,70560629,70562774,Protein coding,IonXpress_SFPQt1,1,2145
1372,70563102,70564646,Protein coding,IonXpress_SFPQt1,1,1544
1373,70564820,70566380,Protein coding,IonXpress_SFPQt1,1,1560
1374,70566523,70569209,Protein coding,IonXpress_SFPQt1,1,2686
1375,70569323,70572224,Protein coding,IonXpress_SFPQt1,1,2901
1376,70572363,70573005,Protein coding,IonXpress_SFPQt1,1,642
1377,70573110,70575570,Protein coding,IonXpress_SFPQt1,1,2460
1378,70575737,70578339,Protein coding,IonXpress_SFPQt1,1,2602
1379,70578436,70582271,Protein coding,IonXpress_SFPQt1,1,3835
1380,70582345,70588347,Protein coding,IonXpress_SFPQt1,1,6002
1381,70585561,70588842,Non coding,IonXpress_NONO_c,2,3281
1382,70585561,70588842,Non coding,IonXpress_SFPQt1,2,3281
1383,70585561,70588842,Protein coding,IonXpress_NONO_c,4,3281
1384,70585561,70588842,Protein coding,IonXpress_SFPQt1,4,3281
1385,70585561,70591611,Protein coding,IonXpress_NONO_c,2,6050
1386,70585561,70591611,Protein coding,IonXpress_SFPQt1,2,6050
1387,70588500,70588952,Protein coding,IonXpress_SFPQt1,1,452
1388,70588908,70591611,Non coding,IonXpress_NONO_c,2,2703
1389,70588908,70591611,Non coding,IonXpress_SFPQt1,2,2703
1390,70588908,70591611,Protein coding,IonXpress_NONO_c,4,2703
1391,70588908,70591611,Protein coding,IonXpress_SFPQt1,4,2703
1392,70589109,70590080,Protein coding,IonXpress_SFPQt1,1,971
1393,70590237,70590787,Protein coding,IonXpress_SFPQt1,1,550
1394,70590932,70594370,Protein coding,IonXpress_SFPQt1,1,3438
1395,70591854,70594417,Non coding,IonXpress_NONO_c,2,2563
1396,70591854,70594417,Non coding,IonXpress_SFPQt1,2,2563
1397,70591854,70594417,Protein coding,IonXpress_NONO_c,6,2563
1398,70591854,70594417,Protein coding,IonXpress_SFPQt1,6,2563
1399,70594494,70595531,Protein coding,IonXpress_SFPQt1,1,1037
1400,70594578,70617264,Protein coding,IonXpress_NONO_c,6,22686
1401,70594578,70617264,Protein coding,IonXpress_SFPQt1,6,22686
1402,70594578,70744000,Non coding,IonXpress_NONO_c,2,149422
1403,70594578,70744000,Non coding,IonXpress_SFPQt1,2,149422
1404,70595687,70597777,Protein coding,IonXpress_SFPQt1,1,2090
1405,70597953,70598966,Protein coding,IonXpress_SFPQt1,1,1013
1406,70599173,70599269,Protein coding,IonXpress_SFPQt1,1,96
1407,70599427,70601312,Protein coding,IonXpress_SFPQt1,1,1885
1408,70601439,70602184,Protein coding,IonXpress_SFPQt1,1,745
1409,70602398,70602944,Protein coding,IonXpress_SFPQt1,1,546
1410,70603044,70603907,Protein coding,IonXpress_SFPQt1,1,863
1411,70604052,70604996,Protein coding,IonXpress_SFPQt1,1,944
1412,70605102,70605574,Protein coding,IonXpress_SFPQt1,1,472
1413,70617464,70650273,Protein coding,IonXpress_NONO_c,4,32809
1414,70617464,70650273,Protein coding,IonXpress_SFPQt1,4,32809
1415,70617464,70667657,Protein coding,IonXpress_NONO_c,2,50193
1416,70617464,70667657,Protein coding,IonXpress_SFPQt1,2,50193
1417,70650439,70667657,Protein coding,IonXpress_NONO_c,4,17218
1418,70650439,70667657,Protein coding,IonXpress_SFPQt1,4,17218
1419,70667876,70673976,Protein coding,IonXpress_NONO_c,6,6100
1420,70667876,70673976,Protein coding,IonXpress_SFPQt1,6,6100
1421,70674110,70744000,Protein coding,IonXpress_NONO_c,6,69890
1422,70674110,70744000,Protein coding,IonXpress_SFPQt1,6,69890
1423,70745404,70747087,Protein coding,IonXpress_NONO_c,2,1683
1424,70745404,70747087,Protein coding,IonXpress_SFPQt1,2,1683
1425,71963581,71963953,Protein coding,IonXpress_SFPQt1,2,372
1426,71964086,71967321,Protein coding,IonXpress_SFPQt1,2,3235
1427,71967424,71967816,Protein coding,IonXpress_SFPQt1,2,392
1428,71968028,71969259,Protein coding,IonXpress_SFPQt1,2,1231
1429,71969421,71971193,Protein coding,IonXpress_SFPQt1,2,1772
1430,71971322,71976461,Protein coding,IonXpress_SFPQt1,2,5139
1431,71976927,71977931,Protein coding,IonXpress_SFPQt1,2,1004
1432,71978073,71981393,Protein coding,IonXpress_SFPQt1,2,3320
1433,71981419,71981420,Protein coding,IonXpress_SFPQt1,2,1
1434,71981490,71983680,Protein coding,IonXpress_SFPQt1,2,2190
1435,71983916,71984015,Protein coding,IonXpress_SFPQt1,2,99
1436,71984209,71985461,Protein coding,IonXpress_SFPQt1,2,1252
1437,71985643,71986791,Protein coding,IonXpress_SFPQt1,2,1148
1438,71986992,71988002,Protein coding,IonXpress_SFPQt1,2,1010
1439,71988200,71997102,Protein coding,IonXpress_SFPQt1,2,8902
1440,71997250,72001034,Protein coding,IonXpress_SFPQt1,2,3784
1441,72001214,72001803,Protein coding,IonXpress_SFPQt1,2,589
1442,72001906,72003772,Protein coding,IonXpress_SFPQt1,2,1866
1443,72004004,72007221,Protein coding,IonXpress_SFPQt1,2,3217
1444,72007416,72011133,Protein coding,IonXpress_SFPQt1,2,3717
1445,72011366,72012152,Protein coding,IonXpress_SFPQt1,2,786
1446,72012282,72013683,Protein coding,IonXpress_SFPQt1,2,1401
1447,72013811,72013904,Protein coding,IonXpress_SFPQt1,2,93
1448,72014029,72015952,Protein coding,IonXpress_SFPQt1,2,1923
1449,72016134,72017933,Protein coding,IonXpress_SFPQt1,2,1799
1450,72018066,72020118,Protein coding,IonXpress_SFPQt1,2,2052
1451,72020368,72024177,Protein coding,IonXpress_SFPQt1,2,3809
1452,72024228,72027113,Protein coding,IonXpress_SFPQt1,2,2885
1453,72027231,72032169,Protein coding,IonXpress_SFPQt1,2,4938
1454,72032293,72033581,Protein coding,IonXpress_SFPQt1,2,1288
1455,73249386,73251429,Non coding,IonXpress_NONO_c,1,2043
1456,73251675,73494175,Non coding,IonXpress_NONO_c,1,242500
1457,73423744,73461766,Non coding,IonXpress_NONO_c,1,38022
1458,73494245,73500227,Non coding,IonXpress_NONO_c,1,5982
1459,73500329,73500764,Non coding,IonXpress_NONO_c,1,435
1460,73500920,73501535,Non coding,IonXpress_NONO_c,1,615
1461,73501683,73513185,Non coding,IonXpress_NONO_c,1,11502
1462,74553939,74555025,Non coding,IonXpress_SFPQt1,2,1086
1463,74553939,74557368,Non coding,IonXpress_SFPQt1,2,3429
1464,74555125,74557368,Non coding,IonXpress_SFPQt1,3,2243
1465,74557480,74559199,Non coding,IonXpress_SFPQt1,3,1719
1466,74557484,74559199,Non coding,IonXpress_SFPQt1,2,1715
1467,75085031,75085233,Protein coding,IonXpress_NONO_c,2,202
1468,75085031,75085233,Protein coding,IonXpress_SFPQt1,2,202
1469,75085353,75089324,Protein coding,IonXpress_NONO_c,2,3971
1470,75085353,75089324,Protein coding,IonXpress_SFPQt1,2,3971
1471,75085353,75138726,Protein coding,IonXpress_NONO_c,1,53373
1472,75085353,75138726,Protein coding,IonXpress_SFPQt1,1,53373
1473,75089429,75138726,Protein coding,IonXpress_NONO_c,2,49297
1474,75089429,75138726,Protein coding,IonXpress_SFPQt1,2,49297
1475,75110621,75111736,Protein coding,IonXpress_SFPQt1,3,1115
1476,75110621,75112682,Protein coding,IonXpress_SFPQt1,1,2061
1477,75111868,75112682,Protein coding,IonXpress_SFPQt1,3,814
1478,75112777,75113346,Protein coding,IonXpress_SFPQt1,1,569
1479,75112777,75113394,Protein coding,IonXpress_SFPQt1,3,617
1480,75113490,75115062,Protein coding,IonXpress_SFPQt1,4,1572
1481,75115251,75115714,Protein coding,IonXpress_SFPQt1,4,463
1482,75115912,75116625,Protein coding,IonXpress_SFPQt1,1,713
1483,75115912,75116656,Protein coding,IonXpress_SFPQt1,2,744
1484,75115912,75132769,Protein coding,IonXpress_SFPQt1,1,16857
1485,75137136,75138726,Protein coding,IonXpress_NONO_c,1,1590
1486,75137136,75138726,Protein coding,IonXpress_SFPQt1,1,1590
1487,75137189,75138726,Protein coding,IonXpress_NONO_c,2,1537
1488,75137189,75138726,Protein coding,IonXpress_SFPQt1,2,1537
1489,75137189,75138730,Protein coding,IonXpress_NONO_c,1,1541
1490,75137189,75138730,Protein coding,IonXpress_SFPQt1,1,1541
1491,75138832,75139647,Protein coding,IonXpress_NONO_c,7,815
1492,75138832,75139647,Protein coding,IonXpress_SFPQt1,7,815
1493,75139741,75186883,Protein coding,IonXpress_NONO_c,7,47142
1494,75139741,75186883,Protein coding,IonXpress_SFPQt1,7,47142
1495,75187034,75187261,Protein coding,IonXpress_NONO_c,7,227
1496,75187034,75187261,Protein coding,IonXpress_SFPQt1,7,227
1497,75187394,75189501,Protein coding,IonXpress_NONO_c,7,2107
1498,75187394,75189501,Protein coding,IonXpress_SFPQt1,7,2107
1499,75189631,75190757,Protein coding,IonXpress_NONO_c,7,1126
1500,75189631,75190757,Protein coding,IonXpress_SFPQt1,7,1126
1501,75190993,75192282,Protein coding,IonXpress_NONO_c,7,1289
1502,75190993,75192282,Protein coding,IonXpress_SFPQt1,7,1289
1503,75192393,75196564,Protein coding,IonXpress_NONO_c,7,4171
1504,75192393,75196564,Protein coding,IonXpress_SFPQt1,7,4171
1505,75196755,75199650,Protein coding,IonXpress_NONO_c,7,2895
1506,75196755,75199650,Protein coding,IonXpress_SFPQt1,7,2895
1507,75199740,75201356,Protein coding,IonXpress_NONO_c,7,1616
1508,75199740,75201356,Protein coding,IonXpress_SFPQt1,7,1616
1509,75201428,75202309,Protein coding,IonXpress_NONO_c,7,881
1510,75201428,75202309,Protein coding,IonXpress_SFPQt1,7,881
1511,75202482,75202808,Protein coding,IonXpress_NONO_c,6,326
1512,75202482,75202808,Protein coding,IonXpress_SFPQt1,6,326
1513,75202944,75205422,Protein coding,IonXpress_NONO_c,6,2478
1514,75202944,75205422,Protein coding,IonXpress_SFPQt1,6,2478
1515,75205558,75208030,Protein coding,IonXpress_NONO_c,6,2472
1516,75205558,75208030,Protein coding,IonXpress_SFPQt1,6,2472
1517,75208283,75209394,Protein coding,IonXpress_NONO_c,6,1111
1518,75208283,75209394,Protein coding,IonXpress_SFPQt1,6,1111
1519,75209574,75209998,Protein coding,IonXpress_NONO_c,6,424
1520,75209574,75209998,Protein coding,IonXpress_SFPQt1,6,424
1521,75210101,75212629,Protein coding,IonXpress_NONO_c,2,2528
1522,75210101,75212629,Protein coding,IonXpress_SFPQt1,2,2528
1523,76251959,76253180,Non coding,IonXpress_NONO_c,4,1221
1524,76251959,76253180,Non coding,IonXpress_SFPQt1,2,1221
1525,76251959,76253180,Protein coding,IonXpress_NONO_c,4,1221
1526,76251959,76253180,Protein coding,IonXpress_SFPQt1,2,1221
1527,76253289,76254842,Non coding,IonXpress_NONO_c,4,1553
1528,76253289,76254842,Non coding,IonXpress_SFPQt1,2,1553
1529,76253289,76254842,Protein coding,IonXpress_NONO_c,4,1553
1530,76253289,76254842,Protein coding,IonXpress_SFPQt1,2,1553
1531,76255041,76255635,Non coding,IonXpress_NONO_c,4,594
1532,76255041,76255635,Non coding,IonXpress_SFPQt1,2,594
1533,76255041,76255635,Protein coding,IonXpress_NONO_c,4,594
1534,76255041,76255635,Protein coding,IonXpress_SFPQt1,2,594
1535,76255742,76255835,Non coding,IonXpress_NONO_c,4,93
1536,76255742,76255835,Non coding,IonXpress_SFPQt1,2,93
1537,76255742,76256968,Protein coding,IonXpress_NONO_c,4,1226
1538,76255742,76256968,Protein coding,IonXpress_SFPQt1,2,1226
1539,76255959,76256129,Non coding,IonXpress_NONO_c,4,170
1540,76255959,76256129,Non coding,IonXpress_SFPQt1,2,170
1541,76256202,76256968,Non coding,IonXpress_NONO_c,4,766
1542,76256202,76256968,Non coding,IonXpress_SFPQt1,2,766
1543,76257022,76257144,Non coding,IonXpress_NONO_c,4,122
1544,76257022,76257144,Non coding,IonXpress_SFPQt1,2,122
1545,76257022,76257144,Protein coding,IonXpress_NONO_c,4,122
1546,76257022,76257144,Protein coding,IonXpress_SFPQt1,2,122
1547,76257256,76257864,Non coding,IonXpress_NONO_c,4,608
1548,76257256,76257864,Non coding,IonXpress_SFPQt1,2,608
1549,76257256,76257864,Protein coding,IonXpress_NONO_c,4,608
1550,76257256,76257864,Protein coding,IonXpress_SFPQt1,2,608
1551,76257991,76259767,Non coding,IonXpress_NONO_c,4,1776
1552,76257991,76259767,Non coding,IonXpress_SFPQt1,2,1776
1553,76257991,76259767,Protein coding,IonXpress_NONO_c,4,1776
1554,76257991,76259767,Protein coding,IonXpress_SFPQt1,2,1776
1555,76259918,76260193,Non coding,IonXpress_NONO_c,4,275
1556,76259918,76260193,Non coding,IonXpress_SFPQt1,2,275
1557,76259918,76260193,Protein coding,IonXpress_NONO_c,4,275
1558,76259918,76260193,Protein coding,IonXpress_SFPQt1,2,275
1559,76782073,76785591,Non coding,IonXpress_NONO_c,1,3518
1560,76782073,76785591,Non coding,IonXpress_SFPQt1,1,3518
1561,76782073,76785591,Protein coding,IonXpress_NONO_c,1,3518
1562,76782073,76785591,Protein coding,IonXpress_SFPQt1,1,3518
1563,76785680,76787340,Non coding,IonXpress_NONO_c,1,1660
1564,76785680,76787340,Non coding,IonXpress_SFPQt1,1,1660
1565,76785680,76787340,Protein coding,IonXpress_NONO_c,1,1660
1566,76785680,76787340,Protein coding,IonXpress_SFPQt1,1,1660
1567,76787505,76788464,Protein coding,IonXpress_NONO_c,1,959
1568,76787505,76788464,Protein coding,IonXpress_SFPQt1,1,959
1569,76787671,76788464,Non coding,IonXpress_NONO_c,1,793
1570,76787671,76788464,Non coding,IonXpress_SFPQt1,1,793
1571,76787671,76788464,Protein coding,IonXpress_NONO_c,1,793
1572,76787671,76788464,Protein coding,IonXpress_SFPQt1,1,793
1573,76788572,76793176,Non coding,IonXpress_NONO_c,1,4604
1574,76788572,76793176,Non coding,IonXpress_SFPQt1,1,4604
1575,76788572,76793176,Protein coding,IonXpress_NONO_c,2,4604
1576,76788572,76793176,Protein coding,IonXpress_SFPQt1,2,4604
1577,76793320,76794278,Non coding,IonXpress_NONO_c,1,958
1578,76793320,76794278,Non coding,IonXpress_SFPQt1,1,958
1579,76793320,76794278,Protein coding,IonXpress_NONO_c,2,958
1580,76793320,76794278,Protein coding,IonXpress_SFPQt1,2,958
1581,76794465,76797438,Non coding,IonXpress_NONO_c,1,2973
1582,76794465,76797438,Non coding,IonXpress_SFPQt1,1,2973
1583,76794465,76797438,Protein coding,IonXpress_NONO_c,2,2973
1584,76794465,76797438,Protein coding,IonXpress_SFPQt1,2,2973
1585,76797826,76802482,Non coding,IonXpress_NONO_c,1,4656
1586,76797826,76802482,Non coding,IonXpress_SFPQt1,1,4656
1587,76797826,76804077,Protein coding,IonXpress_NONO_c,2,6251
1588,76797826,76804077,Protein coding,IonXpress_SFPQt1,2,6251
1589,76803138,76804077,Non coding,IonXpress_NONO_c,1,939
1590,76803138,76804077,Non coding,IonXpress_SFPQt1,1,939
1591,76804228,76804317,Non coding,IonXpress_NONO_c,1,89
1592,76804228,76804317,Non coding,IonXpress_SFPQt1,1,89
1593,76804228,76804317,Protein coding,IonXpress_NONO_c,2,89
1594,76804228,76804317,Protein coding,IonXpress_SFPQt1,2,89
1595,76804355,76805745,Non coding,IonXpress_NONO_c,1,1390
1596,76804355,76805745,Non coding,IonXpress_SFPQt1,1,1390
1597,76804355,76805745,Protein coding,IonXpress_NONO_c,2,1390
1598,76804355,76805745,Protein coding,IonXpress_SFPQt1,2,1390
1599,76805913,76808003,Non coding,IonXpress_NONO_c,1,2090
1600,76805913,76808003,Non coding,IonXpress_SFPQt1,1,2090
1601,76805913,76808003,Protein coding,IonXpress_NONO_c,2,2090
1602,76805913,76808003,Protein coding,IonXpress_SFPQt1,2,2090
1603,76808051,76809365,Non coding,IonXpress_NONO_c,1,1314
1604,76808051,76809365,Non coding,IonXpress_SFPQt1,1,1314
1605,76808051,76809365,Protein coding,IonXpress_NONO_c,2,1314
1606,76808051,76809365,Protein coding,IonXpress_SFPQt1,2,1314
1607,76809481,76811108,Protein coding,IonXpress_NONO_c,2,1627
1608,76809481,76811108,Protein coding,IonXpress_SFPQt1,2,1627
1609,76809484,76811108,Non coding,IonXpress_NONO_c,1,1624
1610,76809484,76811108,Non coding,IonXpress_SFPQt1,1,1624
1611,76811285,76812799,Non coding,IonXpress_NONO_c,1,1514
1612,76811285,76812799,Non coding,IonXpress_SFPQt1,1,1514
1613,76811285,76812799,Protein coding,IonXpress_NONO_c,2,1514
1614,76811285,76812799,Protein coding,IonXpress_SFPQt1,2,1514
1615,76812858,76813002,Non coding,IonXpress_NONO_c,1,144
1616,76812858,76813002,Non coding,IonXpress_SFPQt1,1,144
1617,76812858,76813002,Protein coding,IonXpress_NONO_c,2,144
1618,76812858,76813002,Protein coding,IonXpress_SFPQt1,2,144
1619,76813131,76817422,Non coding,IonXpress_NONO_c,1,4291
1620,76813131,76817422,Non coding,IonXpress_SFPQt1,1,4291
1621,76813131,76817422,Protein coding,IonXpress_NONO_c,2,4291
1622,76813131,76817422,Protein coding,IonXpress_SFPQt1,2,4291
1623,76817536,76823381,Protein coding,IonXpress_NONO_c,1,5845
1624,76817536,76823381,Protein coding,IonXpress_SFPQt1,1,5845
1625,76817557,76823381,Non coding,IonXpress_NONO_c,1,5824
1626,76817557,76823381,Non coding,IonXpress_SFPQt1,1,5824
1627,76987323,76989089,Protein coding,IonXpress_NONO_c,1,1766
1628,76989177,77004065,Protein coding,IonXpress_NONO_c,2,14888
1629,77004172,77072027,Protein coding,IonXpress_NONO_c,2,67855
1630,77532226,77553523,Protein coding,IonXpress_NONO_c,3,21297
1631,77532226,77553523,Protein coding,IonXpress_SFPQt1,1,21297
1632,77532287,77552063,Protein coding,IonXpress_NONO_c,3,19776
1633,77532287,77552063,Protein coding,IonXpress_SFPQt1,1,19776
1634,77552106,77553523,Protein coding,IonXpress_NONO_c,3,1417
1635,77552106,77553523,Protein coding,IonXpress_SFPQt1,1,1417
1636,77553674,77580766,Protein coding,IonXpress_NONO_c,6,27092
1637,77553674,77580766,Protein coding,IonXpress_SFPQt1,2,27092
1638,77580863,77587994,Protein coding,IonXpress_NONO_c,3,7131
1639,77580863,77587994,Protein coding,IonXpress_SFPQt1,1,7131
1640,77580863,77629105,Protein coding,IonXpress_NONO_c,3,48242
1641,77580863,77629105,Protein coding,IonXpress_SFPQt1,1,48242
1642,77588095,77611615,Protein coding,IonXpress_NONO_c,3,23520
1643,77588095,77611615,Protein coding,IonXpress_SFPQt1,1,23520
1644,77590173,77594876,Non coding,IonXpress_NONO_c,3,4703
1645,77590173,77594876,Non coding,IonXpress_SFPQt1,1,4703
1646,77590173,77594876,Protein coding,IonXpress_NONO_c,3,4703
1647,77590173,77594876,Protein coding,IonXpress_SFPQt1,1,4703
1648,77594998,77602363,Non coding,IonXpress_NONO_c,3,7365
1649,77594998,77602363,Non coding,IonXpress_SFPQt1,1,7365
1650,77594998,77602363,Protein coding,IonXpress_NONO_c,3,7365
1651,77594998,77602363,Protein coding,IonXpress_SFPQt1,1,7365
1652,77602508,77602725,Non coding,IonXpress_NONO_c,3,217
1653,77602508,77602725,Non coding,IonXpress_SFPQt1,1,217
1654,77602508,77602725,Protein coding,IonXpress_NONO_c,3,217
1655,77602508,77602725,Protein coding,IonXpress_SFPQt1,1,217
1656,77602886,77605334,Non coding,IonXpress_NONO_c,3,2448
1657,77602886,77605334,Non coding,IonXpress_SFPQt1,1,2448
1658,77602886,77605334,Protein coding,IonXpress_NONO_c,3,2448
1659,77602886,77605334,Protein coding,IonXpress_SFPQt1,1,2448
1660,77605395,77612465,Non coding,IonXpress_NONO_c,3,7070
1661,77605395,77612465,Non coding,IonXpress_SFPQt1,1,7070
1662,77605395,77612465,Protein coding,IonXpress_NONO_c,3,7070
1663,77605395,77612465,Protein coding,IonXpress_SFPQt1,1,7070
1664,77612597,77614584,Non coding,IonXpress_NONO_c,3,1987
1665,77612597,77614584,Non coding,IonXpress_SFPQt1,1,1987
1666,77612597,77614584,Protein coding,IonXpress_NONO_c,3,1987
1667,77612597,77614584,Protein coding,IonXpress_SFPQt1,1,1987
1668,77614666,77618761,Non coding,IonXpress_NONO_c,3,4095
1669,77614666,77618761,Non coding,IonXpress_SFPQt1,1,4095
1670,77614666,77618761,Protein coding,IonXpress_NONO_c,3,4095
1671,77614666,77618761,Protein coding,IonXpress_SFPQt1,1,4095
1672,77618856,77622014,Non coding,IonXpress_NONO_c,3,3158
1673,77618856,77622014,Non coding,IonXpress_SFPQt1,1,3158
1674,77618856,77629865,Protein coding,IonXpress_NONO_c,3,11009
1675,77618856,77629865,Protein coding,IonXpress_SFPQt1,1,11009
1676,77622198,77629075,Non coding,IonXpress_NONO_c,3,6877
1677,77622198,77629075,Non coding,IonXpress_SFPQt1,1,6877
1678,77629310,77629865,Non coding,IonXpress_NONO_c,3,555
1679,77629310,77629865,Non coding,IonXpress_SFPQt1,1,555
1680,77630024,77632384,Non coding,IonXpress_NONO_c,3,2360
1681,77630024,77632384,Non coding,IonXpress_SFPQt1,1,2360
1682,77630024,77632384,Protein coding,IonXpress_NONO_c,3,2360
1683,77630024,77632384,Protein coding,IonXpress_SFPQt1,1,2360
1684,77632519,77633400,Non coding,IonXpress_NONO_c,3,881
1685,77632519,77633400,Non coding,IonXpress_SFPQt1,1,881
1686,77632519,77633400,Protein coding,IonXpress_NONO_c,3,881
1687,77632519,77633400,Protein coding,IonXpress_SFPQt1,1,881
1688,77633517,77635794,Non coding,IonXpress_NONO_c,3,2277
1689,77633517,77635794,Non coding,IonXpress_SFPQt1,1,2277
1690,77633517,77635794,Protein coding,IonXpress_NONO_c,3,2277
1691,77633517,77635794,Protein coding,IonXpress_SFPQt1,1,2277
1692,77635938,77639386,Non coding,IonXpress_NONO_c,3,3448
1693,77635938,77639386,Non coding,IonXpress_SFPQt1,1,3448
1694,77635938,77639386,Protein coding,IonXpress_NONO_c,3,3448
1695,77635938,77639386,Protein coding,IonXpress_SFPQt1,1,3448
1696,77639593,77649695,Non coding,IonXpress_NONO_c,3,10102
1697,77639593,77649695,Non coding,IonXpress_SFPQt1,1,10102
1698,77639593,77649695,Protein coding,IonXpress_NONO_c,3,10102
1699,77639593,77649695,Protein coding,IonXpress_SFPQt1,1,10102
1700,77649871,77652224,Non coding,IonXpress_NONO_c,3,2353
1701,77649871,77652224,Non coding,IonXpress_SFPQt1,1,2353
1702,77649871,77652224,Protein coding,IonXpress_NONO_c,3,2353
1703,77649871,77652224,Protein coding,IonXpress_SFPQt1,1,2353
1704,77652297,77666986,Non coding,IonXpress_NONO_c,3,14689
1705,77652297,77666986,Non coding,IonXpress_SFPQt1,1,14689
1706,77652297,77666986,Protein coding,IonXpress_NONO_c,3,14689
1707,77652297,77666986,Protein coding,IonXpress_SFPQt1,1,14689
1708,77667108,77669790,Non coding,IonXpress_NONO_c,3,2682
1709,77667108,77669790,Non coding,IonXpress_SFPQt1,1,2682
1710,77667108,77669790,Protein coding,IonXpress_NONO_c,3,2682
1711,77667108,77669790,Protein coding,IonXpress_SFPQt1,1,2682
1712,77669880,77671385,Non coding,IonXpress_NONO_c,3,1505
1713,77669880,77671385,Non coding,IonXpress_SFPQt1,1,1505
1714,77669880,77671385,Protein coding,IonXpress_NONO_c,3,1505
1715,77669880,77671385,Protein coding,IonXpress_SFPQt1,1,1505
1716,77671437,77671997,Non coding,IonXpress_NONO_c,3,560
1717,77671437,77671997,Non coding,IonXpress_SFPQt1,1,560
1718,77671437,77671997,Protein coding,IonXpress_NONO_c,3,560
1719,77671437,77671997,Protein coding,IonXpress_SFPQt1,1,560
1720,77672184,77690040,Protein coding,IonXpress_NONO_c,3,17856
1721,77672184,77690040,Protein coding,IonXpress_SFPQt1,1,17856
1722,77672184,77692503,Non coding,IonXpress_NONO_c,3,20319
1723,77672184,77692503,Non coding,IonXpress_SFPQt1,1,20319
1724,77690148,77692503,Protein coding,IonXpress_NONO_c,3,2355
1725,77690148,77692503,Protein coding,IonXpress_SFPQt1,1,2355
1726,77692622,77702152,Non coding,IonXpress_NONO_c,3,9530
1727,77692622,77702152,Non coding,IonXpress_SFPQt1,1,9530
1728,77692622,77702152,Protein coding,IonXpress_NONO_c,3,9530
1729,77692622,77702152,Protein coding,IonXpress_SFPQt1,1,9530
1730,77702345,77705634,Non coding,IonXpress_NONO_c,3,3289
1731,77702345,77705634,Non coding,IonXpress_SFPQt1,1,3289
1732,77702345,77705634,Protein coding,IonXpress_NONO_c,3,3289
1733,77702345,77705634,Protein coding,IonXpress_SFPQt1,1,3289
1734,77733856,77737596,Protein coding,IonXpress_NONO_c,2,3740
1735,77733856,77737596,Protein coding,IonXpress_SFPQt1,1,3740
1736,77737701,77793849,Protein coding,IonXpress_NONO_c,2,56148
1737,77737701,77793849,Protein coding,IonXpress_SFPQt1,1,56148
1738,80478183,80521228,Protein coding,IonXpress_SFPQt1,6,43045
1739,80521424,80525928,Protein coding,IonXpress_SFPQt1,6,4504
1740,80526077,80529598,Protein coding,IonXpress_SFPQt1,6,3521
1741,80529746,80540615,Protein coding,IonXpress_SFPQt1,4,10869
1742,80529746,80559177,Protein coding,IonXpress_SFPQt1,2,29431
1743,80540810,80541887,Protein coding,IonXpress_SFPQt1,4,1077
1744,80542064,80543778,Protein coding,IonXpress_SFPQt1,4,1714
1745,80544076,80544937,Protein coding,IonXpress_SFPQt1,4,861
1746,80545148,80553656,Protein coding,IonXpress_SFPQt1,2,8508
1747,80545148,80559177,Protein coding,IonXpress_SFPQt1,2,14029
1748,80551830,80553656,Non coding,IonXpress_SFPQt1,2,1826
1749,80554067,80557966,Non coding,IonXpress_SFPQt1,2,3899
1750,80554067,80559177,Non coding,IonXpress_SFPQt1,2,5110
1751,80558120,80559177,Non coding,IonXpress_SFPQt1,2,1057
1752,83170967,83173043,Protein coding,IonXpress_NONO_c,1,2076
1753,83170967,83173043,Protein coding,IonXpress_SFPQt1,1,2076
1754,83173136,83177749,Protein coding,IonXpress_NONO_c,1,4613
1755,83173136,83177749,Protein coding,IonXpress_SFPQt1,1,4613
1756,83177860,83180242,Protein coding,IonXpress_NONO_c,1,2382
1757,83177860,83180242,Protein coding,IonXpress_SFPQt1,1,2382
1758,83180416,83182667,Protein coding,IonXpress_NONO_c,1,2251
1759,83180416,83182667,Protein coding,IonXpress_SFPQt1,1,2251
1760,83182770,83183768,Protein coding,IonXpress_NONO_c,1,998
1761,83182770,83183768,Protein coding,IonXpress_SFPQt1,1,998
1762,83183820,83195170,Protein coding,IonXpress_NONO_c,1,11350
1763,83183820,83195170,Protein coding,IonXpress_SFPQt1,1,11350
1764,83195271,83243749,Protein coding,IonXpress_NONO_c,1,48478
1765,83195271,83243749,Protein coding,IonXpress_SFPQt1,1,48478
1766,83243826,83252723,Protein coding,IonXpress_NONO_c,1,8897
1767,83243826,83252723,Protein coding,IonXpress_SFPQt1,1,8897
1768,83252901,83344252,Protein coding,IonXpress_NONO_c,1,91351
1769,83252901,83344252,Protein coding,IonXpress_SFPQt1,1,91351
1770,83344368,83497731,Protein coding,IonXpress_NONO_c,1,153363
1771,83344368,83497731,Protein coding,IonXpress_SFPQt1,1,153363
1772,83497835,83544655,Protein coding,IonXpress_NONO_c,1,46820
1773,83497835,83544655,Protein coding,IonXpress_SFPQt1,1,46820
1774,83544813,83585461,Protein coding,IonXpress_NONO_c,1,40648
1775,83544813,83585461,Protein coding,IonXpress_SFPQt1,1,40648
1776,83585531,83641369,Protein coding,IonXpress_NONO_c,1,55838
1777,83585531,83641369,Protein coding,IonXpress_SFPQt1,1,55838
1778,83641526,83673926,Protein coding,IonXpress_NONO_c,1,32400
1779,83641526,83673926,Protein coding,IonXpress_SFPQt1,1,32400
1780,83674066,83676365,Protein coding,IonXpress_NONO_c,1,2299
1781,83674066,83676365,Protein coding,IonXpress_SFPQt1,1,2299
1782,83676511,83691547,Protein coding,IonXpress_NONO_c,1,15036
1783,83676511,83691547,Protein coding,IonXpress_SFPQt1,1,15036
1784,83691685,83770356,Protein coding,IonXpress_NONO_c,1,78671
1785,83691685,83770356,Protein coding,IonXpress_SFPQt1,1,78671
1786,83740406,83742188,Protein coding,IonXpress_SFPQt1,1,1782
1787,83742261,83745706,Protein coding,IonXpress_SFPQt1,1,3445
1788,83745827,83748520,Protein coding,IonXpress_SFPQt1,1,2693
1789,83748785,83750151,Protein coding,IonXpress_SFPQt1,1,1366
1790,83750211,83763291,Protein coding,IonXpress_SFPQt1,1,13080
1791,83763634,83765537,Protein coding,IonXpress_SFPQt1,1,1903
1792,83765662,83769955,Protein coding,IonXpress_SFPQt1,1,4293
1793,83770130,83772582,Protein coding,IonXpress_SFPQt1,1,2452
1794,83770527,83809964,Protein coding,IonXpress_NONO_c,1,39437
1795,83770527,83809964,Protein coding,IonXpress_SFPQt1,1,39437
1796,83772757,83774721,Protein coding,IonXpress_SFPQt1,1,1964
1797,83774868,83776054,Protein coding,IonXpress_SFPQt1,1,1186
1798,83776182,83778103,Protein coding,IonXpress_SFPQt1,1,1921
1799,83778283,83778840,Protein coding,IonXpress_SFPQt1,1,557
1800,83778917,83782782,Protein coding,IonXpress_SFPQt1,1,3865
1801,83782861,83783685,Protein coding,IonXpress_SFPQt1,1,824
1802,83783725,83784469,Protein coding,IonXpress_SFPQt1,1,744
1803,83784545,83785513,Protein coding,IonXpress_SFPQt1,1,968
1804,83785751,83787959,Protein coding,IonXpress_SFPQt1,1,2208
1805,83788113,83788306,Protein coding,IonXpress_SFPQt1,1,193
1806,83788469,83791476,Protein coding,IonXpress_SFPQt1,1,3007
1807,83791577,83793095,Protein coding,IonXpress_SFPQt1,1,1518
1808,83793239,83795762,Protein coding,IonXpress_SFPQt1,1,2523
1809,83795904,83796878,Protein coding,IonXpress_SFPQt1,1,974
1810,83796975,83799881,Protein coding,IonXpress_SFPQt1,1,2906
1811,83800081,83801950,Protein coding,IonXpress_SFPQt1,1,1869
1812,83802075,83803009,Protein coding,IonXpress_SFPQt1,1,934
1813,83803090,83820864,Protein coding,IonXpress_SFPQt1,1,17774
1814,83810090,83874502,Protein coding,IonXpress_NONO_c,1,64412
1815,83810090,83874502,Protein coding,IonXpress_SFPQt1,1,64412
1816,83816000,83816843,Non coding,IonXpress_SFPQt1,3,843
1817,83816927,83819140,Non coding,IonXpress_SFPQt1,2,2213
1818,83816927,83821228,Non coding,IonXpress_SFPQt1,1,4301
1819,83819215,83820864,Non coding,IonXpress_SFPQt1,1,1649
1820,83819215,83821228,Non coding,IonXpress_SFPQt1,1,2013
1821,83820890,83821228,Non coding,IonXpress_SFPQt1,1,338
1822,83820890,83821228,Protein coding,IonXpress_SFPQt1,1,338
1823,83821376,83821485,Non coding,IonXpress_SFPQt1,3,109
1824,83821376,83821485,Protein coding,IonXpress_SFPQt1,1,109
1825,83874554,83962279,Protein coding,IonXpress_NONO_c,1,87725
1826,83874554,83962279,Protein coding,IonXpress_SFPQt1,1,87725
1827,83962334,84245611,Protein coding,IonXpress_NONO_c,1,283277
1828,83962334,84245611,Protein coding,IonXpress_SFPQt1,1,283277
1829,84245774,84822703,Protein coding,IonXpress_NONO_c,1,576929
1830,84245774,84822703,Protein coding,IonXpress_SFPQt1,1,576929
1831,84822779,84865598,Protein coding,IonXpress_NONO_c,1,42819
1832,84822779,84865598,Protein coding,IonXpress_SFPQt1,1,42819
1833,84865695,84996262,Protein coding,IonXpress_NONO_c,1,130567
1834,84865695,84996262,Protein coding,IonXpress_SFPQt1,1,130567
1835,84996409,85309699,Protein coding,IonXpress_NONO_c,1,313290
1836,84996409,85309699,Protein coding,IonXpress_SFPQt1,1,313290
1837,85309832,85337629,Protein coding,IonXpress_NONO_c,1,27797
1838,85309832,85337629,Protein coding,IonXpress_SFPQt1,1,27797
1839,85337797,85338260,Protein coding,IonXpress_NONO_c,1,463
1840,85337797,85338260,Protein coding,IonXpress_SFPQt1,1,463
1841,85430185,85431929,Protein coding,IonXpress_SFPQt1,1,1744
1842,85432086,85434266,Protein coding,IonXpress_SFPQt1,1,2180
1843,85434379,85438494,Protein coding,IonXpress_SFPQt1,1,4115
1844,85438587,85439796,Protein coding,IonXpress_SFPQt1,1,1209
1845,85439915,85441023,Protein coding,IonXpress_SFPQt1,1,1108
1846,85441248,85445953,Protein coding,IonXpress_SFPQt1,1,4705
1847,85446029,85449323,Protein coding,IonXpress_SFPQt1,1,3294
1848,85450962,85459038,Protein coding,IonXpress_SFPQt1,1,8076
1849,85459192,85460524,Protein coding,IonXpress_SFPQt1,1,1332
1850,85460676,85466683,Protein coding,IonXpress_SFPQt1,1,6007
1851,85466876,85492131,Protein coding,IonXpress_SFPQt1,1,25255
1852,85492326,85492643,Protein coding,IonXpress_SFPQt1,1,317
1853,85492772,85497780,Protein coding,IonXpress_SFPQt1,1,5008
1854,85497855,85500298,Protein coding,IonXpress_SFPQt1,1,2443
1855,85500393,85515473,Protein coding,IonXpress_SFPQt1,1,15080
1856,85515654,85517846,Protein coding,IonXpress_SFPQt1,1,2192
1857,85518297,85521608,Protein coding,IonXpress_SFPQt1,1,3311
1858,85521811,85531626,Protein coding,IonXpress_SFPQt1,1,9815
1859,85531747,85546056,Protein coding,IonXpress_SFPQt1,1,14309
1860,85546147,85546800,Protein coding,IonXpress_SFPQt1,1,653
1861,85546923,85547439,Protein coding,IonXpress_SFPQt1,1,516
1862,85547536,85547788,Protein coding,IonXpress_SFPQt1,1,252
1863,85547872,85554389,Protein coding,IonXpress_SFPQt1,1,6517
1864,85554492,85623293,Protein coding,IonXpress_SFPQt1,1,68801
1865,85623427,85626472,Protein coding,IonXpress_SFPQt1,1,3045
1866,85626534,85638565,Protein coding,IonXpress_SFPQt1,1,12031
1867,86333474,86335471,Protein coding,IonXpress_SFPQt1,1,1997
1868,86335525,86335621,Protein coding,IonXpress_SFPQt1,1,96
1869,86335659,86338234,Protein coding,IonXpress_SFPQt1,1,2575
1870,86338281,86343651,Protein coding,IonXpress_SFPQt1,1,5370
1871,86343721,86344176,Protein coding,IonXpress_SFPQt1,1,455
1872,86344282,86346042,Protein coding,IonXpress_SFPQt1,1,1760
1873,86346167,86348600,Protein coding,IonXpress_SFPQt1,1,2433
1874,86348717,86350822,Protein coding,IonXpress_SFPQt1,1,2105
1875,86350885,86352116,Protein coding,IonXpress_SFPQt1,1,1231
1876,86352205,86352576,Protein coding,IonXpress_SFPQt1,1,371
1877,86352205,86352916,Protein coding,IonXpress_SFPQt1,1,711
1878,86352638,86352916,Protein coding,IonXpress_SFPQt1,1,278
1879,86353003,86354282,Protein coding,IonXpress_SFPQt1,2,1279
1880,86354428,86355062,Protein coding,IonXpress_SFPQt1,2,634
1881,86355114,86357769,Protein coding,IonXpress_SFPQt1,2,2655
1882,86357860,86358199,Protein coding,IonXpress_SFPQt1,1,339
1883,86357864,86358199,Protein coding,IonXpress_SFPQt1,1,335
1884,86358229,86359439,Protein coding,IonXpress_SFPQt1,2,1210
1885,86359547,86360299,Protein coding,IonXpress_SFPQt1,2,752
1886,86360379,86360467,Protein coding,IonXpress_SFPQt1,2,88
1887,86360559,86361413,Protein coding,IonXpress_SFPQt1,2,854
1888,86361500,86361960,Protein coding,IonXpress_SFPQt1,2,460
1889,86362110,86363642,Protein coding,IonXpress_SFPQt1,2,1532
1890,86363685,86364103,Protein coding,IonXpress_SFPQt1,2,418
1891,86364263,86364590,Protein coding,IonXpress_SFPQt1,2,327
1892,86386909,86387140,Non coding,IonXpress_NONO_c,2,231
1893,86386909,86387140,Non coding,IonXpress_SFPQt1,2,231
1894,86387210,86387511,Non coding,IonXpress_NONO_c,2,301
1895,86387210,86387511,Non coding,IonXpress_SFPQt1,2,301
1896,86387593,86387670,Non coding,IonXpress_NONO_c,2,77
1897,86387593,86387670,Non coding,IonXpress_SFPQt1,2,77
1898,86387750,86387852,Non coding,IonXpress_NONO_c,2,102
1899,86387750,86387852,Non coding,IonXpress_SFPQt1,2,102
1900,86387906,86388410,Non coding,IonXpress_NONO_c,1,504
1901,86387906,86388410,Non coding,IonXpress_SFPQt1,1,504
1902,89627120,89627346,Protein coding,IonXpress_SFPQt1,3,226
1903,89627471,89627633,Protein coding,IonXpress_SFPQt1,5,162
1904,89627737,89628002,Protein coding,IonXpress_SFPQt1,1,265
1905,89627747,89628071,Protein coding,IonXpress_SFPQt1,1,324
1906,89627776,89627984,Protein coding,IonXpress_SFPQt1,3,208
1907,89628006,89628146,Protein coding,IonXpress_SFPQt1,1,140
1908,89628159,89628741,Protein coding,IonXpress_SFPQt1,5,582
1909,89628799,89629290,Protein coding,IonXpress_SFPQt1,5,491
1910,91726916,91727796,Protein coding,IonXpress_NONO_c,6,880
1911,91726916,91727796,Protein coding,IonXpress_SFPQt1,10,880
1912,91727949,91728036,Protein coding,IonXpress_NONO_c,6,87
1913,91727949,91728036,Protein coding,IonXpress_SFPQt1,10,87
1914,91728149,91731572,Protein coding,IonXpress_NONO_c,6,3423
1915,91728149,91731572,Protein coding,IonXpress_SFPQt1,10,3423
1916,91731664,91733300,Protein coding,IonXpress_NONO_c,6,1636
1917,91731664,91733300,Protein coding,IonXpress_SFPQt1,10,1636
1918,91733412,91739267,Protein coding,IonXpress_NONO_c,9,5855
1919,91733412,91739267,Protein coding,IonXpress_SFPQt1,15,5855
1920,91739372,91740285,Protein coding,IonXpress_NONO_c,9,913
1921,91739372,91740285,Protein coding,IonXpress_SFPQt1,15,913
1922,91740366,91742183,Protein coding,IonXpress_NONO_c,9,1817
1923,91740366,91742183,Protein coding,IonXpress_SFPQt1,15,1817
1924,91742300,91742537,Protein coding,IonXpress_NONO_c,9,237
1925,91742300,91742537,Protein coding,IonXpress_SFPQt1,15,237
1926,91742619,91778904,Protein coding,IonXpress_NONO_c,9,36285
1927,91742619,91778904,Protein coding,IonXpress_SFPQt1,15,36285
1928,91779052,91779512,Protein coding,IonXpress_NONO_c,9,460
1929,91779052,91779512,Protein coding,IonXpress_SFPQt1,15,460
1930,91779617,91781370,Protein coding,IonXpress_NONO_c,9,1753
1931,91779617,91781370,Protein coding,IonXpress_SFPQt1,15,1753
1932,91781529,91781656,Protein coding,IonXpress_NONO_c,9,127
1933,91781529,91781656,Protein coding,IonXpress_SFPQt1,15,127
1934,91781741,91781946,Protein coding,IonXpress_NONO_c,9,205
1935,91781741,91781946,Protein coding,IonXpress_SFPQt1,15,205
1936,91782033,91784633,Protein coding,IonXpress_NONO_c,9,2600
1937,91782033,91784633,Protein coding,IonXpress_SFPQt1,15,2600
1938,91784766,91784848,Protein coding,IonXpress_NONO_c,9,82
1939,91784766,91784848,Protein coding,IonXpress_SFPQt1,15,82
1940,91784947,91788505,Protein coding,IonXpress_NONO_c,9,3558
1941,91784947,91788505,Protein coding,IonXpress_SFPQt1,15,3558
1942,91788554,91788648,Protein coding,IonXpress_NONO_c,9,94
1943,91788554,91788648,Protein coding,IonXpress_SFPQt1,15,94
1944,91788756,91790230,Protein coding,IonXpress_NONO_c,9,1474
1945,91788756,91790230,Protein coding,IonXpress_SFPQt1,15,1474
1946,91790323,91808985,Protein coding,IonXpress_NONO_c,9,18662
1947,91790323,91808985,Protein coding,IonXpress_SFPQt1,15,18662
1948,91809067,91812984,Protein coding,IonXpress_NONO_c,9,3917
1949,91809067,91812984,Protein coding,IonXpress_SFPQt1,15,3917
1950,91813033,91816293,Protein coding,IonXpress_NONO_c,9,3260
1951,91813033,91816293,Protein coding,IonXpress_SFPQt1,15,3260
1952,91816428,91817104,Protein coding,IonXpress_NONO_c,9,676
1953,91816428,91817104,Protein coding,IonXpress_SFPQt1,15,676
1954,91817200,91818061,Protein coding,IonXpress_NONO_c,9,861
1955,91817200,91818061,Protein coding,IonXpress_SFPQt1,15,861
1956,91818208,91818606,Protein coding,IonXpress_NONO_c,9,398
1957,91818208,91818606,Protein coding,IonXpress_SFPQt1,15,398
1958,91818709,91818811,Protein coding,IonXpress_NONO_c,9,102
1959,91818709,91818811,Protein coding,IonXpress_SFPQt1,15,102
1960,91818856,91840913,Protein coding,IonXpress_NONO_c,9,22057
1961,91818856,91840913,Protein coding,IonXpress_SFPQt1,15,22057
1962,91841003,91841082,Protein coding,IonXpress_NONO_c,9,79
1963,91841003,91841082,Protein coding,IonXpress_SFPQt1,15,79
1964,91841284,91843580,Protein coding,IonXpress_NONO_c,9,2296
1965,91841284,91843580,Protein coding,IonXpress_SFPQt1,15,2296
1966,91843740,91843958,Protein coding,IonXpress_NONO_c,12,218
1967,91843740,91843958,Protein coding,IonXpress_SFPQt1,20,218
1968,91844037,91844618,Protein coding,IonXpress_NONO_c,12,581
1969,91844037,91844618,Protein coding,IonXpress_SFPQt1,20,581
1970,91844771,91845659,Protein coding,IonXpress_NONO_c,9,888
1971,91844771,91845659,Protein coding,IonXpress_SFPQt1,15,888
1972,91844771,91866567,Protein coding,IonXpress_NONO_c,3,21796
1973,91844771,91866567,Protein coding,IonXpress_SFPQt1,5,21796
1974,91845793,91846467,Protein coding,IonXpress_NONO_c,9,674
1975,91845793,91846467,Protein coding,IonXpress_SFPQt1,15,674
1976,91846486,91866567,Protein coding,IonXpress_NONO_c,3,20081
1977,91846486,91866567,Protein coding,IonXpress_SFPQt1,5,20081
1978,91846539,91850742,Protein coding,IonXpress_NONO_c,6,4203
1979,91846539,91850742,Protein coding,IonXpress_SFPQt1,10,4203
1980,91850791,91851130,Protein coding,IonXpress_NONO_c,6,339
1981,91850791,91851130,Protein coding,IonXpress_SFPQt1,10,339
1982,91851391,91859648,Protein coding,IonXpress_NONO_c,6,8257
1983,91851391,91859648,Protein coding,IonXpress_SFPQt1,10,8257
1984,91859959,91861848,Protein coding,IonXpress_NONO_c,6,1889
1985,91859959,91861848,Protein coding,IonXpress_SFPQt1,10,1889
1986,91861962,91866567,Protein coding,IonXpress_NONO_c,6,4605
1987,91861962,91866567,Protein coding,IonXpress_SFPQt1,10,4605
1988,91866666,91870353,Protein coding,IonXpress_NONO_c,9,3687
1989,91866666,91870353,Protein coding,IonXpress_SFPQt1,15,3687
1990,92051463,92101013,Protein coding,IonXpress_NONO_c,2,49550
1991,92101176,92345439,Protein coding,IonXpress_NONO_c,2,244263
1992,92346135,92380784,Protein coding,IonXpress_NONO_c,2,34649
1993,92380919,92408547,Protein coding,IonXpress_NONO_c,2,27628
1994,92408674,92560189,Protein coding,IonXpress_NONO_c,2,151515
1995,92560311,92797081,Protein coding,IonXpress_NONO_c,2,236770
1996,92797242,93518533,Protein coding,IonXpress_NONO_c,2,721291
1997,93221083,93515816,Non coding,IonXpress_NONO_c,1,294733
1998,93463613,93463841,Non coding,IonXpress_NONO_c,4,228
1999,93463613,93463841,Non coding,IonXpress_SFPQt1,6,228
2000,93463878,93464314,Non coding,IonXpress_NONO_c,2,436
2001,93463878,93464314,Non coding,IonXpress_SFPQt1,3,436
2002,93464382,93464917,Non coding,IonXpress_NONO_c,4,535
2003,93464382,93464917,Non coding,IonXpress_SFPQt1,6,535
2004,93464965,93465408,Non coding,IonXpress_NONO_c,4,443
2005,93464965,93465408,Non coding,IonXpress_SFPQt1,6,443
2006,93465457,93466251,Non coding,IonXpress_NONO_c,2,794
2007,93465457,93466251,Non coding,IonXpress_SFPQt1,3,794
2008,93466287,93466514,Non coding,IonXpress_NONO_c,2,227
2009,93466287,93466514,Non coding,IonXpress_SFPQt1,3,227
2010,93466671,93467789,Non coding,IonXpress_NONO_c,2,1118
2011,93466671,93467789,Non coding,IonXpress_SFPQt1,3,1118
2012,93467826,93469305,Non coding,IonXpress_NONO_c,2,1479
2013,93467826,93469305,Non coding,IonXpress_SFPQt1,3,1479
2014,93469470,93469858,Non coding,IonXpress_NONO_c,2,388
2015,93469470,93469858,Non coding,IonXpress_SFPQt1,3,388
2016,93469917,93470228,Non coding,IonXpress_NONO_c,2,311
2017,93469917,93470228,Non coding,IonXpress_SFPQt1,3,311
2018,93470405,93471273,Non coding,IonXpress_NONO_c,2,868
2019,93470405,93471273,Non coding,IonXpress_SFPQt1,3,868
2020,93471665,93472401,Non coding,IonXpress_NONO_c,2,736
2021,93471665,93472401,Non coding,IonXpress_SFPQt1,3,736
2022,93472497,93474486,Non coding,IonXpress_NONO_c,2,1989
2023,93472497,93474486,Non coding,IonXpress_SFPQt1,3,1989
2024,93515861,93536046,Non coding,IonXpress_NONO_c,1,20185
2025,93536154,93538793,Non coding,IonXpress_NONO_c,1,2639
2026,99037966,99057169,Protein coding,IonXpress_SFPQt1,1,19203
2027,99054078,99054871,Protein coding,IonXpress_SFPQt1,1,793
2028,99055003,99057169,Protein coding,IonXpress_SFPQt1,1,2166
2029,99057316,99057573,Protein coding,IonXpress_SFPQt1,2,257
2030,99057627,99057734,Protein coding,IonXpress_SFPQt1,2,107
2031,108536066,108544192,Protein coding,IonXpress_NONO_c,2,8126
2032,108544254,108546321,Protein coding,IonXpress_NONO_c,2,2067
2033,108546453,108547810,Protein coding,IonXpress_NONO_c,2,1357
2034,108547970,108549040,Protein coding,IonXpress_NONO_c,2,1070
2035,108549162,108550096,Protein coding,IonXpress_NONO_c,2,934
2036,108550287,108559661,Protein coding,IonXpress_NONO_c,2,9374
2037,108559789,108562601,Protein coding,IonXpress_NONO_c,2,2812
2038,108562765,108564241,Protein coding,IonXpress_NONO_c,2,1476
2039,108564327,108577464,Protein coding,IonXpress_NONO_c,2,13137
2040,108577564,108586604,Protein coding,IonXpress_NONO_c,2,9040
2041,108586693,108590522,Protein coding,IonXpress_NONO_c,2,3829
2042,108590612,108593722,Protein coding,IonXpress_NONO_c,2,3110
2043,108594189,108709171,Protein coding,IonXpress_NONO_c,2,114982
2044,108709292,108712040,Protein coding,IonXpress_NONO_c,2,2748
2045,108712203,108722878,Protein coding,IonXpress_NONO_c,2,10675
2046,108722936,108788598,Protein coding,IonXpress_NONO_c,2,65662
2047,108788745,108810971,Protein coding,IonXpress_NONO_c,1,22226
2048,110303777,110526647,Protein coding,IonXpress_NONO_c,2,222870
2049,110526751,110603554,Protein coding,IonXpress_NONO_c,2,76803
2050,110603146,110603554,Protein coding,IonXpress_NONO_c,1,408
2051,110603621,111127292,Protein coding,IonXpress_NONO_c,3,523671
2052,110719712,110720407,Protein coding,IonXpress_NONO_c,2,695
2053,110720426,110720516,Protein coding,IonXpress_NONO_c,2,90
2054,110720600,110729823,Protein coding,IonXpress_NONO_c,2,9223
2055,110729929,110734402,Protein coding,IonXpress_NONO_c,3,4473
2056,110734542,110760795,Protein coding,IonXpress_NONO_c,2,26253
2057,110734542,110764193,Protein coding,IonXpress_NONO_c,1,29651
2058,110760877,110764193,Protein coding,IonXpress_NONO_c,2,3316
2059,110764280,110765356,Protein coding,IonXpress_NONO_c,3,1076
2060,110765822,110770400,Protein coding,IonXpress_NONO_c,3,4578
2061,110770490,110770984,Protein coding,IonXpress_NONO_c,3,494
2062,110771088,110771815,Protein coding,IonXpress_NONO_c,3,727
2063,110771948,110777084,Protein coding,IonXpress_NONO_c,3,5136
2064,110777208,110777306,Protein coding,IonXpress_NONO_c,3,98
2065,110777526,110778462,Protein coding,IonXpress_NONO_c,3,936
2066,110778799,110780031,Protein coding,IonXpress_NONO_c,3,1232
2067,110780253,110781035,Protein coding,IonXpress_NONO_c,3,782
2068,110781239,110782689,Protein coding,IonXpress_NONO_c,3,1450
2069,110782776,110783052,Protein coding,IonXpress_NONO_c,3,276
2070,110783187,110783804,Protein coding,IonXpress_NONO_c,3,617
2071,110783923,110784004,Protein coding,IonXpress_NONO_c,3,81
2072,110784126,110788095,Protein coding,IonXpress_NONO_c,1,3969
2073,111127397,111161367,Protein coding,IonXpress_NONO_c,3,33970
2074,111161505,111201905,Protein coding,IonXpress_NONO_c,3,40400
2075,111201979,111202518,Protein coding,IonXpress_NONO_c,2,539
2076,120459317,120460286,Protein coding,IonXpress_NONO_c,1,969
2077,120459317,120460286,Protein coding,IonXpress_SFPQt1,1,969
2078,120460385,120461027,Protein coding,IonXpress_NONO_c,1,642
2079,120460385,120461027,Protein coding,IonXpress_SFPQt1,1,642
2080,120461176,120461933,Protein coding,IonXpress_NONO_c,1,757
2081,120461176,120461933,Protein coding,IonXpress_SFPQt1,1,757
2082,120462236,120462850,Protein coding,IonXpress_NONO_c,1,614
2083,120462236,120462850,Protein coding,IonXpress_SFPQt1,1,614
2084,120463020,120464334,Protein coding,IonXpress_NONO_c,1,1314
2085,120463020,120464334,Protein coding,IonXpress_SFPQt1,1,1314
2086,120464432,120464857,Protein coding,IonXpress_NONO_c,1,425
2087,120464432,120464857,Protein coding,IonXpress_SFPQt1,1,425
2088,120465069,120465257,Protein coding,IonXpress_NONO_c,1,188
2089,120465069,120465257,Protein coding,IonXpress_SFPQt1,1,188
2090,120465401,120466258,Protein coding,IonXpress_NONO_c,1,857
2091,120465401,120466258,Protein coding,IonXpress_SFPQt1,1,857
2092,120466607,120467926,Protein coding,IonXpress_NONO_c,1,1319
2093,120466607,120467926,Protein coding,IonXpress_SFPQt1,1,1319
2094,120468433,120469120,Protein coding,IonXpress_NONO_c,1,687
2095,120468433,120469120,Protein coding,IonXpress_SFPQt1,1,687
2096,120469234,120471597,Protein coding,IonXpress_NONO_c,1,2363
2097,120469234,120471597,Protein coding,IonXpress_SFPQt1,1,2363
2098,120471835,120478093,Protein coding,IonXpress_NONO_c,1,6258
2099,120471835,120478093,Protein coding,IonXpress_SFPQt1,1,6258
2100,120478227,120479903,Protein coding,IonXpress_NONO_c,2,1676
2101,120478227,120479903,Protein coding,IonXpress_SFPQt1,2,1676
2102,120480089,120480478,Protein coding,IonXpress_NONO_c,2,389
2103,120480089,120480478,Protein coding,IonXpress_SFPQt1,2,389
2104,120480633,120483176,Protein coding,IonXpress_NONO_c,2,2543
2105,120480633,120483176,Protein coding,IonXpress_SFPQt1,2,2543
2106,120483379,120484147,Protein coding,IonXpress_NONO_c,2,768
2107,120483379,120484147,Protein coding,IonXpress_SFPQt1,2,768
2108,120484377,120491035,Protein coding,IonXpress_NONO_c,2,6658
2109,120484377,120491035,Protein coding,IonXpress_SFPQt1,2,6658
2110,120491189,120491628,Protein coding,IonXpress_NONO_c,2,439
2111,120491189,120491628,Protein coding,IonXpress_SFPQt1,2,439
2112,120491749,120493345,Protein coding,IonXpress_NONO_c,2,1596
2113,120491749,120493345,Protein coding,IonXpress_SFPQt1,2,1596
2114,120493460,120496164,Protein coding,IonXpress_NONO_c,4,2704
2115,120493460,120496164,Protein coding,IonXpress_SFPQt1,4,2704
2116,120496311,120497661,Protein coding,IonXpress_NONO_c,4,1350
2117,120496311,120497661,Protein coding,IonXpress_SFPQt1,4,1350
2118,120497855,120502013,Protein coding,IonXpress_NONO_c,4,4158
2119,120497855,120502013,Protein coding,IonXpress_SFPQt1,4,4158
2120,120502125,120506195,Protein coding,IonXpress_NONO_c,4,4070
2121,120502125,120506195,Protein coding,IonXpress_SFPQt1,4,4070
2122,120506430,120508074,Protein coding,IonXpress_NONO_c,4,1644
2123,120506430,120508074,Protein coding,IonXpress_SFPQt1,4,1644
2124,120508189,120508997,Protein coding,IonXpress_NONO_c,4,808
2125,120508189,120508997,Protein coding,IonXpress_SFPQt1,4,808
2126,120509112,120510054,Protein coding,IonXpress_NONO_c,4,942
2127,120509112,120510054,Protein coding,IonXpress_SFPQt1,4,942
2128,120510244,120510698,Protein coding,IonXpress_NONO_c,4,454
2129,120510244,120510698,Protein coding,IonXpress_SFPQt1,4,454
2130,120510855,120512132,Protein coding,IonXpress_NONO_c,4,1277
2131,120510855,120512132,Protein coding,IonXpress_SFPQt1,4,1277
2132,120512367,120529581,Protein coding,IonXpress_NONO_c,4,17214
2133,120512367,120529581,Protein coding,IonXpress_SFPQt1,4,17214
2134,120529705,120539618,Protein coding,IonXpress_NONO_c,4,9913
2135,120529705,120539618,Protein coding,IonXpress_SFPQt1,4,9913
2136,120539955,120547950,Protein coding,IonXpress_NONO_c,4,7995
2137,120539955,120547950,Protein coding,IonXpress_SFPQt1,4,7995
2138,120548211,120572527,Protein coding,IonXpress_NONO_c,3,24316
2139,120548211,120572527,Protein coding,IonXpress_SFPQt1,3,24316
2140,120548211,120611946,Protein coding,IonXpress_NONO_c,1,63735
2141,120548211,120611946,Protein coding,IonXpress_SFPQt1,1,63735
2142,120572610,120594096,Protein coding,IonXpress_NONO_c,1,21486
2143,120572610,120594096,Protein coding,IonXpress_SFPQt1,1,21486
2144,120572610,120611946,Protein coding,IonXpress_NONO_c,2,39336
2145,120572610,120611946,Protein coding,IonXpress_SFPQt1,2,39336
2146,122098523,122104612,Non coding,IonXpress_NONO_c,2,6089
2147,122098523,122104612,Non coding,IonXpress_SFPQt1,2,6089
2148,122098523,122104612,Protein coding,IonXpress_NONO_c,4,6089
2149,122098523,122104612,Protein coding,IonXpress_SFPQt1,4,6089
2150,122104730,122106086,Non coding,IonXpress_NONO_c,2,1356
2151,122104730,122106086,Non coding,IonXpress_SFPQt1,2,1356
2152,122104730,122106086,Protein coding,IonXpress_NONO_c,4,1356
2153,122104730,122106086,Protein coding,IonXpress_SFPQt1,4,1356
2154,122106294,122120746,Non coding,IonXpress_NONO_c,2,14452
2155,122106294,122120746,Non coding,IonXpress_SFPQt1,2,14452
2156,122106294,122120746,Protein coding,IonXpress_NONO_c,4,14452
2157,122106294,122120746,Protein coding,IonXpress_SFPQt1,4,14452
2158,122120876,122122668,Non coding,IonXpress_NONO_c,2,1792
2159,122120876,122122668,Non coding,IonXpress_SFPQt1,2,1792
2160,122120876,122122668,Protein coding,IonXpress_NONO_c,4,1792
2161,122120876,122122668,Protein coding,IonXpress_SFPQt1,4,1792
2162,122122860,122125162,Non coding,IonXpress_NONO_c,2,2302
2163,122122860,122125162,Non coding,IonXpress_SFPQt1,2,2302
2164,122122860,122125162,Protein coding,IonXpress_NONO_c,4,2302
2165,122122860,122125162,Protein coding,IonXpress_SFPQt1,4,2302
2166,122125407,122135073,Non coding,IonXpress_NONO_c,2,9666
2167,122125407,122135073,Non coding,IonXpress_SFPQt1,2,9666
2168,122125407,122135073,Protein coding,IonXpress_NONO_c,4,9666
2169,122125407,122135073,Protein coding,IonXpress_SFPQt1,4,9666
2170,122135225,122139782,Protein coding,IonXpress_NONO_c,1,4557
2171,122135225,122139782,Protein coding,IonXpress_SFPQt1,1,4557
2172,122135225,122144696,Non coding,IonXpress_NONO_c,2,9471
2173,122135225,122144696,Non coding,IonXpress_SFPQt1,2,9471
2174,122135225,122144696,Protein coding,IonXpress_NONO_c,3,9471
2175,122135225,122144696,Protein coding,IonXpress_SFPQt1,3,9471
2176,122139900,122144696,Protein coding,IonXpress_NONO_c,1,4796
2177,122139900,122144696,Protein coding,IonXpress_SFPQt1,1,4796
2178,122144804,122145337,Non coding,IonXpress_NONO_c,2,533
2179,122144804,122145337,Non coding,IonXpress_SFPQt1,2,533
2180,122144804,122145337,Protein coding,IonXpress_NONO_c,4,533
2181,122144804,122145337,Protein coding,IonXpress_SFPQt1,4,533
2182,122145482,122154714,Non coding,IonXpress_NONO_c,2,9232
2183,122145482,122154714,Non coding,IonXpress_SFPQt1,2,9232
2184,122145482,122154714,Protein coding,IonXpress_NONO_c,4,9232
2185,122145482,122154714,Protein coding,IonXpress_SFPQt1,4,9232
2186,122154859,122155896,Non coding,IonXpress_NONO_c,2,1037
2187,122154859,122155896,Non coding,IonXpress_SFPQt1,2,1037
2188,122154859,122155896,Protein coding,IonXpress_NONO_c,4,1037
2189,122154859,122155896,Protein coding,IonXpress_SFPQt1,4,1037
2190,122155976,122159083,Non coding,IonXpress_NONO_c,2,3107
2191,122155976,122159083,Non coding,IonXpress_SFPQt1,2,3107
2192,122155976,122159083,Protein coding,IonXpress_NONO_c,4,3107
2193,122155976,122159083,Protein coding,IonXpress_SFPQt1,4,3107
2194,122159248,122161941,Non coding,IonXpress_NONO_c,2,2693
2195,122159248,122161941,Non coding,IonXpress_SFPQt1,2,2693
2196,122159248,122161941,Protein coding,IonXpress_NONO_c,1,2693
2197,122159248,122161941,Protein coding,IonXpress_SFPQt1,1,2693
2198,122159248,122161945,Protein coding,IonXpress_NONO_c,4,2697
2199,122159248,122161945,Protein coding,IonXpress_SFPQt1,4,2697
2200,122162010,122165045,Non coding,IonXpress_NONO_c,2,3035
2201,122162010,122165045,Non coding,IonXpress_SFPQt1,2,3035
2202,122162010,122165045,Protein coding,IonXpress_NONO_c,5,3035
2203,122162010,122165045,Protein coding,IonXpress_SFPQt1,5,3035
2204,122165288,122166598,Protein coding,IonXpress_NONO_c,1,1310
2205,122165288,122166598,Protein coding,IonXpress_SFPQt1,1,1310
2206,122165291,122166598,Protein coding,IonXpress_NONO_c,2,1307
2207,122165291,122166598,Protein coding,IonXpress_SFPQt1,2,1307
2208,122165291,122168440,Non coding,IonXpress_NONO_c,2,3149
2209,122165291,122168440,Non coding,IonXpress_SFPQt1,2,3149
2210,122165291,122168440,Protein coding,IonXpress_NONO_c,2,3149
2211,122165291,122168440,Protein coding,IonXpress_SFPQt1,2,3149
2212,122166623,122168440,Protein coding,IonXpress_NONO_c,3,1817
2213,122166623,122168440,Protein coding,IonXpress_SFPQt1,3,1817
2214,122168545,122176196,Protein coding,IonXpress_NONO_c,1,7651
2215,122168545,122176196,Protein coding,IonXpress_SFPQt1,1,7651
2216,122168545,122182713,Non coding,IonXpress_NONO_c,2,14168
2217,122168545,122182713,Non coding,IonXpress_SFPQt1,2,14168
2218,122168545,122182713,Protein coding,IonXpress_NONO_c,4,14168
2219,122168545,122182713,Protein coding,IonXpress_SFPQt1,4,14168
2220,122176305,122182713,Protein coding,IonXpress_NONO_c,1,6408
2221,122176305,122182713,Protein coding,IonXpress_SFPQt1,1,6408
2222,122182882,122184978,Non coding,IonXpress_NONO_c,1,2096
2223,122182882,122184978,Non coding,IonXpress_SFPQt1,1,2096
2224,122182882,122184978,Protein coding,IonXpress_NONO_c,3,2096
2225,122182882,122184978,Protein coding,IonXpress_SFPQt1,3,2096
2226,122182882,122187647,Non coding,IonXpress_NONO_c,1,4765
2227,122182882,122187647,Non coding,IonXpress_SFPQt1,1,4765
2228,122182882,122187647,Protein coding,IonXpress_NONO_c,2,4765
2229,122182882,122187647,Protein coding,IonXpress_SFPQt1,2,4765
2230,122185006,122187647,Non coding,IonXpress_NONO_c,1,2641
2231,122185006,122187647,Non coding,IonXpress_SFPQt1,1,2641
2232,122185006,122187647,Protein coding,IonXpress_NONO_c,3,2641
2233,122185006,122187647,Protein coding,IonXpress_SFPQt1,3,2641
2234,122187753,122202513,Protein coding,IonXpress_NONO_c,1,14760
2235,122187753,122202513,Protein coding,IonXpress_SFPQt1,1,14760
2236,122187753,122203023,Protein coding,IonXpress_NONO_c,2,15270
2237,122187753,122203023,Protein coding,IonXpress_SFPQt1,2,15270
2238,122187753,122204911,Non coding,IonXpress_NONO_c,2,17158
2239,122187753,122204911,Non coding,IonXpress_SFPQt1,2,17158
2240,122187753,122204911,Protein coding,IonXpress_NONO_c,2,17158
2241,122187753,122204911,Protein coding,IonXpress_SFPQt1,2,17158
2242,122202538,122204911,Protein coding,IonXpress_NONO_c,1,2373
2243,122202538,122204911,Protein coding,IonXpress_SFPQt1,1,2373
2244,122203072,122204911,Protein coding,IonXpress_NONO_c,2,1839
2245,122203072,122204911,Protein coding,IonXpress_SFPQt1,2,1839
2246,122205083,122205850,Non coding,IonXpress_NONO_c,1,767
2247,122205083,122205850,Non coding,IonXpress_SFPQt1,1,767
2248,122205083,122205850,Protein coding,IonXpress_NONO_c,5,767
2249,122205083,122205850,Protein coding,IonXpress_SFPQt1,5,767
2250,122205116,122205850,Non coding,IonXpress_NONO_c,1,734
2251,122205116,122205850,Non coding,IonXpress_SFPQt1,1,734
2252,122205901,122206527,Non coding,IonXpress_NONO_c,2,626
2253,122205901,122206527,Non coding,IonXpress_SFPQt1,2,626
2254,122205901,122206527,Protein coding,IonXpress_NONO_c,5,626
2255,122205901,122206527,Protein coding,IonXpress_SFPQt1,5,626
2256,122206696,122208487,Non coding,IonXpress_NONO_c,2,1791
2257,122206696,122208487,Non coding,IonXpress_SFPQt1,2,1791
2258,122206696,122208487,Protein coding,IonXpress_NONO_c,5,1791
2259,122206696,122208487,Protein coding,IonXpress_SFPQt1,5,1791
2260,122208566,122209364,Non coding,IonXpress_NONO_c,2,798
2261,122208566,122209364,Non coding,IonXpress_SFPQt1,2,798
2262,122208566,122209364,Protein coding,IonXpress_NONO_c,5,798
2263,122208566,122209364,Protein coding,IonXpress_SFPQt1,5,798
2264,122209425,122215261,Non coding,IonXpress_NONO_c,2,5836
2265,122209425,122215261,Non coding,IonXpress_SFPQt1,2,5836
2266,122209425,122215261,Protein coding,IonXpress_NONO_c,5,5836
2267,122209425,122215261,Protein coding,IonXpress_SFPQt1,5,5836
2268,122215333,122216414,Non coding,IonXpress_NONO_c,2,1081
2269,122215333,122216414,Non coding,IonXpress_SFPQt1,2,1081
2270,122215333,122216414,Protein coding,IonXpress_NONO_c,5,1081
2271,122215333,122216414,Protein coding,IonXpress_SFPQt1,5,1081
2272,122216551,122217554,Non coding,IonXpress_NONO_c,2,1003
2273,122216551,122217554,Non coding,IonXpress_SFPQt1,2,1003
2274,122216551,122217554,Protein coding,IonXpress_NONO_c,5,1003
2275,122216551,122217554,Protein coding,IonXpress_SFPQt1,5,1003
2276,122217701,122218675,Non coding,IonXpress_NONO_c,2,974
2277,122217701,122218675,Non coding,IonXpress_SFPQt1,2,974
2278,122217701,122218675,Protein coding,IonXpress_NONO_c,5,974
2279,122217701,122218675,Protein coding,IonXpress_SFPQt1,5,974
2280,122218769,122220106,Non coding,IonXpress_NONO_c,2,1337
2281,122218769,122220106,Non coding,IonXpress_SFPQt1,2,1337
2282,122218769,122220106,Protein coding,IonXpress_NONO_c,5,1337
2283,122218769,122220106,Protein coding,IonXpress_SFPQt1,5,1337
2284,122220181,122227382,Non coding,IonXpress_NONO_c,2,7201
2285,122220181,122227382,Non coding,IonXpress_SFPQt1,2,7201
2286,122220181,122227382,Protein coding,IonXpress_NONO_c,5,7201
2287,122220181,122227382,Protein coding,IonXpress_SFPQt1,5,7201
2288,122227536,122260741,Non coding,IonXpress_NONO_c,2,33205
2289,122227536,122260741,Non coding,IonXpress_SFPQt1,2,33205
2290,122227536,122260741,Protein coding,IonXpress_NONO_c,5,33205
2291,122227536,122260741,Protein coding,IonXpress_SFPQt1,5,33205
2292,122260810,122273239,Non coding,IonXpress_NONO_c,1,12429
2293,122260810,122273239,Non coding,IonXpress_SFPQt1,1,12429
2294,122260810,122273239,Protein coding,IonXpress_NONO_c,5,12429
2295,122260810,122273239,Protein coding,IonXpress_SFPQt1,5,12429
2296,122260810,122363275,Non coding,IonXpress_NONO_c,1,102465
2297,122260810,122363275,Non coding,IonXpress_SFPQt1,1,102465
2298,122273338,122283419,Non coding,IonXpress_NONO_c,1,10081
2299,122273338,122283419,Non coding,IonXpress_SFPQt1,1,10081
2300,122273338,122283419,Protein coding,IonXpress_NONO_c,5,10081
2301,122273338,122283419,Protein coding,IonXpress_SFPQt1,5,10081
2302,122283496,122285373,Non coding,IonXpress_NONO_c,1,1877
2303,122283496,122285373,Non coding,IonXpress_SFPQt1,1,1877
2304,122283496,122285373,Protein coding,IonXpress_NONO_c,5,1877
2305,122283496,122285373,Protein coding,IonXpress_SFPQt1,5,1877
2306,122285466,122286251,Non coding,IonXpress_NONO_c,1,785
2307,122285466,122286251,Non coding,IonXpress_SFPQt1,1,785
2308,122285466,122286251,Protein coding,IonXpress_NONO_c,5,785
2309,122285466,122286251,Protein coding,IonXpress_SFPQt1,5,785
2310,122286356,122287821,Non coding,IonXpress_NONO_c,1,1465
2311,122286356,122287821,Non coding,IonXpress_SFPQt1,1,1465
2312,122286356,122287821,Protein coding,IonXpress_NONO_c,5,1465
2313,122286356,122287821,Protein coding,IonXpress_SFPQt1,5,1465
2314,122287901,122363275,Non coding,IonXpress_NONO_c,1,75374
2315,122287901,122363275,Non coding,IonXpress_SFPQt1,1,75374
2316,122287901,122363275,Protein coding,IonXpress_NONO_c,5,75374
2317,122287901,122363275,Protein coding,IonXpress_SFPQt1,5,75374
2318,122363756,122406946,Non coding,IonXpress_NONO_c,1,43190
2319,122363756,122406946,Non coding,IonXpress_SFPQt1,1,43190
2320,122363756,122406946,Protein coding,IonXpress_NONO_c,5,43190
2321,122363756,122406946,Protein coding,IonXpress_SFPQt1,5,43190
2322,122928536,122929473,Protein coding,IonXpress_SFPQt1,1,937
2323,122928627,122928958,Protein coding,IonXpress_SFPQt1,3,331
2324,122929192,122929338,Protein coding,IonXpress_SFPQt1,3,146
2325,122929538,122929765,Protein coding,IonXpress_SFPQt1,4,227
2326,122929969,122930179,Protein coding,IonXpress_SFPQt1,4,210
2327,122930736,122930822,Protein coding,IonXpress_SFPQt1,5,86
2328,122930951,122931826,Protein coding,IonXpress_SFPQt1,1,875
2329,122930976,122931299,Protein coding,IonXpress_SFPQt1,3,323
2330,122931506,122931826,Protein coding,IonXpress_SFPQt1,3,320
2331,122932037,122932770,Protein coding,IonXpress_SFPQt1,4,733
2332,128221962,128231053,Non coding,IonXpress_NONO_c,7,9091
2333,129734745,129734859,Protein coding,IonXpress_SFPQt1,3,114
2334,129734996,129735770,Protein coding,IonXpress_SFPQt1,3,774
2335,129735878,129739387,Protein coding,IonXpress_SFPQt1,3,3509
2336,129740156,129742777,Protein coding,IonXpress_SFPQt1,4,2621
2337,129742991,129743638,Protein coding,IonXpress_SFPQt1,4,647
2338,129743910,129744006,Protein coding,IonXpress_SFPQt1,4,96
2339,129744228,129744394,Protein coding,IonXpress_SFPQt1,4,166
2340,129744475,129744686,Protein coding,IonXpress_SFPQt1,4,211
2341,129744811,129745250,Protein coding,IonXpress_SFPQt1,4,439
2342,129745358,129746614,Protein coding,IonXpress_SFPQt1,4,1256
2343,129746790,129747218,Protein coding,IonXpress_SFPQt1,4,428
2344,129747280,129748202,Protein coding,IonXpress_SFPQt1,3,922
2345,129747280,129748204,Protein coding,IonXpress_SFPQt1,1,924
2346,129748246,129748357,Protein coding,IonXpress_SFPQt1,1,111
2347,129748250,129748357,Protein coding,IonXpress_SFPQt1,3,107
2348,129748438,129751336,Protein coding,IonXpress_SFPQt1,4,2898
2349,129751403,129751620,Protein coding,IonXpress_SFPQt1,4,217
2350,129751748,129751979,Protein coding,IonXpress_SFPQt1,4,231
2351,129752089,129752344,Protein coding,IonXpress_SFPQt1,4,255
2352,129752526,129753015,Protein coding,IonXpress_SFPQt1,4,489
2353,129753101,129753963,Protein coding,IonXpress_SFPQt1,4,862
2354,129754038,129754638,Protein coding,IonXpress_SFPQt1,4,600
2355,129754741,129755328,Protein coding,IonXpress_SFPQt1,2,587
2356,129754777,129755328,Protein coding,IonXpress_SFPQt1,2,551
2357,129755504,129756210,Protein coding,IonXpress_SFPQt1,4,706
2358,129756339,129758487,Protein coding,IonXpress_SFPQt1,4,2148
2359,129758690,129762608,Protein coding,IonXpress_SFPQt1,4,3918
2360,129762765,129763190,Protein coding,IonXpress_SFPQt1,1,425
2361,129762765,129764252,Protein coding,IonXpress_SFPQt1,2,1487
2362,129763280,129764252,Protein coding,IonXpress_SFPQt1,1,972
2363,129764333,129765389,Protein coding,IonXpress_SFPQt1,3,1056
2364,132905801,132908483,Non coding,IonXpress_NONO_c,8,2682
2365,132905801,132908483,Non coding,IonXpress_SFPQt1,6,2682
2366,132908549,132912233,Non coding,IonXpress_NONO_c,8,3684
2367,132908549,132912233,Non coding,IonXpress_SFPQt1,6,3684
2368,132912341,132914544,Non coding,IonXpress_NONO_c,8,2203
2369,132912341,132914544,Non coding,IonXpress_SFPQt1,6,2203
2370,132914719,133015100,Non coding,IonXpress_NONO_c,8,100381
2371,132914719,133015100,Non coding,IonXpress_SFPQt1,6,100381
2372,133135752,133135869,Protein coding,IonXpress_NONO_c,1,117
2373,133135752,133135869,Protein coding,IonXpress_SFPQt1,2,117
2374,133135921,133136109,Protein coding,IonXpress_NONO_c,1,188
2375,133135921,133136109,Protein coding,IonXpress_SFPQt1,2,188
2376,133136227,133137598,Protein coding,IonXpress_NONO_c,1,1371
2377,133136227,133137598,Protein coding,IonXpress_SFPQt1,2,1371
2378,133137702,133138097,Protein coding,IonXpress_NONO_c,1,395
2379,133137702,133138097,Protein coding,IonXpress_SFPQt1,2,395
2380,133138200,133138617,Protein coding,IonXpress_NONO_c,1,417
2381,133138200,133138617,Protein coding,IonXpress_SFPQt1,2,417
2382,133308553,133309480,Protein coding,IonXpress_NONO_c,4,927
2383,133309539,133311560,Protein coding,IonXpress_NONO_c,4,2021
2384,133311712,133316418,Protein coding,IonXpress_NONO_c,4,4706
2385,133316647,133326544,Protein coding,IonXpress_NONO_c,4,9897
2386,133326598,133326691,Protein coding,IonXpress_NONO_c,4,93
2387,133326845,133327995,Protein coding,IonXpress_NONO_c,4,1150
2388,133328046,133328635,Protein coding,IonXpress_NONO_c,4,589
2389,133328706,133340336,Protein coding,IonXpress_NONO_c,1,11630
2390,133328709,133340336,Protein coding,IonXpress_NONO_c,1,11627
2391,133328709,133340584,Protein coding,IonXpress_NONO_c,1,11875
2392,133328709,133410454,Protein coding,IonXpress_NONO_c,1,81745
2393,133410581,133441152,Protein coding,IonXpress_NONO_c,1,30571
2394,133441321,133441574,Protein coding,IonXpress_NONO_c,1,253
2395,133561975,133562635,Protein coding,IonXpress_NONO_c,3,660
2396,133562887,133595852,Protein coding,IonXpress_NONO_c,18,32965
2397,133595951,133703528,Protein coding,IonXpress_NONO_c,18,107577
2398,133703579,133767766,Protein coding,IonXpress_NONO_c,18,64187
2399,133767892,133769247,Protein coding,IonXpress_NONO_c,9,1355
2400,133767892,133777692,Protein coding,IonXpress_NONO_c,3,9800
2401,133767892,133782250,Protein coding,IonXpress_NONO_c,6,14358
2402,133769317,133777692,Protein coding,IonXpress_NONO_c,9,8375
2403,133777786,133782250,Protein coding,IonXpress_NONO_c,12,4464
2404,133782318,133783471,Protein coding,IonXpress_NONO_c,18,1153
2405,133783615,133783757,Protein coding,IonXpress_NONO_c,18,142
2406,133783902,133785915,Protein coding,IonXpress_NONO_c,18,2013
2407,133785996,133789702,Protein coding,IonXpress_NONO_c,18,3706
2408,133789869,133802599,Protein coding,IonXpress_NONO_c,12,12730
2409,133789887,133802599,Protein coding,IonXpress_NONO_c,6,12712
2410,133802737,133804168,Protein coding,IonXpress_NONO_c,18,1431
2411,133804253,133827242,Protein coding,IonXpress_NONO_c,18,22989
2412,133827333,133833857,Protein coding,IonXpress_NONO_c,18,6524
2413,133833917,133834014,Protein coding,IonXpress_NONO_c,18,97
2414,133834176,133836457,Protein coding,IonXpress_NONO_c,18,2281
2415,133836573,133844192,Protein coding,IonXpress_NONO_c,18,7619
2416,133844315,133846151,Protein coding,IonXpress_NONO_c,9,1836
2417,133844315,133846290,Protein coding,IonXpress_NONO_c,9,1975
2418,133846253,133849861,Protein coding,IonXpress_NONO_c,6,3608
2419,133846253,133852345,Protein coding,IonXpress_NONO_c,3,6092
2420,133846392,133849861,Protein coding,IonXpress_NONO_c,9,3469
2421,134073926,134075460,Protein coding,IonXpress_NONO_c,1,1534
2422,134075520,134076070,Protein coding,IonXpress_NONO_c,1,550
2423,134076178,134084130,Protein coding,IonXpress_NONO_c,1,7952
2424,134084437,134111294,Protein coding,IonXpress_NONO_c,1,26857
2425,134305646,134308002,Protein coding,IonXpress_SFPQt1,2,2356
2426,134308181,134312005,Protein coding,IonXpress_SFPQt1,2,3824
2427,134312109,134314374,Protein coding,IonXpress_SFPQt1,2,2265
2428,134314448,134319570,Protein coding,IonXpress_SFPQt1,2,5122
2429,134319715,134321786,Protein coding,IonXpress_SFPQt1,2,2071
2430,134322029,134322470,Protein coding,IonXpress_SFPQt1,2,441
2431,134322593,134323047,Protein coding,IonXpress_SFPQt1,2,454
2432,134323191,134330461,Protein coding,IonXpress_SFPQt1,2,7270
2433,134330553,134334549,Protein coding,IonXpress_SFPQt1,2,3996
2434,134334743,134340148,Protein coding,IonXpress_SFPQt1,2,5405
2435,134340465,134342948,Protein coding,IonXpress_SFPQt1,2,2483
2436,134343140,134346173,Protein coding,IonXpress_SFPQt1,2,3033
2437,134346370,134348893,Protein coding,IonXpress_SFPQt1,4,2523
2438,134349111,134349839,Protein coding,IonXpress_SFPQt1,4,728
2439,134351922,134353129,Protein coding,IonXpress_SFPQt1,4,1207
2440,134353336,134353859,Protein coding,IonXpress_SFPQt1,4,523
2441,134354006,134354637,Protein coding,IonXpress_SFPQt1,4,631
2442,134354780,134357111,Protein coding,IonXpress_SFPQt1,4,2331
2443,134357195,134357756,Protein coding,IonXpress_SFPQt1,2,561
2444,134357195,134357759,Protein coding,IonXpress_SFPQt1,2,564
2445,134357949,134358095,Protein coding,IonXpress_SFPQt1,4,146
2446,134358294,134358744,Protein coding,IonXpress_SFPQt1,4,450
2447,134358832,134360071,Protein coding,IonXpress_SFPQt1,4,1239
2448,134360177,134360333,Protein coding,IonXpress_SFPQt1,4,156
2449,134360527,134361470,Protein coding,IonXpress_SFPQt1,6,943
2450,134361569,134362552,Protein coding,IonXpress_SFPQt1,6,983
2451,134362681,134363241,Protein coding,IonXpress_SFPQt1,6,560
2452,134363483,134366807,Protein coding,IonXpress_SFPQt1,2,3324
2453,134363483,134366810,Protein coding,IonXpress_SFPQt1,4,3327
2454,134366967,134367554,Protein coding,IonXpress_SFPQt1,6,587
2455,134367647,134369790,Protein coding,IonXpress_SFPQt1,4,2143
2456,134367647,134371125,Protein coding,IonXpress_SFPQt1,2,3478
2457,134369873,134371125,Protein coding,IonXpress_SFPQt1,4,1252
2458,135809895,135809998,Protein coding,IonXpress_SFPQt1,3,103
2459,135810055,135815579,Protein coding,IonXpress_SFPQt1,3,5524
2460,135815656,135848566,Protein coding,IonXpress_SFPQt1,3,32910
2461,135847442,135848566,Non coding,IonXpress_SFPQt1,1,1124
2462,135848700,135851183,Non coding,IonXpress_SFPQt1,1,2483
2463,135848700,135851183,Protein coding,IonXpress_SFPQt1,3,2483
2464,135851263,135870719,Non coding,IonXpress_SFPQt1,1,19456
2465,135851263,135870719,Protein coding,IonXpress_SFPQt1,3,19456
2466,135870840,135872784,Non coding,IonXpress_SFPQt1,1,1944
2467,135870840,135872784,Protein coding,IonXpress_SFPQt1,2,1944
2468,135870840,135872788,Protein coding,IonXpress_SFPQt1,1,1948
2469,135872951,135878387,Non coding,IonXpress_SFPQt1,1,5436
2470,135872951,135878387,Protein coding,IonXpress_SFPQt1,3,5436
2471,135878488,135881733,Non coding,IonXpress_SFPQt1,1,3245
2472,135878488,135881733,Protein coding,IonXpress_SFPQt1,3,3245
2473,135881816,135883749,Non coding,IonXpress_SFPQt1,1,1933
2474,135881816,135883749,Protein coding,IonXpress_SFPQt1,3,1933
2475,135883819,135884151,Non coding,IonXpress_SFPQt1,1,332
2476,135883819,135884151,Protein coding,IonXpress_SFPQt1,3,332
2477,135884226,135887563,Non coding,IonXpress_SFPQt1,1,3337
2478,135884226,135887563,Protein coding,IonXpress_SFPQt1,3,3337
2479,135887657,135888120,Non coding,IonXpress_SFPQt1,1,463
2480,135887657,135888120,Protein coding,IonXpress_SFPQt1,3,463
2481,135888291,135890463,Non coding,IonXpress_SFPQt1,1,2172
2482,135888291,135890463,Protein coding,IonXpress_SFPQt1,3,2172
2483,135890554,135891429,Non coding,IonXpress_SFPQt1,1,875
2484,135890554,135891429,Protein coding,IonXpress_SFPQt1,3,875
2485,135891603,135892833,Non coding,IonXpress_SFPQt1,1,1230
2486,135891603,135892833,Protein coding,IonXpress_SFPQt1,3,1230
2487,135892889,135893132,Non coding,IonXpress_SFPQt1,1,243
2488,135892889,135893132,Protein coding,IonXpress_SFPQt1,3,243
2489,135893502,135907937,Non coding,IonXpress_SFPQt1,1,14435
2490,135893502,135907937,Protein coding,IonXpress_SFPQt1,3,14435
2491,135908076,135911217,Non coding,IonXpress_SFPQt1,1,3141
2492,135908076,135911217,Protein coding,IonXpress_SFPQt1,3,3141
2493,135911446,135920123,Non coding,IonXpress_SFPQt1,1,8677
2494,135911446,135920123,Protein coding,IonXpress_SFPQt1,3,8677
2495,135920221,135920316,Non coding,IonXpress_SFPQt1,1,95
2496,135920221,135920316,Protein coding,IonXpress_SFPQt1,3,95
2497,135920421,135920554,Non coding,IonXpress_SFPQt1,1,133
2498,135920421,135920554,Protein coding,IonXpress_SFPQt1,3,133
2499,135920671,135922162,Non coding,IonXpress_SFPQt1,1,1491
2500,135920671,135922162,Protein coding,IonXpress_SFPQt1,3,1491
2501,135922266,135925261,Protein coding,IonXpress_SFPQt1,1,2995
2502,135922266,135926113,Non coding,IonXpress_SFPQt1,1,3847
2503,135922266,135926113,Protein coding,IonXpress_SFPQt1,2,3847
2504,135925283,135926113,Protein coding,IonXpress_SFPQt1,1,830
2505,135926319,135927302,Non coding,IonXpress_SFPQt1,1,983
2506,135927418,135932895,Non coding,IonXpress_SFPQt1,1,5477
2507,135933158,135933817,Non coding,IonXpress_SFPQt1,1,659
2508,135952576,135954425,Protein coding,IonXpress_SFPQt1,1,1849
2509,135954504,135957243,Protein coding,IonXpress_SFPQt1,1,2739
2510,135956611,135957243,Protein coding,IonXpress_SFPQt1,3,632
2511,135957327,135957415,Protein coding,IonXpress_SFPQt1,5,88
2512,135957542,135957628,Protein coding,IonXpress_SFPQt1,5,86
2513,135957744,135958660,Protein coding,IonXpress_SFPQt1,4,916
2514,135957744,135961174,Protein coding,IonXpress_SFPQt1,1,3430
2515,135958814,135960072,Protein coding,IonXpress_SFPQt1,3,1258
2516,135958814,135961174,Protein coding,IonXpress_SFPQt1,1,2360
2517,135960245,135961174,Protein coding,IonXpress_SFPQt1,3,929
2518,135961282,135961476,Protein coding,IonXpress_SFPQt1,4,194
2519,135961317,135961476,Protein coding,IonXpress_SFPQt1,1,159
2520,135961612,135962754,Protein coding,IonXpress_SFPQt1,5,1142
2521,136215101,136215775,Protein coding,IonXpress_NONO_c,1,674
2522,136215101,136215775,Protein coding,IonXpress_SFPQt1,2,674
2523,136215897,136216404,Protein coding,IonXpress_NONO_c,1,507
2524,136215897,136216404,Protein coding,IonXpress_SFPQt1,2,507
2525,136216555,136216765,Protein coding,IonXpress_NONO_c,1,210
2526,136216555,136216765,Protein coding,IonXpress_SFPQt1,2,210
2527,136216907,136217093,Protein coding,IonXpress_NONO_c,1,186
2528,136216907,136217093,Protein coding,IonXpress_SFPQt1,2,186
2529,136217174,136217450,Protein coding,IonXpress_NONO_c,1,276
2530,136217174,136217450,Protein coding,IonXpress_SFPQt1,2,276
2531,136217582,136217855,Protein coding,IonXpress_NONO_c,1,273
2532,136217582,136217855,Protein coding,IonXpress_SFPQt1,2,273
2533,136217926,136218115,Protein coding,IonXpress_NONO_c,1,189
2534,136217926,136218115,Protein coding,IonXpress_SFPQt1,2,189
2535,137891803,137892139,Protein coding,IonXpress_NONO_c,1,336
2536,137891803,137892139,Protein coding,IonXpress_SFPQt1,1,336
2537,137892281,137892461,Protein coding,IonXpress_NONO_c,1,180
2538,137892281,137892461,Protein coding,IonXpress_SFPQt1,1,180
2539,137892555,137893089,Protein coding,IonXpress_NONO_c,1,534
2540,137892555,137893089,Protein coding,IonXpress_SFPQt1,1,534
2541,137893185,137893556,Protein coding,IonXpress_NONO_c,1,371
2542,137893185,137893556,Protein coding,IonXpress_SFPQt1,1,371
2543,137893185,137894240,Protein coding,IonXpress_NONO_c,1,1055
2544,137893185,137894240,Protein coding,IonXpress_SFPQt1,1,1055
2545,137893675,137894240,Protein coding,IonXpress_NONO_c,1,565
2546,137893675,137894240,Protein coding,IonXpress_SFPQt1,1,565
2547,137894346,137895551,Protein coding,IonXpress_NONO_c,2,1205
2548,137894346,137895551,Protein coding,IonXpress_SFPQt1,2,1205
2549,137895780,137897267,Protein coding,IonXpress_NONO_c,2,1487
2550,137895780,137897267,Protein coding,IonXpress_SFPQt1,2,1487
2551,137897478,137902313,Protein coding,IonXpress_NONO_c,2,4835
2552,137897478,137902313,Protein coding,IonXpress_SFPQt1,2,4835
2553,137902407,137902688,Protein coding,IonXpress_NONO_c,2,281
2554,137902407,137902688,Protein coding,IonXpress_SFPQt1,2,281
2555,137902852,137903142,Protein coding,IonXpress_NONO_c,2,290
2556,137902852,137903142,Protein coding,IonXpress_SFPQt1,2,290
2557,137903250,137903336,Protein coding,IonXpress_NONO_c,2,86
2558,137903250,137903336,Protein coding,IonXpress_SFPQt1,2,86
2559,137903411,137904612,Protein coding,IonXpress_NONO_c,2,1201
2560,137903411,137904612,Protein coding,IonXpress_SFPQt1,2,1201
2561,137904738,137906647,Protein coding,IonXpress_NONO_c,2,1909
2562,137904738,137906647,Protein coding,IonXpress_SFPQt1,2,1909
2563,137906830,137909450,Protein coding,IonXpress_NONO_c,2,2620
2564,137906830,137909450,Protein coding,IonXpress_SFPQt1,2,2620
2565,137909539,137909755,Protein coding,IonXpress_NONO_c,2,216
2566,137909539,137909755,Protein coding,IonXpress_SFPQt1,2,216
2567,137909815,137910925,Protein coding,IonXpress_NONO_c,1,1110
2568,137909815,137910925,Protein coding,IonXpress_SFPQt1,1,1110
2569,137909858,137910925,Protein coding,IonXpress_NONO_c,1,1067
2570,137909858,137910925,Protein coding,IonXpress_SFPQt1,1,1067
2571,138609850,138611808,Non coding,IonXpress_NONO_c,2,1958
2572,138609850,138611808,Non coding,IonXpress_SFPQt1,2,1958
2573,138609850,138611808,Protein coding,IonXpress_NONO_c,4,1958
2574,138609850,138611808,Protein coding,IonXpress_SFPQt1,4,1958
2575,138611839,138614014,Non coding,IonXpress_NONO_c,2,2175
2576,138611839,138614014,Non coding,IonXpress_SFPQt1,2,2175
2577,138611839,138614014,Protein coding,IonXpress_NONO_c,3,2175
2578,138611839,138614014,Protein coding,IonXpress_SFPQt1,3,2175
2579,138611839,138614738,Protein coding,IonXpress_NONO_c,1,2899
2580,138611839,138614738,Protein coding,IonXpress_SFPQt1,1,2899
2581,138614097,138614738,Non coding,IonXpress_NONO_c,1,641
2582,138614097,138614738,Non coding,IonXpress_SFPQt1,1,641
2583,138614097,138614738,Protein coding,IonXpress_NONO_c,3,641
2584,138614097,138614738,Protein coding,IonXpress_SFPQt1,3,641
2585,138614185,138614738,Non coding,IonXpress_NONO_c,1,553
2586,138614185,138614738,Non coding,IonXpress_SFPQt1,1,553
2587,138614818,138615622,Protein coding,IonXpress_NONO_c,1,804
2588,138614818,138615622,Protein coding,IonXpress_SFPQt1,1,804
2589,138614818,138618426,Non coding,IonXpress_NONO_c,1,3608
2590,138614818,138618426,Non coding,IonXpress_SFPQt1,1,3608
2591,138614818,138642926,Protein coding,IonXpress_NONO_c,2,28108
2592,138614818,138642926,Protein coding,IonXpress_SFPQt1,2,28108
2593,138614818,138650362,Protein coding,IonXpress_NONO_c,1,35544
2594,138614818,138650362,Protein coding,IonXpress_SFPQt1,1,35544
2595,138615747,138642926,Protein coding,IonXpress_NONO_c,1,27179
2596,138615747,138642926,Protein coding,IonXpress_SFPQt1,1,27179
2597,138644016,138650362,Protein coding,IonXpress_NONO_c,2,6346
2598,138644016,138650362,Protein coding,IonXpress_SFPQt1,2,6346
2599,138650425,138651384,Protein coding,IonXpress_NONO_c,3,959
2600,138650425,138651384,Protein coding,IonXpress_SFPQt1,3,959
2601,138651427,138651763,Protein coding,IonXpress_NONO_c,3,336
2602,138651427,138651763,Protein coding,IonXpress_SFPQt1,3,336
2603,138651877,138652740,Protein coding,IonXpress_NONO_c,3,863
2604,138651877,138652740,Protein coding,IonXpress_SFPQt1,3,863
2605,138652794,138653283,Protein coding,IonXpress_NONO_c,3,489
2606,138652794,138653283,Protein coding,IonXpress_SFPQt1,3,489
2607,138653410,138654595,Protein coding,IonXpress_NONO_c,3,1185
2608,138653410,138654595,Protein coding,IonXpress_SFPQt1,3,1185
2609,138654722,138655021,Protein coding,IonXpress_NONO_c,3,299
2610,138654722,138655021,Protein coding,IonXpress_SFPQt1,3,299
2611,138655190,138657585,Protein coding,IonXpress_NONO_c,3,2395
2612,138655190,138657585,Protein coding,IonXpress_SFPQt1,3,2395
2613,138657718,138658150,Protein coding,IonXpress_NONO_c,3,432
2614,138657718,138658150,Protein coding,IonXpress_SFPQt1,3,432
2615,138658195,138658285,Protein coding,IonXpress_NONO_c,3,90
2616,138658195,138658285,Protein coding,IonXpress_SFPQt1,3,90
2617,138658656,138661127,Protein coding,IonXpress_NONO_c,3,2471
2618,138658656,138661127,Protein coding,IonXpress_SFPQt1,3,2471
2619,138661351,138661850,Protein coding,IonXpress_NONO_c,3,499
2620,138661351,138661850,Protein coding,IonXpress_SFPQt1,3,499
2621,138661973,138665032,Protein coding,IonXpress_NONO_c,3,3059
2622,138661973,138665032,Protein coding,IonXpress_SFPQt1,3,3059
2623,140167477,140358532,Non coding,IonXpress_SFPQt1,1,191055
2624,140168269,140358532,Non coding,IonXpress_SFPQt1,1,190263
2625,140176937,140184643,Protein coding,IonXpress_SFPQt1,1,7706
2626,140176937,140358532,Protein coding,IonXpress_SFPQt1,1,181595
2627,140358592,140362058,Non coding,IonXpress_SFPQt1,2,3466
2628,140358592,140362058,Protein coding,IonXpress_SFPQt1,1,3466
2629,140362148,140389210,Non coding,IonXpress_SFPQt1,2,27062
2630,140362148,140389210,Protein coding,IonXpress_SFPQt1,1,27062
2631,141542251,141542513,Protein coding,IonXpress_NONO_c,3,262
2632,141542714,141545565,Protein coding,IonXpress_NONO_c,2,2851
2633,141542714,141549417,Protein coding,IonXpress_NONO_c,1,6703
2634,141545668,141549417,Protein coding,IonXpress_NONO_c,2,3749
2635,141549553,141551261,Protein coding,IonXpress_NONO_c,3,1708
2636,141551457,141554310,Protein coding,IonXpress_NONO_c,3,2853
2637,141554402,141557565,Protein coding,IonXpress_NONO_c,3,3163
2638,141557726,141559211,Protein coding,IonXpress_NONO_c,3,1485
2639,141559397,141561400,Protein coding,IonXpress_NONO_c,3,2003
2640,141561535,141565993,Protein coding,IonXpress_NONO_c,3,4458
2641,141566117,141566264,Protein coding,IonXpress_NONO_c,3,147
2642,141566385,141567186,Protein coding,IonXpress_NONO_c,3,801
2643,141567335,141568582,Protein coding,IonXpress_NONO_c,3,1247
2644,141568671,141569492,Protein coding,IonXpress_NONO_c,3,821
2645,141569628,141570471,Protein coding,IonXpress_NONO_c,3,843
2646,141570609,141572550,Protein coding,IonXpress_NONO_c,3,1941
2647,141572733,141582909,Protein coding,IonXpress_NONO_c,3,10176
2648,141583031,141595216,Protein coding,IonXpress_NONO_c,2,12185
2649,141583031,141645582,Protein coding,IonXpress_NONO_c,1,62551
2650,141595410,141645582,Protein coding,IonXpress_NONO_c,2,50172
2651,144147021,144148788,Protein coding,IonXpress_NONO_c,1,1767
2652,144147021,144148788,Protein coding,IonXpress_SFPQt1,2,1767
2653,144148892,144149725,Protein coding,IonXpress_NONO_c,1,833
2654,144148892,144149725,Protein coding,IonXpress_SFPQt1,2,833
2655,144149941,144150980,Protein coding,IonXpress_NONO_c,1,1039
2656,144149941,144150980,Protein coding,IonXpress_SFPQt1,2,1039
2657,144151054,144151517,Protein coding,IonXpress_NONO_c,1,463
2658,144151054,144151517,Protein coding,IonXpress_SFPQt1,2,463
2659,144151724,144153011,Protein coding,IonXpress_NONO_c,1,1287
2660,144151724,144153011,Protein coding,IonXpress_SFPQt1,2,1287
2661,144153064,144156970,Protein coding,IonXpress_NONO_c,1,3906
2662,144153064,144156970,Protein coding,IonXpress_SFPQt1,2,3906
2663,144157135,144158176,Protein coding,IonXpress_NONO_c,1,1041
2664,144157135,144158176,Protein coding,IonXpress_SFPQt1,2,1041
2665,144158252,144158377,Protein coding,IonXpress_NONO_c,1,125
2666,144158252,144158377,Protein coding,IonXpress_SFPQt1,2,125
2667,144158391,144158869,Protein coding,IonXpress_NONO_c,1,478
2668,144158391,144158869,Protein coding,IonXpress_SFPQt1,2,478
2669,144159043,144164517,Protein coding,IonXpress_NONO_c,1,5474
2670,144159043,144164517,Protein coding,IonXpress_SFPQt1,2,5474
2671,144164570,144179472,Protein coding,IonXpress_NONO_c,1,14902
2672,144164570,144179472,Protein coding,IonXpress_SFPQt1,2,14902
2673,144179646,144180354,Protein coding,IonXpress_NONO_c,1,708
2674,144179646,144180354,Protein coding,IonXpress_SFPQt1,2,708
2675,144180407,144181062,Protein coding,IonXpress_NONO_c,1,655
2676,144180407,144181062,Protein coding,IonXpress_SFPQt1,2,655
2677,144181236,144181949,Protein coding,IonXpress_NONO_c,1,713
2678,144181236,144181949,Protein coding,IonXpress_SFPQt1,2,713
2679,144182059,144182694,Protein coding,IonXpress_NONO_c,1,635
2680,144182059,144182694,Protein coding,IonXpress_SFPQt1,2,635
2681,144182868,144183586,Protein coding,IonXpress_NONO_c,1,718
2682,144182868,144183586,Protein coding,IonXpress_SFPQt1,2,718
2683,144183639,144184250,Protein coding,IonXpress_NONO_c,1,611
2684,144183639,144184250,Protein coding,IonXpress_SFPQt1,2,611
2685,144184424,144185132,Protein coding,IonXpress_NONO_c,2,708
2686,144184424,144185132,Protein coding,IonXpress_SFPQt1,3,708
2687,144185185,144185826,Protein coding,IonXpress_NONO_c,2,641
2688,144185185,144185826,Protein coding,IonXpress_SFPQt1,3,641
2689,144186000,144186713,Protein coding,IonXpress_NONO_c,1,713
2690,144186000,144186713,Protein coding,IonXpress_SFPQt1,2,713
2691,144186000,144191467,Protein coding,IonXpress_NONO_c,1,5467
2692,144186000,144191467,Protein coding,IonXpress_SFPQt1,1,5467
2693,144186823,144187458,Protein coding,IonXpress_NONO_c,1,635
2694,144186823,144187458,Protein coding,IonXpress_SFPQt1,2,635
2695,144187632,144188350,Protein coding,IonXpress_NONO_c,1,718
2696,144187632,144188350,Protein coding,IonXpress_SFPQt1,2,718
2697,144188403,144189010,Protein coding,IonXpress_NONO_c,1,607
2698,144188403,144189010,Protein coding,IonXpress_SFPQt1,2,607
2699,144189184,144189892,Protein coding,IonXpress_NONO_c,1,708
2700,144189184,144189892,Protein coding,IonXpress_SFPQt1,2,708
2701,144189945,144190580,Protein coding,IonXpress_NONO_c,1,635
2702,144189945,144190580,Protein coding,IonXpress_SFPQt1,2,635
2703,144190754,144191467,Protein coding,IonXpress_NONO_c,1,713
2704,144190754,144191467,Protein coding,IonXpress_SFPQt1,2,713
2705,144191577,144192204,Protein coding,IonXpress_NONO_c,2,627
2706,144191577,144192204,Protein coding,IonXpress_SFPQt1,3,627
2707,144192378,144193096,Protein coding,IonXpress_NONO_c,2,718
2708,144192378,144193096,Protein coding,IonXpress_SFPQt1,3,718
2709,144193149,144193758,Protein coding,IonXpress_NONO_c,1,609
2710,144193149,144193758,Protein coding,IonXpress_SFPQt1,2,609
2711,144193149,144198518,Protein coding,IonXpress_NONO_c,1,5369
2712,144193149,144198518,Protein coding,IonXpress_SFPQt1,1,5369
2713,144193932,144194640,Protein coding,IonXpress_NONO_c,1,708
2714,144193932,144194640,Protein coding,IonXpress_SFPQt1,2,708
2715,144194693,144195342,Protein coding,IonXpress_NONO_c,1,649
2716,144194693,144195342,Protein coding,IonXpress_SFPQt1,2,649
2717,144195516,144196229,Protein coding,IonXpress_NONO_c,1,713
2718,144195516,144196229,Protein coding,IonXpress_SFPQt1,2,713
2719,144196339,144196974,Protein coding,IonXpress_NONO_c,1,635
2720,144196339,144196974,Protein coding,IonXpress_SFPQt1,2,635
2721,144197148,144197866,Protein coding,IonXpress_NONO_c,1,718
2722,144197148,144197866,Protein coding,IonXpress_SFPQt1,2,718
2723,144197919,144201703,Protein coding,IonXpress_NONO_c,1,3784
2724,144197919,144201703,Protein coding,IonXpress_SFPQt1,2,3784
2725,144198692,144199400,Protein coding,IonXpress_NONO_c,1,708
2726,144198692,144199400,Protein coding,IonXpress_SFPQt1,1,708
2727,144199453,144200104,Protein coding,IonXpress_NONO_c,1,651
2728,144199453,144200104,Protein coding,IonXpress_SFPQt1,1,651
2729,144200278,144223264,Protein coding,IonXpress_NONO_c,1,22986
2730,144200278,144223264,Protein coding,IonXpress_SFPQt1,1,22986
2731,144201877,144202585,Protein coding,IonXpress_NONO_c,1,708
2732,144201877,144202585,Protein coding,IonXpress_SFPQt1,2,708
2733,144202638,144203297,Protein coding,IonXpress_NONO_c,1,659
2734,144202638,144203297,Protein coding,IonXpress_SFPQt1,2,659
2735,144203471,144204184,Protein coding,IonXpress_NONO_c,1,713
2736,144203471,144204184,Protein coding,IonXpress_SFPQt1,2,713
2737,144204294,144204923,Protein coding,IonXpress_NONO_c,1,629
2738,144204294,144204923,Protein coding,IonXpress_SFPQt1,2,629
2739,144205097,144205815,Protein coding,IonXpress_NONO_c,1,718
2740,144205097,144205815,Protein coding,IonXpress_SFPQt1,2,718
2741,144205868,144216026,Protein coding,IonXpress_NONO_c,1,10158
2742,144205868,144216026,Protein coding,IonXpress_SFPQt1,2,10158
2743,144216200,144216908,Protein coding,IonXpress_NONO_c,1,708
2744,144216200,144216908,Protein coding,IonXpress_SFPQt1,2,708
2745,144216961,144217610,Protein coding,IonXpress_NONO_c,1,649
2746,144216961,144217610,Protein coding,IonXpress_SFPQt1,2,649
2747,144217784,144218497,Protein coding,IonXpress_NONO_c,1,713
2748,144217784,144218497,Protein coding,IonXpress_SFPQt1,2,713
2749,144218607,144219234,Protein coding,IonXpress_NONO_c,1,627
2750,144218607,144219234,Protein coding,IonXpress_SFPQt1,2,627
2751,144219408,144220126,Protein coding,IonXpress_NONO_c,1,718
2752,144219408,144220126,Protein coding,IonXpress_SFPQt1,2,718
2753,144220179,144220785,Protein coding,IonXpress_NONO_c,1,606
2754,144220179,144220785,Protein coding,IonXpress_SFPQt1,2,606
2755,144220959,144221667,Protein coding,IonXpress_NONO_c,1,708
2756,144220959,144221667,Protein coding,IonXpress_SFPQt1,2,708
2757,144221720,144222377,Protein coding,IonXpress_NONO_c,1,657
2758,144221720,144222377,Protein coding,IonXpress_SFPQt1,2,657
2759,144222551,144223264,Protein coding,IonXpress_NONO_c,1,713
2760,144222551,144223264,Protein coding,IonXpress_SFPQt1,2,713
2761,144223374,144224001,Protein coding,IonXpress_NONO_c,2,627
2762,144223374,144224001,Protein coding,IonXpress_SFPQt1,3,627
2763,144224175,144824703,Protein coding,IonXpress_NONO_c,2,600528
2764,144224175,144824703,Protein coding,IonXpress_SFPQt1,3,600528
2765,144594483,144595833,Protein coding,IonXpress_NONO_c,1,1350
2766,144594483,144595833,Protein coding,IonXpress_SFPQt1,1,1350
2767,144595952,144598510,Protein coding,IonXpress_NONO_c,1,2558
2768,144595952,144598510,Protein coding,IonXpress_SFPQt1,1,2558
2769,144598780,144606367,Protein coding,IonXpress_NONO_c,1,7587
2770,144598780,144606367,Protein coding,IonXpress_SFPQt1,1,7587
2771,144606510,144606836,Protein coding,IonXpress_NONO_c,1,326
2772,144606510,144606836,Protein coding,IonXpress_SFPQt1,1,326
2773,144607061,144615094,Protein coding,IonXpress_NONO_c,1,8033
2774,144607061,144615094,Protein coding,IonXpress_SFPQt1,1,8033
2775,144614998,144615094,Protein coding,IonXpress_NONO_c,1,96
2776,144614998,144615094,Protein coding,IonXpress_SFPQt1,1,96
2777,144615244,144615247,Protein coding,IonXpress_NONO_c,1,3
2778,144615244,144615247,Protein coding,IonXpress_SFPQt1,1,3
2779,144615303,144617148,Protein coding,IonXpress_NONO_c,2,1845
2780,144615303,144617148,Protein coding,IonXpress_SFPQt1,2,1845
2781,144617252,144618080,Protein coding,IonXpress_NONO_c,2,828
2782,144617252,144618080,Protein coding,IonXpress_SFPQt1,2,828
2783,144618296,144619345,Protein coding,IonXpress_NONO_c,2,1049
2784,144618296,144619345,Protein coding,IonXpress_SFPQt1,2,1049
2785,144619419,144619881,Protein coding,IonXpress_NONO_c,2,462
2786,144619419,144619881,Protein coding,IonXpress_SFPQt1,2,462
2787,144620094,144621445,Protein coding,IonXpress_NONO_c,2,1351
2788,144620094,144621445,Protein coding,IonXpress_SFPQt1,2,1351
2789,144621656,144813740,Protein coding,IonXpress_NONO_c,2,192084
2790,144621656,144813740,Protein coding,IonXpress_SFPQt1,2,192084
2791,144813844,144814678,Protein coding,IonXpress_NONO_c,2,834
2792,144813844,144814678,Protein coding,IonXpress_SFPQt1,2,834
2793,144814894,144815934,Protein coding,IonXpress_NONO_c,1,1040
2794,144814894,144815934,Protein coding,IonXpress_SFPQt1,1,1040
2795,144814894,144817964,Protein coding,IonXpress_NONO_c,1,3070
2796,144814894,144817964,Protein coding,IonXpress_SFPQt1,1,3070
2797,144816008,144816471,Protein coding,IonXpress_NONO_c,1,463
2798,144816008,144816471,Protein coding,IonXpress_SFPQt1,1,463
2799,144816678,144817964,Protein coding,IonXpress_NONO_c,1,1286
2800,144816678,144817964,Protein coding,IonXpress_SFPQt1,1,1286
2801,144818017,144821919,Protein coding,IonXpress_NONO_c,2,3902
2802,144818017,144821919,Protein coding,IonXpress_SFPQt1,2,3902
2803,144821973,144823126,Protein coding,IonXpress_NONO_c,1,1153
2804,144821973,144823126,Protein coding,IonXpress_SFPQt1,1,1153
2805,144822084,144823126,Protein coding,IonXpress_NONO_c,1,1042
2806,144822084,144823126,Protein coding,IonXpress_SFPQt1,1,1042
2807,144823179,144823811,Protein coding,IonXpress_NONO_c,2,632
2808,144823179,144823811,Protein coding,IonXpress_SFPQt1,2,632
2809,144823985,144824703,Protein coding,IonXpress_NONO_c,2,718
2810,144823985,144824703,Protein coding,IonXpress_SFPQt1,2,718
2811,144824756,144825351,Protein coding,IonXpress_NONO_c,2,595
2812,144824756,144825351,Protein coding,IonXpress_SFPQt1,2,595
2813,144824756,145313332,Protein coding,IonXpress_NONO_c,2,488576
2814,144824756,145313332,Protein coding,IonXpress_SFPQt1,3,488576
2815,144825525,144826233,Protein coding,IonXpress_NONO_c,2,708
2816,144825525,144826233,Protein coding,IonXpress_SFPQt1,2,708
2817,144826286,144826931,Protein coding,IonXpress_NONO_c,2,645
2818,144826286,144826931,Protein coding,IonXpress_SFPQt1,2,645
2819,144827105,144827818,Protein coding,IonXpress_NONO_c,2,713
2820,144827105,144827818,Protein coding,IonXpress_SFPQt1,2,713
2821,144827928,145313332,Protein coding,IonXpress_NONO_c,2,485404
2822,144827928,145313332,Protein coding,IonXpress_SFPQt1,2,485404
2823,145209436,145248811,Protein coding,IonXpress_NONO_c,3,39375
2824,145209436,145248811,Protein coding,IonXpress_SFPQt1,3,39375
2825,145209436,145248819,Non coding,IonXpress_NONO_c,1,39383
2826,145209436,145248819,Non coding,IonXpress_SFPQt1,1,39383
2827,145209436,145248819,Protein coding,IonXpress_NONO_c,1,39383
2828,145209436,145248819,Protein coding,IonXpress_SFPQt1,1,39383
2829,145224702,145227039,Protein coding,IonXpress_NONO_c,1,2337
2830,145224702,145227039,Protein coding,IonXpress_SFPQt1,1,2337
2831,145227336,145248811,Protein coding,IonXpress_NONO_c,1,21475
2832,145227336,145248811,Protein coding,IonXpress_SFPQt1,1,21475
2833,145248894,145273183,Non coding,IonXpress_NONO_c,1,24289
2834,145248894,145273183,Non coding,IonXpress_SFPQt1,1,24289
2835,145248894,145273183,Protein coding,IonXpress_NONO_c,5,24289
2836,145248894,145273183,Protein coding,IonXpress_SFPQt1,5,24289
2837,145273444,145281367,Non coding,IonXpress_NONO_c,1,7923
2838,145273444,145281367,Non coding,IonXpress_SFPQt1,1,7923
2839,145273444,145281367,Protein coding,IonXpress_NONO_c,5,7923
2840,145273444,145281367,Protein coding,IonXpress_SFPQt1,5,7923
2841,145281704,145281953,Protein coding,IonXpress_NONO_c,3,249
2842,145281704,145281953,Protein coding,IonXpress_SFPQt1,3,249
2843,145281704,145290427,Non coding,IonXpress_NONO_c,1,8723
2844,145281704,145290427,Non coding,IonXpress_SFPQt1,1,8723
2845,145281704,145290427,Protein coding,IonXpress_NONO_c,1,8723
2846,145281704,145290427,Protein coding,IonXpress_SFPQt1,1,8723
2847,145281704,145293112,Protein coding,IonXpress_NONO_c,1,11408
2848,145281704,145293112,Protein coding,IonXpress_SFPQt1,1,11408
2849,145290511,145290779,Non coding,IonXpress_NONO_c,1,268
2850,145290511,145290779,Non coding,IonXpress_SFPQt1,1,268
2851,145290511,145290779,Protein coding,IonXpress_NONO_c,1,268
2852,145290511,145290779,Protein coding,IonXpress_SFPQt1,1,268
2853,145290850,145293369,Non coding,IonXpress_NONO_c,1,2519
2854,145290850,145293369,Non coding,IonXpress_SFPQt1,1,2519
2855,145293272,145293369,Protein coding,IonXpress_NONO_c,1,97
2856,145293272,145293369,Protein coding,IonXpress_SFPQt1,1,97
2857,145293580,145295421,Non coding,IonXpress_NONO_c,1,1841
2858,145293580,145295421,Non coding,IonXpress_SFPQt1,1,1841
2859,145293580,145295421,Protein coding,IonXpress_NONO_c,1,1841
2860,145293580,145295421,Protein coding,IonXpress_SFPQt1,2,1841
2861,145295525,145296355,Protein coding,IonXpress_NONO_c,1,830
2862,145295525,145296355,Protein coding,IonXpress_SFPQt1,2,830
2863,145296571,145297617,Protein coding,IonXpress_NONO_c,1,1046
2864,145296571,145297617,Protein coding,IonXpress_SFPQt1,2,1046
2865,145297691,145298153,Protein coding,IonXpress_NONO_c,1,462
2866,145297691,145298153,Protein coding,IonXpress_SFPQt1,2,462
2867,145298366,145299728,Protein coding,IonXpress_NONO_c,1,1362
2868,145298366,145299728,Protein coding,IonXpress_SFPQt1,2,1362
2869,145299939,145301718,Protein coding,IonXpress_NONO_c,1,1779
2870,145299939,145301718,Protein coding,IonXpress_SFPQt1,2,1779
2871,145301822,145302652,Protein coding,IonXpress_NONO_c,1,830
2872,145301822,145302652,Protein coding,IonXpress_SFPQt1,2,830
2873,145302868,145303908,Protein coding,IonXpress_NONO_c,1,1040
2874,145302868,145303908,Protein coding,IonXpress_SFPQt1,2,1040
2875,145303982,145304445,Protein coding,IonXpress_NONO_c,1,463
2876,145303982,145304445,Protein coding,IonXpress_SFPQt1,2,463
2877,145304652,145305943,Protein coding,IonXpress_SFPQt1,1,1291
2878,145305996,145309898,Protein coding,IonXpress_SFPQt1,1,3902
2879,145310063,145311101,Protein coding,IonXpress_SFPQt1,1,1038
2880,145311154,145311784,Protein coding,IonXpress_SFPQt1,1,630
2881,145311958,145312676,Protein coding,IonXpress_SFPQt1,1,718
2882,145312729,145313332,Protein coding,IonXpress_SFPQt1,1,603
2883,145313506,145314214,Protein coding,IonXpress_NONO_c,4,708
2884,145313506,145314214,Protein coding,IonXpress_SFPQt1,6,708
2885,145314267,145314902,Protein coding,IonXpress_NONO_c,4,635
2886,145314267,145314902,Protein coding,IonXpress_SFPQt1,6,635
2887,145315076,145315789,Protein coding,IonXpress_NONO_c,3,713
2888,145315076,145315789,Protein coding,IonXpress_SFPQt1,5,713
2889,145315076,145334682,Protein coding,IonXpress_NONO_c,1,19606
2890,145315076,145334682,Protein coding,IonXpress_SFPQt1,1,19606
2891,145315899,145316510,Protein coding,IonXpress_NONO_c,1,611
2892,145315899,145316510,Protein coding,IonXpress_SFPQt1,3,611
2893,145315899,145368439,Protein coding,IonXpress_NONO_c,2,52540
2894,145315899,145368439,Protein coding,IonXpress_SFPQt1,2,52540
2895,145316684,145317404,Protein coding,IonXpress_NONO_c,1,720
2896,145316684,145317404,Protein coding,IonXpress_SFPQt1,3,720
2897,145317457,145318052,Protein coding,IonXpress_NONO_c,1,595
2898,145317457,145318052,Protein coding,IonXpress_SFPQt1,3,595
2899,145318226,145318934,Protein coding,IonXpress_NONO_c,1,708
2900,145318226,145318934,Protein coding,IonXpress_SFPQt1,3,708
2901,145318987,145319622,Protein coding,IonXpress_NONO_c,1,635
2902,145318987,145319622,Protein coding,IonXpress_SFPQt1,3,635
2903,145319796,145320509,Protein coding,IonXpress_NONO_c,1,713
2904,145319796,145320509,Protein coding,IonXpress_SFPQt1,3,713
2905,145320619,145321228,Protein coding,IonXpress_SFPQt1,1,609
2906,145320619,145330681,Protein coding,IonXpress_NONO_c,1,10062
2907,145320619,145330681,Protein coding,IonXpress_SFPQt1,2,10062
2908,145321402,145322122,Protein coding,IonXpress_SFPQt1,1,720
2909,145322175,145322770,Protein coding,IonXpress_SFPQt1,1,595
2910,145322944,145323652,Protein coding,IonXpress_SFPQt1,1,708
2911,145323705,145324346,Protein coding,IonXpress_SFPQt1,1,641
2912,145324520,145325233,Protein coding,IonXpress_SFPQt1,1,713
2913,145325343,145325950,Protein coding,IonXpress_SFPQt1,1,607
2914,145326124,145331573,Protein coding,IonXpress_SFPQt1,1,5449
2915,145330855,145331573,Protein coding,IonXpress_NONO_c,1,718
2916,145330855,145331573,Protein coding,IonXpress_SFPQt1,2,718
2917,145331626,145332221,Protein coding,IonXpress_NONO_c,1,595
2918,145331626,145332221,Protein coding,IonXpress_SFPQt1,3,595
2919,145332395,145333103,Protein coding,IonXpress_NONO_c,1,708
2920,145332395,145333103,Protein coding,IonXpress_SFPQt1,3,708
2921,145333156,145333795,Protein coding,IonXpress_NONO_c,1,639
2922,145333156,145333795,Protein coding,IonXpress_SFPQt1,3,639
2923,145333969,145334682,Protein coding,IonXpress_NONO_c,1,713
2924,145333969,145334682,Protein coding,IonXpress_SFPQt1,3,713
2925,145334792,145335387,Protein coding,IonXpress_NONO_c,2,595
2926,145334792,145335387,Protein coding,IonXpress_SFPQt1,4,595
2927,145335561,145336279,Protein coding,IonXpress_NONO_c,2,718
2928,145335561,145336279,Protein coding,IonXpress_SFPQt1,4,718
2929,145336332,145336927,Protein coding,IonXpress_NONO_c,2,595
2930,145336332,145336927,Protein coding,IonXpress_SFPQt1,4,595
2931,145337101,145337809,Protein coding,IonXpress_NONO_c,2,708
2932,145337101,145337809,Protein coding,IonXpress_SFPQt1,4,708
2933,145337862,145338515,Protein coding,IonXpress_NONO_c,2,653
2934,145337862,145338515,Protein coding,IonXpress_SFPQt1,4,653
2935,145338689,145339402,Protein coding,IonXpress_NONO_c,2,713
2936,145338689,145339402,Protein coding,IonXpress_SFPQt1,4,713
2937,145339512,145340107,Protein coding,IonXpress_NONO_c,1,595
2938,145339512,145340107,Protein coding,IonXpress_SFPQt1,3,595
2939,145340281,145340999,Protein coding,IonXpress_NONO_c,1,718
2940,145340281,145340999,Protein coding,IonXpress_SFPQt1,3,718
2941,145341052,145341647,Protein coding,IonXpress_NONO_c,1,595
2942,145341052,145341647,Protein coding,IonXpress_SFPQt1,3,595
2943,145341821,145342529,Protein coding,IonXpress_NONO_c,1,708
2944,145341821,145342529,Protein coding,IonXpress_SFPQt1,3,708
2945,145342582,145343239,Protein coding,IonXpress_NONO_c,1,657
2946,145342582,145343239,Protein coding,IonXpress_SFPQt1,3,657
2947,145343413,145344126,Protein coding,IonXpress_NONO_c,1,713
2948,145343413,145344126,Protein coding,IonXpress_SFPQt1,3,713
2949,145344236,145344831,Protein coding,IonXpress_NONO_c,1,595
2950,145344236,145344831,Protein coding,IonXpress_SFPQt1,3,595
2951,145345005,145345723,Protein coding,IonXpress_NONO_c,1,718
2952,145345005,145345723,Protein coding,IonXpress_SFPQt1,3,718
2953,145345776,145346371,Protein coding,IonXpress_NONO_c,1,595
2954,145345776,145346371,Protein coding,IonXpress_SFPQt1,3,595
2955,145346545,145347253,Protein coding,IonXpress_NONO_c,1,708
2956,145346545,145347253,Protein coding,IonXpress_SFPQt1,3,708
2957,145347306,145347963,Protein coding,IonXpress_NONO_c,1,657
2958,145347306,145347963,Protein coding,IonXpress_SFPQt1,3,657
2959,145348137,145348850,Protein coding,IonXpress_NONO_c,1,713
2960,145348137,145348850,Protein coding,IonXpress_SFPQt1,3,713
2961,145348960,145349561,Protein coding,IonXpress_NONO_c,1,601
2962,145348960,145349561,Protein coding,IonXpress_SFPQt1,3,601
2963,145349735,145350453,Protein coding,IonXpress_NONO_c,1,718
2964,145349735,145350453,Protein coding,IonXpress_SFPQt1,3,718
2965,145350506,145351101,Protein coding,IonXpress_NONO_c,1,595
2966,145350506,145351101,Protein coding,IonXpress_SFPQt1,3,595
2967,145351275,145351983,Protein coding,IonXpress_NONO_c,1,708
2968,145351275,145351983,Protein coding,IonXpress_SFPQt1,3,708
2969,145352036,145352683,Protein coding,IonXpress_NONO_c,1,647
2970,145352036,145352683,Protein coding,IonXpress_SFPQt1,3,647
2971,145352857,145353570,Protein coding,IonXpress_NONO_c,1,713
2972,145352857,145353570,Protein coding,IonXpress_SFPQt1,3,713
2973,145353680,145354293,Protein coding,IonXpress_NONO_c,1,613
2974,145353680,145354293,Protein coding,IonXpress_SFPQt1,3,613
2975,145354467,145355185,Protein coding,IonXpress_NONO_c,1,718
2976,145354467,145355185,Protein coding,IonXpress_SFPQt1,3,718
2977,145355238,145355835,Protein coding,IonXpress_NONO_c,1,597
2978,145355238,145355835,Protein coding,IonXpress_SFPQt1,3,597
2979,145356009,145362977,Protein coding,IonXpress_NONO_c,1,6968
2980,145356009,145362977,Protein coding,IonXpress_SFPQt1,3,6968
2981,145363030,145363677,Protein coding,IonXpress_NONO_c,1,647
2982,145363030,145363677,Protein coding,IonXpress_SFPQt1,3,647
2983,145363851,145364564,Protein coding,IonXpress_NONO_c,1,713
2984,145363851,145364564,Protein coding,IonXpress_SFPQt1,3,713
2985,145364674,145365285,Protein coding,IonXpress_SFPQt1,1,611
2986,145364674,146420017,Protein coding,IonXpress_NONO_c,1,1055343
2987,145364674,146420017,Protein coding,IonXpress_SFPQt1,2,1055343
2988,145365459,146420909,Protein coding,IonXpress_SFPQt1,1,1055450
2989,146420191,146420909,Protein coding,IonXpress_NONO_c,1,718
2990,146420191,146420909,Protein coding,IonXpress_SFPQt1,2,718
2991,146420962,146421557,Protein coding,IonXpress_NONO_c,1,595
2992,146420962,146421557,Protein coding,IonXpress_SFPQt1,2,595
2993,146420962,146448372,Protein coding,IonXpress_SFPQt1,1,27410
2994,146421731,146422439,Protein coding,IonXpress_NONO_c,1,708
2995,146421731,146422439,Protein coding,IonXpress_SFPQt1,2,708
2996,146422492,146423161,Protein coding,IonXpress_NONO_c,1,669
2997,146422492,146423161,Protein coding,IonXpress_SFPQt1,2,669
2998,146423335,146424048,Protein coding,IonXpress_NONO_c,1,713
2999,146423335,146424048,Protein coding,IonXpress_SFPQt1,2,713
3000,146424158,146424782,Protein coding,IonXpress_NONO_c,1,624
3001,146424158,146424782,Protein coding,IonXpress_SFPQt1,2,624
3002,146424956,146425674,Protein coding,IonXpress_NONO_c,1,718
3003,146424956,146425674,Protein coding,IonXpress_SFPQt1,2,718
3004,146425727,146426322,Protein coding,IonXpress_NONO_c,1,595
3005,146425727,146426322,Protein coding,IonXpress_SFPQt1,2,595
3006,146426496,146427204,Protein coding,IonXpress_NONO_c,1,708
3007,146426496,146427204,Protein coding,IonXpress_SFPQt1,2,708
3008,146427257,146427926,Protein coding,IonXpress_NONO_c,1,669
3009,146427257,146427926,Protein coding,IonXpress_SFPQt1,2,669
3010,146428100,146428813,Protein coding,IonXpress_NONO_c,1,713
3011,146428100,146428813,Protein coding,IonXpress_SFPQt1,2,713
3012,146428923,146435852,Protein coding,IonXpress_NONO_c,1,6929
3013,146428923,146435852,Protein coding,IonXpress_SFPQt1,2,6929
3014,146436026,146436734,Protein coding,IonXpress_NONO_c,1,708
3015,146436026,146436734,Protein coding,IonXpress_SFPQt1,2,708
3016,146436787,146437456,Protein coding,IonXpress_NONO_c,1,669
3017,146436787,146437456,Protein coding,IonXpress_SFPQt1,2,669
3018,146437630,146438343,Protein coding,IonXpress_NONO_c,1,713
3019,146437630,146438343,Protein coding,IonXpress_SFPQt1,2,713
3020,146438453,146443691,Protein coding,IonXpress_NONO_c,1,5238
3021,146438453,146443691,Protein coding,IonXpress_SFPQt1,2,5238
3022,146443865,146444573,Protein coding,IonXpress_NONO_c,1,708
3023,146443865,146444573,Protein coding,IonXpress_SFPQt1,2,708
3024,146444626,146445297,Protein coding,IonXpress_NONO_c,1,671
3025,146444626,146445297,Protein coding,IonXpress_SFPQt1,2,671
3026,146445388,146446832,Protein coding,IonXpress_NONO_c,1,1444
3027,146445388,146446832,Protein coding,IonXpress_SFPQt1,2,1444
3028,146446834,146446923,Protein coding,IonXpress_NONO_c,1,89
3029,146446834,146446923,Protein coding,IonXpress_SFPQt1,2,89
3030,146447006,146447724,Protein coding,IonXpress_NONO_c,1,718
3031,146447006,146447724,Protein coding,IonXpress_SFPQt1,2,718
3032,146447777,146448372,Protein coding,IonXpress_NONO_c,1,595
3033,146447777,146448372,Protein coding,IonXpress_SFPQt1,2,595
3034,146448546,146449254,Protein coding,IonXpress_SFPQt1,1,708
3035,146448546,146454018,Protein coding,IonXpress_NONO_c,1,5472
3036,146448546,146454018,Protein coding,IonXpress_SFPQt1,2,5472
3037,146449307,146449976,Protein coding,IonXpress_SFPQt1,1,669
3038,146450150,146450863,Protein coding,IonXpress_SFPQt1,1,713
3039,146450973,146451597,Protein coding,IonXpress_SFPQt1,1,624
3040,146451771,146452489,Protein coding,IonXpress_SFPQt1,1,718
3041,146452542,146456357,Protein coding,IonXpress_SFPQt1,1,3815
3042,146454071,146454736,Protein coding,IonXpress_NONO_c,1,665
3043,146454071,146454736,Protein coding,IonXpress_SFPQt1,2,665
3044,146454910,146455623,Protein coding,IonXpress_NONO_c,1,713
3045,146454910,146455623,Protein coding,IonXpress_SFPQt1,2,713
3046,146455733,146456357,Protein coding,IonXpress_NONO_c,1,624
3047,146455733,146456357,Protein coding,IonXpress_SFPQt1,2,624
3048,146456531,146457249,Protein coding,IonXpress_SFPQt1,1,718
3049,146456531,146462009,Protein coding,IonXpress_NONO_c,1,5478
3050,146456531,146462009,Protein coding,IonXpress_SFPQt1,2,5478
3051,146457302,146457896,Protein coding,IonXpress_SFPQt1,1,594
3052,146458070,146458778,Protein coding,IonXpress_SFPQt1,1,708
3053,146458831,146459496,Protein coding,IonXpress_SFPQt1,1,665
3054,146459670,146460383,Protein coding,IonXpress_SFPQt1,1,713
3055,146460493,146461117,Protein coding,IonXpress_SFPQt1,1,624
3056,146461291,146462009,Protein coding,IonXpress_SFPQt1,1,718
3057,146462062,146462656,Protein coding,IonXpress_NONO_c,1,594
3058,146462062,146462656,Protein coding,IonXpress_SFPQt1,3,594
3059,146462830,146463538,Protein coding,IonXpress_NONO_c,1,708
3060,146462830,146463538,Protein coding,IonXpress_SFPQt1,2,708
3061,146462830,146465149,Protein coding,IonXpress_SFPQt1,1,2319
3062,146463591,146464262,Protein coding,IonXpress_NONO_c,1,671
3063,146463591,146464262,Protein coding,IonXpress_SFPQt1,2,671
3064,146464436,146465149,Protein coding,IonXpress_NONO_c,1,713
3065,146464436,146465149,Protein coding,IonXpress_SFPQt1,2,713
3066,146465259,146465876,Protein coding,IonXpress_NONO_c,1,617
3067,146465259,146465876,Protein coding,IonXpress_SFPQt1,3,617
3068,148558286,148560845,Protein coding,IonXpress_SFPQt1,1,2559
3069,148561115,148566848,Protein coding,IonXpress_SFPQt1,2,5733
3070,148566880,148568734,Protein coding,IonXpress_SFPQt1,2,1854
3071,148568877,148574735,Protein coding,IonXpress_SFPQt1,1,5858
3072,148568877,148577356,Protein coding,IonXpress_SFPQt1,1,8479
3073,148574987,148577070,Protein coding,IonXpress_SFPQt1,1,2083
3074,148577251,148577356,Protein coding,IonXpress_SFPQt1,1,105
3075,148577512,148577613,Protein coding,IonXpress_SFPQt1,2,101
3076,148577824,148579604,Protein coding,IonXpress_SFPQt1,2,1780
3077,148579708,148580538,Protein coding,IonXpress_SFPQt1,2,830
3078,148580754,148581794,Protein coding,IonXpress_SFPQt1,2,1040
3079,148581868,148582331,Protein coding,IonXpress_SFPQt1,2,463
3080,148582538,148583824,Protein coding,IonXpress_SFPQt1,2,1286
3081,148583877,148587786,Protein coding,IonXpress_SFPQt1,2,3909
3082,148587951,148588992,Protein coding,IonXpress_SFPQt1,2,1041
3083,148589045,148589659,Protein coding,IonXpress_SFPQt1,2,614
3084,148589833,148590551,Protein coding,IonXpress_SFPQt1,2,718
3085,148590604,148591199,Protein coding,IonXpress_SFPQt1,2,595
3086,148591373,148592081,Protein coding,IonXpress_SFPQt1,2,708
3087,148592134,148592789,Protein coding,IonXpress_SFPQt1,2,655
3088,148592963,148593676,Protein coding,IonXpress_SFPQt1,2,713
3089,148593783,148594395,Protein coding,IonXpress_SFPQt1,2,612
3090,159313730,159389690,Protein coding,IonXpress_NONO_c,5,75960
3091,159314819,159389690,Protein coding,IonXpress_NONO_c,1,74871
3092,159389828,159433781,Protein coding,IonXpress_NONO_c,6,43953
3093,159389828,159459580,Protein coding,IonXpress_NONO_c,1,69752
3094,159433895,159459580,Protein coding,IonXpress_NONO_c,7,25685
3095,159459616,159477500,Protein coding,IonXpress_NONO_c,8,17884
3096,159477627,159477741,Protein coding,IonXpress_NONO_c,2,114
3097,159477633,159477741,Protein coding,IonXpress_NONO_c,6,108
3098,159477933,159481388,Protein coding,IonXpress_NONO_c,6,3455
3099,159477933,159481465,Protein coding,IonXpress_NONO_c,2,3532
3100,159481939,159488263,Protein coding,IonXpress_NONO_c,8,6324
3101,159488453,159490580,Protein coding,IonXpress_NONO_c,7,2127
3102,159488453,159490583,Protein coding,IonXpress_NONO_c,1,2130
3103,159490801,159497137,Protein coding,IonXpress_NONO_c,8,6336
3104,159497271,159498996,Protein coding,IonXpress_NONO_c,8,1725
3105,159499211,159514641,Protein coding,IonXpress_NONO_c,8,15430
3106,159514826,159517843,Protein coding,IonXpress_NONO_c,7,3017
3107,159517962,159519407,Protein coding,IonXpress_NONO_c,7,1445
3108,159519600,159519782,Protein coding,IonXpress_NONO_c,5,182
3109,159519957,159522923,Protein coding,IonXpress_NONO_c,5,2966
3110,159523075,159526230,Protein coding,IonXpress_NONO_c,4,3155
3111,159526427,159530187,Protein coding,IonXpress_NONO_c,4,3760
3112,159530273,159530393,Protein coding,IonXpress_NONO_c,4,120
3113,159530512,159533249,Protein coding,IonXpress_NONO_c,2,2737
3114,159530512,159535091,Protein coding,IonXpress_NONO_c,2,4579
3115,159533379,159535091,Protein coding,IonXpress_NONO_c,2,1712
3116,159535166,159536939,Protein coding,IonXpress_NONO_c,4,1773
3117,166195411,166399594,Non coding,IonXpress_NONO_c,5,204183
3118,166338147,166401015,Protein coding,IonXpress_NONO_c,5,62868
3119,166354254,166401015,Protein coding,IonXpress_NONO_c,5,46761
3120,166363402,166401015,Protein coding,IonXpress_NONO_c,5,37613
3121,173833213,173833393,Non coding,IonXpress_NONO_c,18,180
3122,173833213,173833393,Non coding,IonXpress_SFPQt1,22,180
3123,173833442,173833620,Non coding,IonXpress_NONO_c,9,178
3124,173833442,173833620,Non coding,IonXpress_SFPQt1,11,178
3125,173833644,173833811,Non coding,IonXpress_NONO_c,9,167
3126,173833644,173833811,Non coding,IonXpress_SFPQt1,11,167
3127,173833842,173834365,Non coding,IonXpress_NONO_c,9,523
3128,173833842,173834365,Non coding,IonXpress_SFPQt1,11,523
3129,173834420,173834607,Non coding,IonXpress_NONO_c,18,187
3130,173834420,173834607,Non coding,IonXpress_SFPQt1,22,187
3131,173834685,173834993,Non coding,IonXpress_NONO_c,18,308
3132,173834685,173834993,Non coding,IonXpress_SFPQt1,22,308
3133,173835032,173835313,Non coding,IonXpress_NONO_c,18,281
3134,173835032,173835313,Non coding,IonXpress_SFPQt1,22,281
3135,173835344,173835664,Non coding,IonXpress_NONO_c,18,320
3136,173835344,173835664,Non coding,IonXpress_SFPQt1,22,320
3137,173835705,173835897,Non coding,IonXpress_NONO_c,9,192
3138,173835705,173835897,Non coding,IonXpress_SFPQt1,11,192
3139,173835934,173836127,Non coding,IonXpress_NONO_c,18,193
3140,173835934,173836127,Non coding,IonXpress_SFPQt1,22,193
3141,173836181,173837096,Non coding,IonXpress_NONO_c,18,915
3142,173836181,173837096,Non coding,IonXpress_SFPQt1,22,915
3143,176743312,176744159,Protein coding,IonXpress_NONO_c,3,847
3144,176744262,176750757,Protein coding,IonXpress_NONO_c,3,6495
3145,176750924,176751984,Protein coding,IonXpress_NONO_c,3,1060
3146,176752113,176755884,Protein coding,IonXpress_NONO_c,3,3771
3147,176755960,176756099,Protein coding,IonXpress_NONO_c,3,139
3148,176756222,176763915,Protein coding,IonXpress_NONO_c,3,7693
3149,176763977,176765086,Protein coding,IonXpress_NONO_c,3,1109
3150,176765185,176765272,Protein coding,IonXpress_NONO_c,3,87
3151,176765337,176767783,Protein coding,IonXpress_NONO_c,3,2446
3152,176767905,176769290,Protein coding,IonXpress_NONO_c,1,1385
3153,176767926,176768264,Protein coding,IonXpress_NONO_c,2,338
3154,176768398,176769290,Protein coding,IonXpress_NONO_c,2,892
3155,176769514,176771559,Protein coding,IonXpress_NONO_c,4,2045
3156,176771706,176782706,Protein coding,IonXpress_NONO_c,3,11000
3157,176771706,176816252,Protein coding,IonXpress_NONO_c,1,44546
3158,176782810,176816252,Protein coding,IonXpress_NONO_c,2,33442
3159,176782810,176914907,Protein coding,IonXpress_NONO_c,1,132097
3160,176816329,176914126,Protein coding,IonXpress_NONO_c,1,97797
3161,176816329,176914907,Protein coding,IonXpress_NONO_c,2,98578
3162,186501428,186502216,Protein coding,IonXpress_NONO_c,2,788
3163,186501428,186502216,Protein coding,IonXpress_SFPQt1,4,788
3164,186501428,186502219,Protein coding,IonXpress_NONO_c,2,791
3165,186501428,186502219,Protein coding,IonXpress_SFPQt1,4,791
3166,186502266,186502351,Protein coding,IonXpress_NONO_c,4,85
3167,186502266,186502351,Protein coding,IonXpress_SFPQt1,8,85
3168,186502485,186502749,Protein coding,IonXpress_NONO_c,2,264
3169,186502485,186502749,Protein coding,IonXpress_SFPQt1,4,264
3170,186502485,186503670,Protein coding,IonXpress_NONO_c,2,1185
3171,186502485,186503670,Protein coding,IonXpress_SFPQt1,4,1185
3172,186502890,186503670,Protein coding,IonXpress_NONO_c,2,780
3173,186502890,186503670,Protein coding,IonXpress_SFPQt1,4,780
3174,186503840,186503951,Protein coding,IonXpress_NONO_c,4,111
3175,186503840,186503951,Protein coding,IonXpress_SFPQt1,9,111
3176,186504062,186504289,Protein coding,IonXpress_NONO_c,4,227
3177,186504062,186504289,Protein coding,IonXpress_SFPQt1,9,227
3178,186504434,186504914,Protein coding,IonXpress_NONO_c,4,480
3179,186504434,186504914,Protein coding,IonXpress_SFPQt1,9,480
3180,186505053,186505282,Protein coding,IonXpress_NONO_c,4,229
3181,186505053,186505282,Protein coding,IonXpress_SFPQt1,9,229
3182,186505373,186505590,Protein coding,IonXpress_NONO_c,4,217
3183,186505373,186505590,Protein coding,IonXpress_SFPQt1,8,217
3184,186505671,186506912,Protein coding,IonXpress_NONO_c,4,1241
3185,186505671,186506912,Protein coding,IonXpress_SFPQt1,8,1241
3186,203130709,203139834,Protein coding,IonXpress_NONO_c,2,9125
3187,203130709,203139834,Protein coding,IonXpress_SFPQt1,3,9125
3188,203139912,203142671,Protein coding,IonXpress_NONO_c,2,2759
3189,203139912,203142671,Protein coding,IonXpress_SFPQt1,3,2759
3190,203142725,203147072,Protein coding,IonXpress_NONO_c,2,4347
3191,203142725,203147072,Protein coding,IonXpress_SFPQt1,3,4347
3192,203147195,203149066,Protein coding,IonXpress_NONO_c,2,1871
3193,203147195,203149066,Protein coding,IonXpress_SFPQt1,3,1871
3194,203149204,203152381,Protein coding,IonXpress_NONO_c,2,3177
3195,203149204,203152381,Protein coding,IonXpress_SFPQt1,2,3177
3196,203152447,203155044,Protein coding,IonXpress_NONO_c,2,2597
3197,203152447,203155044,Protein coding,IonXpress_SFPQt1,2,2597
3198,203155180,203155846,Protein coding,IonXpress_NONO_c,2,666
3199,203155180,203155846,Protein coding,IonXpress_SFPQt1,2,666
3200,203155993,203157498,Protein coding,IonXpress_NONO_c,2,1505
3201,203155993,203157498,Protein coding,IonXpress_SFPQt1,2,1505
3202,203157626,203160395,Protein coding,IonXpress_NONO_c,2,2769
3203,203157626,203160395,Protein coding,IonXpress_SFPQt1,2,2769
3204,203160560,203162100,Protein coding,IonXpress_NONO_c,2,1540
3205,203160560,203162100,Protein coding,IonXpress_SFPQt1,2,1540
3206,203162236,203162566,Protein coding,IonXpress_NONO_c,2,330
3207,203162236,203162566,Protein coding,IonXpress_SFPQt1,2,330
3208,203162629,203164955,Protein coding,IonXpress_NONO_c,2,2326
3209,203162629,203164955,Protein coding,IonXpress_SFPQt1,2,2326
3210,203165090,203167642,Protein coding,IonXpress_NONO_c,2,2552
3211,203165090,203167642,Protein coding,IonXpress_SFPQt1,2,2552
3212,203167780,203168107,Protein coding,IonXpress_NONO_c,2,327
3213,203167780,203168107,Protein coding,IonXpress_SFPQt1,2,327
3214,207024408,207024635,Protein coding,IonXpress_NONO_c,1,227
3215,207024408,207024681,Protein coding,IonXpress_NONO_c,1,273
3216,207024783,207025310,Protein coding,IonXpress_NONO_c,3,527
3217,207025434,207026068,Protein coding,IonXpress_NONO_c,3,634
3218,207026196,207026760,Protein coding,IonXpress_NONO_c,3,564
3219,207026828,207027211,Protein coding,IonXpress_NONO_c,3,383
3220,207027338,207027451,Protein coding,IonXpress_NONO_c,3,113
3221,228550885,228551115,Non coding,IonXpress_SFPQt1,1,230
3222,228552289,228552880,Non coding,IonXpress_SFPQt1,1,591
3223,228552289,228552880,Protein coding,IonXpress_SFPQt1,2,591
3224,228553023,228560603,Non coding,IonXpress_SFPQt1,1,7580
3225,228553023,228560603,Protein coding,IonXpress_SFPQt1,2,7580
3226,228560797,228563450,Non coding,IonXpress_SFPQt1,1,2653
3227,228560797,228563450,Protein coding,IonXpress_SFPQt1,2,2653
3228,228564280,228565627,Protein coding,IonXpress_SFPQt1,1,1347
3229,228564280,228566883,Non coding,IonXpress_SFPQt1,1,2603
3230,228564280,228566883,Protein coding,IonXpress_SFPQt1,1,2603
3231,228565824,228566883,Protein coding,IonXpress_SFPQt1,1,1059
3232,228567036,228582657,Non coding,IonXpress_SFPQt1,1,15621
3233,228567036,228582657,Protein coding,IonXpress_SFPQt1,2,15621
3234,230193825,230313962,Protein coding,IonXpress_NONO_c,1,120137
3235,230203153,230313962,Protein coding,IonXpress_NONO_c,1,110809
3236,230203153,230338881,Non coding,IonXpress_NONO_c,1,135728
3237,230314057,230338881,Protein coding,IonXpress_NONO_c,2,24824
3238,230339036,230371758,Non coding,IonXpress_NONO_c,1,32722
3239,230339036,230371758,Protein coding,IonXpress_NONO_c,2,32722
3240,230371858,230372097,Non coding,IonXpress_NONO_c,1,239
3241,230371858,230372097,Protein coding,IonXpress_NONO_c,2,239
3242,230372166,230372404,Non coding,IonXpress_NONO_c,1,238
3243,230372166,230372404,Protein coding,IonXpress_NONO_c,2,238
3244,230372471,230379050,Non coding,IonXpress_NONO_c,1,6579
3245,230372471,230379050,Protein coding,IonXpress_NONO_c,2,6579
3246,230379173,230381807,Non coding,IonXpress_NONO_c,1,2634
3247,230379173,230381807,Protein coding,IonXpress_NONO_c,2,2634
3248,230381896,230384928,Non coding,IonXpress_NONO_c,1,3032
3249,230381896,230384928,Protein coding,IonXpress_NONO_c,2,3032
3250,230385017,230386201,Protein coding,IonXpress_NONO_c,2,1184
3251,230385017,230390962,Non coding,IonXpress_NONO_c,1,5945
3252,230386306,230390962,Protein coding,IonXpress_NONO_c,2,4656
3253,230391090,230398317,Non coding,IonXpress_NONO_c,1,7227
3254,230391090,230398317,Protein coding,IonXpress_NONO_c,2,7227
3255,230398411,230398666,Non coding,IonXpress_NONO_c,1,255
3256,230398411,230398666,Protein coding,IonXpress_NONO_c,2,255
3257,230398751,230400985,Non coding,IonXpress_NONO_c,1,2234
3258,230398751,230400985,Protein coding,IonXpress_NONO_c,2,2234
3259,230401113,230410189,Non coding,IonXpress_NONO_c,1,9076
3260,230401113,230410189,Protein coding,IonXpress_NONO_c,2,9076
3261,230410310,230415047,Protein coding,IonXpress_NONO_c,2,4737
3262,232319978,232320110,Protein coding,IonXpress_NONO_c,1,132
3263,232319978,232320110,Protein coding,IonXpress_SFPQt1,1,132
3264,232320335,232320719,Protein coding,IonXpress_NONO_c,1,384
3265,232320335,232320719,Protein coding,IonXpress_SFPQt1,1,384
3266,232320847,232321340,Protein coding,IonXpress_NONO_c,1,493
3267,232320847,232321340,Protein coding,IonXpress_SFPQt1,1,493
3268,232321475,232321710,Protein coding,IonXpress_NONO_c,1,235
3269,232321475,232321710,Protein coding,IonXpress_SFPQt1,1,235
3270,232321835,232322352,Protein coding,IonXpress_NONO_c,1,517
3271,232321835,232322352,Protein coding,IonXpress_SFPQt1,1,517
3272,232322511,232322975,Protein coding,IonXpress_NONO_c,1,464
3273,232322511,232322975,Protein coding,IonXpress_SFPQt1,1,464
3274,232323100,232323710,Protein coding,IonXpress_NONO_c,1,610
3275,232323100,232323710,Protein coding,IonXpress_SFPQt1,1,610
3276,232323836,232324861,Protein coding,IonXpress_NONO_c,1,1025
3277,232323836,232324861,Protein coding,IonXpress_SFPQt1,1,1025
3278,232325004,232325187,Protein coding,IonXpress_NONO_c,1,183
3279,232325004,232325187,Protein coding,IonXpress_SFPQt1,1,183
3280,232325275,232325378,Protein coding,IonXpress_NONO_c,1,103
3281,232325275,232325378,Protein coding,IonXpress_SFPQt1,1,103
3282,232325577,232326249,Protein coding,IonXpress_NONO_c,1,672
3283,232325577,232326249,Protein coding,IonXpress_SFPQt1,1,672
3284,232326728,232327909,Protein coding,IonXpress_NONO_c,1,1181
3285,232326728,232327909,Protein coding,IonXpress_SFPQt1,1,1181
3286,232328027,232329045,Protein coding,IonXpress_NONO_c,1,1018
3287,232328027,232329045,Protein coding,IonXpress_SFPQt1,1,1018
3288,235275423,235277081,Protein coding,IonXpress_SFPQt1,1,1658
3289,235277225,235283131,Protein coding,IonXpress_SFPQt1,1,5906
3290,235283214,235285639,Protein coding,IonXpress_SFPQt1,1,2425
3291,235285687,235291908,Protein coding,IonXpress_SFPQt1,1,6221
3292,237205869,237433795,Protein coding,IonXpress_NONO_c,2,227926
3293,237205869,237433795,Protein coding,IonXpress_SFPQt1,2,227926
3294,237433916,237494176,Protein coding,IonXpress_NONO_c,2,60260
3295,237433916,237494176,Protein coding,IonXpress_SFPQt1,2,60260
3296,237494282,237519263,Protein coding,IonXpress_NONO_c,2,24981
3297,237494282,237519263,Protein coding,IonXpress_SFPQt1,2,24981
3298,237519285,237527656,Protein coding,IonXpress_NONO_c,2,8371
3299,237519285,237527656,Protein coding,IonXpress_SFPQt1,2,8371
3300,237527672,237532832,Protein coding,IonXpress_NONO_c,2,5160
3301,237527672,237532832,Protein coding,IonXpress_SFPQt1,2,5160
3302,237532908,237538015,Protein coding,IonXpress_NONO_c,2,5107
3303,237532908,237538015,Protein coding,IonXpress_SFPQt1,2,5107
3304,237538095,237540621,Protein coding,IonXpress_NONO_c,2,2526
3305,237538095,237540621,Protein coding,IonXpress_SFPQt1,2,2526
3306,237540735,237550579,Protein coding,IonXpress_NONO_c,2,9844
3307,237540735,237550579,Protein coding,IonXpress_SFPQt1,2,9844
3308,237550680,237551385,Protein coding,IonXpress_NONO_c,2,705
3309,237550680,237551385,Protein coding,IonXpress_SFPQt1,2,705
3310,237551483,237580347,Protein coding,IonXpress_NONO_c,2,28864
3311,237551483,237580347,Protein coding,IonXpress_SFPQt1,2,28864
3312,237580423,237586390,Protein coding,IonXpress_NONO_c,2,5967
3313,237580423,237586390,Protein coding,IonXpress_SFPQt1,2,5967
3314,237586548,237604617,Protein coding,IonXpress_NONO_c,2,18069
3315,237586548,237604617,Protein coding,IonXpress_SFPQt1,2,18069
3316,237604783,237608699,Protein coding,IonXpress_NONO_c,2,3916
3317,237604783,237608699,Protein coding,IonXpress_SFPQt1,2,3916
3318,237608822,237617689,Protein coding,IonXpress_NONO_c,2,8867
3319,237608822,237617689,Protein coding,IonXpress_SFPQt1,2,8867
3320,237617874,237619898,Protein coding,IonXpress_NONO_c,2,2024
3321,237617874,237619898,Protein coding,IonXpress_SFPQt1,2,2024
3322,237620035,237632390,Protein coding,IonXpress_NONO_c,2,12355
3323,237620035,237632390,Protein coding,IonXpress_SFPQt1,2,12355
3324,237632487,237655104,Protein coding,IonXpress_NONO_c,2,22617
3325,237632487,237655104,Protein coding,IonXpress_SFPQt1,2,22617
3326,237655224,237656252,Protein coding,IonXpress_NONO_c,2,1028
3327,237655224,237656252,Protein coding,IonXpress_SFPQt1,2,1028
3328,237656387,237659809,Protein coding,IonXpress_NONO_c,2,3422
3329,237656387,237659809,Protein coding,IonXpress_SFPQt1,2,3422
3330,237660052,237664009,Protein coding,IonXpress_NONO_c,2,3957
3331,237660052,237664009,Protein coding,IonXpress_SFPQt1,2,3957
3332,237664203,237666587,Protein coding,IonXpress_NONO_c,2,2384
3333,237664203,237666587,Protein coding,IonXpress_SFPQt1,2,2384
3334,237666805,237670008,Protein coding,IonXpress_NONO_c,2,3203
3335,237666805,237670008,Protein coding,IonXpress_SFPQt1,2,3203
3336,237670114,237674986,Protein coding,IonXpress_NONO_c,2,4872
3337,237670114,237674986,Protein coding,IonXpress_SFPQt1,2,4872
3338,237675091,237693725,Protein coding,IonXpress_NONO_c,2,18634
3339,237675091,237693725,Protein coding,IonXpress_SFPQt1,2,18634
3340,237693810,237711729,Protein coding,IonXpress_NONO_c,2,17919
3341,237693810,237711729,Protein coding,IonXpress_SFPQt1,2,17919
3342,237711890,237713842,Protein coding,IonXpress_NONO_c,2,1952
3343,237711890,237713842,Protein coding,IonXpress_SFPQt1,2,1952
3344,237713991,237729865,Protein coding,IonXpress_NONO_c,2,15874
3345,237713991,237729865,Protein coding,IonXpress_SFPQt1,2,15874
3346,237730075,237732443,Protein coding,IonXpress_NONO_c,2,2368
3347,237730075,237732443,Protein coding,IonXpress_SFPQt1,2,2368
3348,237732619,237753091,Protein coding,IonXpress_NONO_c,2,20472
3349,237732619,237753091,Protein coding,IonXpress_SFPQt1,2,20472
3350,237753301,237753938,Protein coding,IonXpress_NONO_c,2,637
3351,237753301,237753938,Protein coding,IonXpress_SFPQt1,2,637
3352,237754292,237755037,Protein coding,IonXpress_NONO_c,2,745
3353,237754292,237755037,Protein coding,IonXpress_SFPQt1,2,745
3354,237755153,237756774,Protein coding,IonXpress_NONO_c,2,1621
3355,237755153,237756774,Protein coding,IonXpress_SFPQt1,2,1621
3356,237756936,237758796,Protein coding,IonXpress_NONO_c,2,1860
3357,237756936,237758796,Protein coding,IonXpress_SFPQt1,2,1860
3358,237758957,237765323,Protein coding,IonXpress_NONO_c,2,6366
3359,237758957,237765323,Protein coding,IonXpress_SFPQt1,2,6366
3360,237765411,237774060,Protein coding,IonXpress_NONO_c,2,8649
3361,237765411,237774060,Protein coding,IonXpress_SFPQt1,2,8649
3362,237774288,237777337,Protein coding,IonXpress_NONO_c,2,3049
3363,237774288,237777337,Protein coding,IonXpress_SFPQt1,2,3049
3364,237778143,237780584,Protein coding,IonXpress_NONO_c,2,2441
3365,237778143,237780584,Protein coding,IonXpress_SFPQt1,2,2441
3366,237780786,237787063,Protein coding,IonXpress_NONO_c,2,6277
3367,237780786,237787063,Protein coding,IonXpress_SFPQt1,2,6277
3368,237787170,237788959,Protein coding,IonXpress_NONO_c,2,1789
3369,237787170,237788959,Protein coding,IonXpress_SFPQt1,2,1789
3370,237789104,237791105,Protein coding,IonXpress_NONO_c,2,2001
3371,237789104,237791105,Protein coding,IonXpress_SFPQt1,2,2001
3372,237791380,237794725,Protein coding,IonXpress_NONO_c,2,3345
3373,237791380,237794725,Protein coding,IonXpress_SFPQt1,2,3345
3374,237794841,237796876,Protein coding,IonXpress_NONO_c,2,2035
3375,237794841,237796876,Protein coding,IonXpress_SFPQt1,2,2035
3376,237797010,237798187,Protein coding,IonXpress_NONO_c,2,1177
3377,237797010,237798187,Protein coding,IonXpress_SFPQt1,2,1177
3378,237798292,237801655,Protein coding,IonXpress_NONO_c,2,3363
3379,237798292,237801655,Protein coding,IonXpress_SFPQt1,2,3363
3380,237801792,237802313,Protein coding,IonXpress_NONO_c,2,521
3381,237801792,237802313,Protein coding,IonXpress_SFPQt1,2,521
3382,237802501,237804195,Protein coding,IonXpress_NONO_c,2,1694
3383,237802501,237804195,Protein coding,IonXpress_SFPQt1,2,1694
3384,237804302,237806625,Protein coding,IonXpress_NONO_c,2,2323
3385,237804302,237806625,Protein coding,IonXpress_SFPQt1,2,2323
3386,237806747,237811742,Protein coding,IonXpress_NONO_c,2,4995
3387,237806747,237811742,Protein coding,IonXpress_SFPQt1,2,4995
3388,237811913,237813175,Protein coding,IonXpress_NONO_c,2,1262
3389,237811913,237813175,Protein coding,IonXpress_SFPQt1,2,1262
3390,237813397,237814709,Protein coding,IonXpress_NONO_c,2,1312
3391,237813397,237814709,Protein coding,IonXpress_SFPQt1,2,1312
3392,237814801,237817572,Protein coding,IonXpress_NONO_c,2,2771
3393,237814801,237817572,Protein coding,IonXpress_SFPQt1,2,2771
3394,237817714,237819119,Protein coding,IonXpress_NONO_c,2,1405
3395,237817714,237819119,Protein coding,IonXpress_SFPQt1,2,1405
3396,237819284,237821242,Protein coding,IonXpress_NONO_c,2,1958
3397,237819284,237821242,Protein coding,IonXpress_SFPQt1,2,1958
3398,237821322,237823283,Protein coding,IonXpress_NONO_c,2,1961
3399,237821322,237823283,Protein coding,IonXpress_SFPQt1,2,1961
3400,237823374,237824108,Protein coding,IonXpress_NONO_c,2,734
3401,237823374,237824108,Protein coding,IonXpress_SFPQt1,2,734
3402,237824247,237829810,Protein coding,IonXpress_NONO_c,2,5563
3403,237824247,237829810,Protein coding,IonXpress_SFPQt1,2,5563
3404,237829889,237831181,Protein coding,IonXpress_NONO_c,2,1292
3405,237829889,237831181,Protein coding,IonXpress_SFPQt1,2,1292
3406,237831258,237837394,Protein coding,IonXpress_NONO_c,2,6136
3407,237831258,237837394,Protein coding,IonXpress_SFPQt1,2,6136
3408,237837519,237838029,Protein coding,IonXpress_NONO_c,2,510
3409,237837519,237838029,Protein coding,IonXpress_SFPQt1,2,510
3410,237838146,237841346,Protein coding,IonXpress_NONO_c,2,3200
3411,237838146,237841346,Protein coding,IonXpress_SFPQt1,2,3200
3412,237841412,237843754,Protein coding,IonXpress_NONO_c,2,2342
3413,237841412,237843754,Protein coding,IonXpress_SFPQt1,2,2342
3414,237843877,237850753,Protein coding,IonXpress_NONO_c,2,6876
3415,237843877,237850753,Protein coding,IonXpress_SFPQt1,2,6876
3416,237850804,237862263,Protein coding,IonXpress_NONO_c,2,11459
3417,237850804,237862263,Protein coding,IonXpress_SFPQt1,2,11459
3418,237862325,237863527,Protein coding,IonXpress_NONO_c,2,1202
3419,237862325,237863527,Protein coding,IonXpress_SFPQt1,2,1202
3420,237863767,237865276,Protein coding,IonXpress_NONO_c,2,1509
3421,237863767,237865276,Protein coding,IonXpress_SFPQt1,2,1509
3422,237865359,237868511,Protein coding,IonXpress_NONO_c,2,3152
3423,237865359,237868511,Protein coding,IonXpress_SFPQt1,2,3152
3424,237868643,237870247,Protein coding,IonXpress_NONO_c,2,1604
3425,237868643,237870247,Protein coding,IonXpress_SFPQt1,2,1604
3426,237870569,237872156,Protein coding,IonXpress_NONO_c,2,1587
3427,237870569,237872156,Protein coding,IonXpress_SFPQt1,2,1587
3428,237872398,237872778,Protein coding,IonXpress_NONO_c,2,380
3429,237872398,237872778,Protein coding,IonXpress_SFPQt1,2,380
3430,237872867,237875043,Protein coding,IonXpress_NONO_c,2,2176
3431,237872867,237875043,Protein coding,IonXpress_SFPQt1,2,2176
3432,237875137,237880496,Protein coding,IonXpress_NONO_c,2,5359
3433,237875137,237880496,Protein coding,IonXpress_SFPQt1,2,5359
3434,237880668,237881760,Protein coding,IonXpress_NONO_c,2,1092
3435,237880668,237881760,Protein coding,IonXpress_SFPQt1,2,1092
3436,237881821,237886426,Protein coding,IonXpress_NONO_c,2,4605
3437,237881821,237886426,Protein coding,IonXpress_SFPQt1,2,4605
3438,237886562,237889571,Protein coding,IonXpress_NONO_c,2,3009
3439,237886562,237889571,Protein coding,IonXpress_SFPQt1,2,3009
3440,237889608,237890385,Protein coding,IonXpress_NONO_c,2,777
3441,237889608,237890385,Protein coding,IonXpress_SFPQt1,2,777
3442,237890499,237893558,Protein coding,IonXpress_NONO_c,2,3059
3443,237890499,237893558,Protein coding,IonXpress_SFPQt1,2,3059
3444,237893656,237895344,Protein coding,IonXpress_NONO_c,2,1688
3445,237893656,237895344,Protein coding,IonXpress_SFPQt1,2,1688
3446,237895449,237897003,Protein coding,IonXpress_NONO_c,2,1554
3447,237895449,237897003,Protein coding,IonXpress_SFPQt1,2,1554
3448,237897056,237905594,Protein coding,IonXpress_NONO_c,2,8538
3449,237897056,237905594,Protein coding,IonXpress_SFPQt1,2,8538
3450,237905649,237919586,Protein coding,IonXpress_NONO_c,2,13937
3451,237905649,237919586,Protein coding,IonXpress_SFPQt1,2,13937
3452,237919687,237920995,Protein coding,IonXpress_NONO_c,2,1308
3453,237919687,237920995,Protein coding,IonXpress_SFPQt1,2,1308
3454,237921076,237923074,Protein coding,IonXpress_NONO_c,2,1998
3455,237921076,237923074,Protein coding,IonXpress_SFPQt1,2,1998
3456,237923152,237924253,Protein coding,IonXpress_NONO_c,2,1101
3457,237923152,237924253,Protein coding,IonXpress_SFPQt1,2,1101
3458,237924328,237934105,Protein coding,IonXpress_NONO_c,2,9777
3459,237924328,237934105,Protein coding,IonXpress_SFPQt1,2,9777
3460,237934187,237935310,Protein coding,IonXpress_NONO_c,2,1123
3461,237934187,237935310,Protein coding,IonXpress_SFPQt1,2,1123
3462,237935400,237936818,Protein coding,IonXpress_NONO_c,2,1418
3463,237935400,237936818,Protein coding,IonXpress_SFPQt1,2,1418
3464,237936948,237941964,Protein coding,IonXpress_NONO_c,2,5016
3465,237936948,237941964,Protein coding,IonXpress_SFPQt1,2,5016
3466,237942070,237944863,Protein coding,IonXpress_NONO_c,2,2793
3467,237942070,237944863,Protein coding,IonXpress_SFPQt1,2,2793
3468,237944946,237946973,Protein coding,IonXpress_NONO_c,2,2027
3469,237944946,237946973,Protein coding,IonXpress_SFPQt1,2,2027
3470,237948272,237949267,Protein coding,IonXpress_NONO_c,2,995
3471,237948272,237949267,Protein coding,IonXpress_SFPQt1,2,995
3472,237949336,237951286,Protein coding,IonXpress_NONO_c,2,1950
3473,237949336,237951286,Protein coding,IonXpress_SFPQt1,2,1950
3474,237951435,237954727,Protein coding,IonXpress_NONO_c,2,3292
3475,237951435,237954727,Protein coding,IonXpress_SFPQt1,2,3292
3476,237954815,237955403,Protein coding,IonXpress_NONO_c,2,588
3477,237954815,237955403,Protein coding,IonXpress_SFPQt1,2,588
3478,237955623,237957165,Protein coding,IonXpress_NONO_c,2,1542
3479,237955623,237957165,Protein coding,IonXpress_SFPQt1,2,1542
3480,237957297,237958587,Protein coding,IonXpress_NONO_c,2,1290
3481,237957297,237958587,Protein coding,IonXpress_SFPQt1,2,1290
3482,237958631,237961335,Protein coding,IonXpress_NONO_c,2,2704
3483,237958631,237961335,Protein coding,IonXpress_SFPQt1,2,2704
3484,237961470,237965154,Protein coding,IonXpress_NONO_c,2,3684
3485,237961470,237965154,Protein coding,IonXpress_SFPQt1,2,3684
3486,237965216,237969435,Protein coding,IonXpress_NONO_c,2,4219
3487,237965216,237969435,Protein coding,IonXpress_SFPQt1,2,4219
3488,237969583,237972199,Protein coding,IonXpress_NONO_c,2,2616
3489,237969583,237972199,Protein coding,IonXpress_SFPQt1,2,2616
3490,237972335,237982334,Protein coding,IonXpress_NONO_c,2,9999
3491,237972335,237982334,Protein coding,IonXpress_SFPQt1,2,9999
3492,237982492,237991679,Protein coding,IonXpress_NONO_c,2,9187
3493,237982492,237991679,Protein coding,IonXpress_SFPQt1,2,9187
3494,237991745,237993828,Protein coding,IonXpress_NONO_c,2,2083
3495,237991745,237993828,Protein coding,IonXpress_SFPQt1,2,2083
3496,237993930,237994812,Protein coding,IonXpress_NONO_c,2,882
3497,237993930,237994812,Protein coding,IonXpress_SFPQt1,2,882
3498,237994865,237995850,Protein coding,IonXpress_NONO_c,2,985
3499,237994865,237995850,Protein coding,IonXpress_SFPQt1,2,985
